Clave,Nombre,Precio,Satelite,Metepec,Lindavista,Total,Ubicacion
,BOLSA AIRE SIN SENSOR SUSPENSION DELANTERA (R) PORSCHE PANAMERA (EMBLER) CYS,1818,6,9,0,15,Estante 1A
,KIT 2 PZ CLUTC PLATO OPRESOR DISCO SPRINTER W901 A W905 (FREY),1809,0,2,0,2,Estante 1B
,BRAZO RECTO SUSPENSION TRASERA (L) BMW F20-F23 F30-F34 F36 (FREY),1635,8,7,8,23,Estante 1C
 11427512300-100,FILTRO ACEITE MOTOR BMW M52 M54 (MAHLE OX154/1D) INACTIVO,1986,6,6,3,15,Estante 2A
 2711800109,FILTRO ACEITE MOTOR MERCEDES W203 1.8 L4 VIKA,1941,7,0,7,14,Estante 2B
 32416796390 *1,MANGUERA DE BOMBA DE DIRECCION BMW E46-M54 MEISTERSATZ,1312,0,3,5,8,Estante 2C
 36118009701,Rin BMW R18,1351,3,9,4,16,Estante 3A
 PZKER7A8EGS NGK*3 ,BUJIA DE IGNICION DOBLE PLATINO AUDI A3 A1 Q3 1.4L (NGK),1442,5,7,6,18,Estante 3B
-,///,1293,9,6,5,20,Estante 3C
.,/.,1979,2,0,4,6,Estante 4A
/,TONILLO ESTABIIZADOR,1589,9,0,1,10,Estante 4B
00004330575 *5,1 GALON CON 3.78 LITROS ANTICONGELANTE CONCENTRADO COLOR ROSA (VALVOLINE) SSF,1643,9,7,1,17,Estante 4C
0000535658 *5,KIT 8 PZ. SELLOS VALVULA ADMISION ESCAPE MOTOR MERCEDES M271 2a GEN TURBO (CORTECO) SSF,1204,4,6,8,18,Estante 5A
0000780956 *1,FILTRO ENTRADA AIRE MOTOR VALVULA SOLENOIDE VACIO TURBO CARGADOR SPRINTER CRAFTER 2006 A 2016 (FREY),1770,0,0,3,3,Estante 5B
0000901551 *2,FILTRO COMBUSTIBLE DIESEL MERCEDES VARIO OM904 (MANN  PU1046X),1776,4,6,3,13,Estante 5C
0000902651-100,FILTRO AIRE MOTOR SPRINTER W906 OM651 INACTIVO,1250,6,7,6,19,Estante 6A
0000903751 *3,FILTRO ENTRADA AIRE MOTOR SPRINTER W906 OM651 (MAHLE LX1845),1651,0,6,8,14,Estante 6B
0000940548 *1,SENSOR DE MASA DE AIRE MAF MERCEDES W124-M104 FREY,1466,2,8,5,15,Estante 6C
0000943248,SENSOR MASA AIRE MAF MERCEDES W639 M112 (EMBLER),1974,9,2,8,19,Estante 7A
0000943248 *3,SENSOR MASA AIRE MAF MERCEDES W639 M112 (BOSCH),1246,5,4,4,13,Estante 7B
0001405185 *1,BOMBA INYECCION AIRE SECUNDARIO MERCEDES M272 M273 (FREY),1615,0,5,6,11
0001405185 *2,BOMBA DE INYECCIï¿½N DE AIRE SECUNDARIO MERCEDES W164 (BOSCH),1712,9,5,2,16
0001501380 *1,BOBINA DE ENCENDIDO ( UNIDAD ) MERCEDES W168-M166 FREY,1775,2,7,6,15
0001501380 *5,BOBINA DE ENCENDIDO (UNIDAD) MERCEDES W168 M166 (EMBLER),1250,0,2,7,9
0001502580 *2,BOBINA IGNICION ENCENDIDO MERCEDES M271 (EMBLER),1431,6,4,7,17
0001502780 *1,BOBINA ENCENDIDO IGNICION MOTOR MERCEDES M272 M273 (FREY TECNOLOGIA ALEMANA),1715,1,4,2,7
0001502780 *5,BOBINA ENCENDIDO IGNICION MOTOR MERCEDES M272 M273 (DELPHI) SSF,1370,9,3,6,18
0001502880 *1,BOBINA ENCENDIDO IGNICION MOTOR MERCEDES M271 KOMPRESSOR (FREY),1794,4,6,0,10
0001502980 *1,BOBINA ENCENDIDO IGNICION MOTOR MERCEDES M271 KOMPRESSOR (FREY TECNOLOGIA ALEMANA),1423,5,3,2,10
0001502980 *2,BOBINA IGNICION ENCENDIDO MERCEDES M271 (BMTRS),1888,0,2,1,3
0001502980 *5 ,BOBINA ENCENDIDO IGNICION MOTOR MERCEDES M271 KOMPRESSOR (BERU) SSF,1302,8,9,1,18
0001587803 *1,BOBINA ENCENDIDO IGNICION MOTOR MERCEDES M112 M113 (FREY),1276,6,7,7,20
0001587803 *5 ,BOBINA ENCENDIDO IGNICION MOTOR MERCEDES M112 M113 (BOSCH) SSF,1620,9,0,5,14
0001593642 *1,TUBO PROTECTOR CALOR BUJIA IGNICION MERCEDES W124 W140 W163 W202 W210 W463 VITO W638 SPRINTER W901-W904 (FREY),1825,4,2,8,14
0001802609 *1,FILTRO ACEITE MOTOR MERCEDES M111 M112 M113 M271 M272 M273 (FREY),1885,1,5,5,11
0001802609 *3,FILTRO ACEITE MOTOR MERCEDES M111 M112 M113 M271 M272 M273 (MAHLE OX153/7),1780,1,5,5,11
0001802609 *5,FILTRO ACEITE MOTOR MERCEDES M111 M112 M113 M271 M272 M273 (HENGST) SSF,1665,0,5,4,9
0001802609 *6,FILTRO ACEITE MOTOR MERCEDES M111 M112 M113 M271 M272 M273 (MANN) SSF,1675,2,7,4,13
0001803009 *1,FILTRO ACEITE MOTOR MERCEDES M156 8 CILINDROS 6.3 L AMG (FREY),1657,6,6,5,17
0001803009 *5,FILTRO ACEITE MOTOR MERCEDES M156 8 CILINDROS 6.3 L AMG (HENGST) SSF,1957,9,6,4,19
0001803009-100,FILTRO ACEITE MOTOR MERCEDES AMG M156 8 CILINDROS (SORTECH) INACTIVO,1977,8,5,8,21
0001803109-100,FILTRO ACEITE MOTOR MERCEDES M111 M112 INACTIVO,1646,9,8,5,22
0002008123 *1,ASPAS FAN CLUTCH ENFRIAMIENTO MOTOR CON GIRO OPUESTO AL RELOJ  SPRINTER 1a GEN OM611 5 CIL. (FREY),1922,4,0,7,11
0002009323 *1,MOTOVENTILADOR ENFRIAMIENTO MOTOR SMART FORTWO 2007 A 2015 W451 (FREY),1695,0,4,5,9
0002009723CCW *1,ASPAS FAN CLUTCH ENFRIAMIENTO MOTOR GIRO EN SENTIDO OPUESTO AL RELOG SPRINTER 1a GEN OM611 5 CIL. (FREY),1425,2,5,0,7
0002009723CW *1,ASPAS FAN CLUTCH ENFRIAMIENTO MOTOR GIRO EN SENTIDO AL RELOG SPRINTER 1a GEN OM611 5 CIL. (FREY),1618,1,6,6,13
0002009923 *1,FAN CLUTCH CON ASPAS CON SENSOR ENFRIAMIENTO MOTOR SPRINTER OM642 2009 A 2020 (FREY),1699,6,9,2,17
0002020019 *1,POLEA DE RE ENVIO RAYADA 62X23X8 MM MERCEDES M272 M273 (FREY),1315,1,3,7,11
0002021619 *1,POLEA DE RE ENVIO RAYADA MERCEDES MOTOR M271 ( FREY ),1643,9,7,1,17
0002021719 *1,POLEA LISA REENVIO BANDA ACCESORIOS MERCEDES M271 2a GEN TURBO (FREY),1426,5,9,2,16
0002542508 *1,COLLARIN HIDRAULICO CLUTCH SPRINTER W906 VITO W639 VIANO W447 CRAFTER 2006 A 2016 (FREY),1613,7,4,1,12
0002600009 *1,PALANCA VELOCIDADES STANDAR CON FUNDA SPRINTER W901 A W905 (FREY),1280,3,7,2,12
0002681096 *1,FUNDA PALANCA VELOCIDADES TRANSMISION ESTANDAR SPRINTER W906 VW CRAFTER 2006 A 2016 (FREY),1215,4,5,1,10
0002684097 *1,FUNTA PALANCA VELOCIDADES STARDAR SPRINTER W901 A W905 (FREY),1276,4,4,2,10
0002903212 *1,CILINDRO MAESTRO CLUTCH SPRINTER W901 A W905 (FREY),1518,5,0,1,6
0003210250 *1,BUJE MUELLE SUSPENSION TRASERA (L/R) SPRINTER W906 W907 CRAFTER 2006 A 2016 (FREY),1617,9,0,9,18
00033010-100,ROTULA DE SUSPENSION DELANTERA MERCEDES W211 INACTIVO,1601,3,6,1,10
0003301007 *1,ROTULA SUPERIOR SUSPENSION DELANTERA MERCEDES W211 (FREY),1636,5,0,2,7
0003385010 *1,TERMINAL DIRECCION SIN BIELETA SUSPENSION DELANTERA (L) MERCEDES W123 (FREY),1736,4,6,4,14
0003385210 *1,TERMINAL DIRECCION SIN BIELETA SUSPENSION DELANTERA (R) MERCEDES W123 (FREY),1419,1,2,8,11
0004011872 *1,TUERCA DE BIRLO RUEDA DELANTERA O TRASERA SPRINTER W906 (FREY),1619,3,4,9,16
0004200482 *1,KIT TORNILLO CALIPER SPRINTER W901 A W905 (FREY),1803,9,9,1,19
0004202902 *1,BALATAS FRENOS DELANTEROS 129X71 MM MERCEDES W176 W246 (FREY),1446,4,3,0,7
0004202902 *9,BALATAS FRENOS DELANTEROS 129X71 MM MERCEDES W176 W246 (TEXTAR) SSF,1883,8,3,2,13
0004203602 *3,BALATAS FRENOS TRASEROS 122X56 MM MERCEDES W205 X253 (TRW GDB2071),1808,7,4,6,17
0004203602 *5,BALATAS FRENOS TRASEROS 122X56 MM MERCEDES W205 X253 FERODO (SSF),1556,2,3,2,7
0004203602 *6,BALATAS FRENOS TRASEROS 122X56 MM MERCEDES W205 X253 (ATE) SSF,1928,5,0,9,14
0004204900 *3,BALATAS FRENOS DELANTEROS MECEDES W205 (TRW GDB2150),1229,2,1,4,7
0004205900 *1,BALATAS FRENOS TRASEROS 122.5X63.9 MM MERCEDES W205 X253 (FREY),1417,8,6,4,18
0004205900 *3,BALATAS FRENOS TRASEROS 122.5X63.9 MM MERCEDES W205 X253 (TRW GDB2154),1925,1,5,2,8
0004205900 *5,BALATAS FRENOS TRASEROS 122.5X63.9 MM MERCEDES W205 X253 (FERODO) SSF,1872,0,3,3,6
0004205900 *6,BALATAS FRENOS TRASEROS 122.5X63.9 MM MERCEDES W205 X253 (ATE) SSF,1772,5,2,7,14
0004206700 *1,BALATAS FRENOS DELANTEROS 127.6X92.6 MM MERCEDES W205 AMG W213 X253 (FREY),1375,9,7,1,17
0004206700 *5,BALATAS FRENOS DELANTEROS 127.6X92.6 MM MERCEDES W205 AMG W213 X253 (FERODO) SSF,1259,1,5,2,8
0004206700 *6,BALATAS FRENOS DELANTEROS 127.6X92.6 MM MERCEDES W205 AMG W213 X253 (ATE) SSF,1840,1,5,5,11
0004206902 *1,BALATAS FRENOS DELANTERO MERCEDES W177 W247 (FREY),1571,3,4,5,12
0004207004 *3,BALATAS FRENOS TRASEROS MERCEDES W164 AMG (TRW GDB1675),1908,7,1,4,12
0004207500 *1,BALATAS DE FRENOS TRASEROS MERCEDES W247 W177 (FREY),1269,6,4,3,13
0004207900 *3,BALATAS FRENOS TRASEROS 122X54 MERCEDES BENZ W204 (TRW GDB1738),1976,7,3,0,10
0004207902 *3,BALATAS FRENOS DELANTERO (L/R) MERCEDES W253 (BREMBO),1801,5,6,7,18
0004208200 *1,BALATAS FRENOS TRASEROS 122X56 MM MERCEDES W205 X253 (FREY),1952,3,0,6,9
000420870-100,BALATAS FRENOS DELANTEROS 144X71 MM MERCEDES W246 W205 INACTIVO,1683,9,1,7,17
0004208700 *1,BALATAS FRENOS DELANTEROS 144.2X69.8 MERCEDES W205 W212 W213 X156 (FREY),1252,7,1,8,16
0004208700 *3,BALATAS FRENOS DELANTEROS 144.2X69.8 MERCEDES W205 W212 W213 X156 (BREMBO P50118N) DGO,1552,9,8,4,21
0004209004 *3,BALATAS FRENOS DELANTEROS 188X74 MM MERCEDES W204 W212 W213 R172 (TRW GDB1737),1468,2,3,0,5
0004209700 *1,BALATAS FRENOS TRASERO 114.2X64 MM MERCEDES W213 (FREY),1668,0,6,4,10
0004209720 *1,BALATAS FRENOS TRASEROS 140 X 51.6 MM SPRINTER W901 A W905 (FREY),1208,5,1,8,14
0004210850 *1,KIT 8 PZ HERRAJES CALIPERS FRENOS DELANTEROS (L/R) VITO 639 SPRINTER W906 VW CRAFTER 2006 A 2016 (FREY),1235,5,0,7,12
0004210850B *1,KIT 10 PZ HERRAJES CALIPERS FRENOS DELANTEROS (L/R) VITO 639 SPRINTER W906 VW CRAFTER 2006 A 2016 (FREY),1744,9,0,9,18
0004211412 *5,DISCO FRENOS DELANTERO VENTILADO 344X65 MM MERCEDES W212 R172 (FREMAX) SSF,1568,7,5,2,14
0004212312 *1,DISCO DE FRENOS DELANTEROS 360 X 36 MM MERCEDES W205 X253 (FREY),1821,4,2,0,6
0004212412 *3,DISCO FRENOS DELANTERO (L/R) 295 X 24 MM MERCEDES W205 (FREMAX),1235,1,0,8,9
0004212512 *2,DISCO FRENO DELANTERO 305X28X112 MM MERCEDES W205 W213 (EMBLER),1948,7,4,4,15
0004212712 *1,DISCO FRENOS DELANTERO (L/R) 330X63X112 MM MERCEDES W205 (FREY),1606,9,6,9,24
0004230230 *3,BALATAS FRENOS TRASEROS MERCEDES W211 ( TRW ),1991,8,6,7,21
0004230512 *1,DISCO FRENOS TRASEROS SOLIDO (L/R) 300X12 MM CON TORNILLOS MERCEDES W205 (FREY),1601,5,0,8,13
0004230512B,DISCO FRENOS TRASEROS SOLIDO 300X12 MM MERCEDES W205 (FREY),1300,9,9,7,25
0004230563 *1,KIT 14 PZ PERNOS CALIPERS FRENOS TRASEROS (L/R) VITO 639 SPRINTER W906 VW CRAFTER 2006 A 2016 (FREY),1517,3,6,2,11
0004230663 *1,KIT 7 PZ PERNOS TORNILLOS CALIPER FRENOS TRASEROS (L/R) SPRINTER W906 CRAFTER 2006 A 2016 (FREY),1575,1,2,5,8
0004230912 *1,DISCO FRENOS TRASERO 300X168 MM MERCEDES X204 W211 W212 (FREY),1963,9,4,1,14
0004302694,ACUMULADOR DE PRESION DEL LIQUIDO DE FRENOS MERCEDES W211 BOSCH,1341,8,0,7,15
0004302694 *1,ACUMULADOR DE PRESION DEL LIQUIDO DE FRENOS MERCEDES W211 FREY,1359,8,0,9,17
0004317501 *1,CILINDRO MAESTRO BOMBA FRENOS SPRINTER W906 (FREY),1200,9,3,5,17
0004600183,DEPOSITO DE ACEITE DE DIRECCION MERCEDES W163-M112,1786,5,2,2,9
0004600183 *1,DEPOSITO LIQUIDO DIRECCION HIDRAULICA MERCEDES W163 W210 W211 W220 (FREY),1767,5,5,4,14
0004602383 *1,DEPOSITO DE DIRECCION ASISTIDA MERCEDES DENZ W203 FREY,1822,1,6,5,12
0004602483 *1,DEPOSITO DIRECCION HIDRAULICA SPRINTER W906 OM651 (FREY),1213,6,7,5,18
0004602583 *1,DEPOSITO DIRECCION HIDRAULICA MERCEDES W164 M272 (FREY),1874,9,2,6,17
0004602583 *2,DEPOSITO DE DIRECCION HIDRAULICA MERCEDES W164 M272 LEMFORDER,1869,2,0,5,7
0004602683 *1,DEPOSITO DE ACEITE DE DIRECCION MERCEDES X164-M273 FREY,1395,9,0,3,12
000460283-100,DEPOSITO ACEITE DIRECCION HIDRAULICA MERCEDES W164 W251 INACTIVO,1358,5,5,4,14
0004635132 *1,AMORTIGUADOR DE DIRECCION MERCEDES W123 FREY,1684,2,0,8,10
0004661880 *1,SELLO DE DEPOSITO DE ACEITE DE DIRECCION MERCEDES W164 / M272 FREY,1573,2,5,1,8
0004661880 *3,SELLO DEPOSITO ACEITE DE DIRECCION MERCEDES W164  M272 (EMBLER),1782,4,5,7,16
0004704994 *1,BOMBA GASOLINA ELECTRICA MERCEDES W202 (FREY),1571,0,9,1,10
0004707894 *1 ,BOMBA DE GASOLINA MERCEDES W220 M113 (FREY),1884,0,1,3,4
0004708593 *1,VALVULA SOLENOIDE DE PURGA MERCEDES W204-W221 FREY,1958,5,8,0,13
0005002686 *1,BOMBA AGUA AUXILIAR ELECTRICA ENFRIAMIENTO MOTOR MERCEDES W166 W176 W205 W213 W222 X159 X253 (FREY),1813,6,6,7,19
0005003500 *5,BOMBA AGUA AUXILIAR ELECTRICA ENFRIAMIENTO MOTOR MERCEDES (BOSCH) SSF,1615,2,0,3,5
0005426218 ,SENSOR DE TEMPERATURA W203 TOPRAN,1892,2,1,1,4
0005450527 *1,VALVULA SOLENOIDE CONVERTIDOR TURBO SPRINTER OM651 (FREY),1681,6,1,3,10
0005458108 *1,SWICH ARRANQUE PASTILLA ENCENDIDO SPRINTER W901 A W905 (FREY),1963,6,9,4,19
0007270037 *1,MANIJA INTERNA PUERTA DELANTERA (L) SPRINTER W901 A W905 (FREY),1659,8,2,6,16
0007270137 *1,MANIJA INTERNA PUERTA DELANTERA (R) SPRINTER W901 A W905 (FREY),1764,1,2,9,12
0007601359 *1,MANIJA EXTERNA CON CHAPA PUERTA DELANTERA (L) SPRINTER W901 A W905 (FREY),1890,4,6,0,10
0008107419 *1,ESPEJO RETROVISOR ELECTRICO LATERAL (L) BRAZO LARGO SPRINTER W906 CRAFTER 2006 A 2016 (FREY),1256,2,2,0,4
0008107519 *1,ESPEJO ELï¿½CTRICO LATERAL (R) BRAZO LARGO SPRINTER 906 CRAFTER 2006 A 2016 (FREY),1762,7,4,8,19
0008201277 *1 ,FOCO COLOR AMBAR DIRECCIONAL CUARTO ESPEJO LATERAL (L/R) SPRINTER W906 (FREY),1847,1,8,9,18
0008201377 *1,PLACA CIRCUITO LUCES (L) CALAVERA TRACERA SPRINTER W906 (FREY),1882,8,1,3,12
0008201477 *1,PLACA CIRCUITO LUCES (R) CALAVERA TRACERA SPRINTER W906 (FREY),1792,7,0,9,16
0008204409 *1,ACTUADOR ELECTRICO TAPON GASOLINA MERCEDES H247 W177 X118 (FREY),1961,8,7,6,21
0008261556 *1,CALAVERA LUZ TRASERA (L) SPRINTER W901 A W905 2000 A 2006 (FREY),1298,7,5,7,19
0008261656 *1,CALAVERA LUZ TRASERA (R) SPRINTER W901 A W905 2000 A 2006 (FREY),1579,3,7,0,10
0008356107 *1,MOTOR SOPLADOR BLOWER AIRE ACONDICIONADO SPRINTER W906 CRAFTER 2006 A 2016 (FREY),1489,1,8,1,10
0008356207 *1,BLOWER DE AIRE SPRINTER W906 (FREY),1383,3,3,6,12
0008603526 *1,BOMBA AGUA LIMPIA PARABRISAS CHISGUETEROS SPRINTER VW BMW MERCEDES (FREY),1406,4,1,7,12
0009050143 *1 ,SENSOR POSICION ARBOL LEVAS ADMISION MERCEDES M156  (FREY),1203,1,9,3,13
0009050242 *1,SENSOR DE ESTACIONAMIENTO MERCEDES W204 FREY,1745,9,5,2,16
0009050243 *1,SENSOR POSICION ARBOL LEVAS ADMISION MERCEDES M156 (FREY),1912,7,2,9,18
0009050342 *1,SENSOR DE ESTACIONAMIENTO MERCEDES W204  (FREY ),1563,6,8,9,23
0009050343 *1,SENSOR POSICION ARBOL LEVAS ESCAPE MERCEDES M156 (FREY),1454,9,3,8,20
0009051202 *1,SENSOR DE ESTACIONAMIENTO MERCEDES W212 FREY,1688,0,3,0,3
0009057200 *1,SENSOR DE PRESION DE LLANTAS MERCEDES W203 / TM FREY,1257,6,9,9,24
0009060022 *1,ALTERNADOR GENERADOR VOLTAJE 150 AMP MERCEDES W176 W246 X117 X156 (FREY),1692,0,8,1,9
0009061004 *1,Nuevo Actuador De Freno Trasero Park  FREY,1400,6,7,1,14
0009061303 *1,ACTUADOR ELECTRICO FRENO ESTACIONAMIENTO TRASERO (R) MERCEDES W205 X253 (FREY),1603,6,9,7,22
000989180811 *1 ,1 GALON CON 3.785  LITROS ANTICONGELANTE ROJO -45C MERCEDES BENZ (FREY),1663,3,6,4,13
0009913940 *1,GRAPAS SUJETADORAS MULTIUSOS 0.8 MM SPRNTER W906 (FREY),1628,1,2,5,8
0009934178 *1,CADENA DE DISTRIBUCION LARGA MERCEDES W176 W246 W156 (FREY),1352,1,3,3,7
0009977070 *1,TUBO COPLE ENFRIAMIENTO MOTOR SPRINTER VITO VIANO OM646 (FREY),1353,2,6,8,16
0009985690 *1,TAPON DE ACEITE PARA CABEZA DE MOTOR MERCEDES W203-M272 FREY,1849,8,7,3,18
0009986590 *1,TAPON TRASERO CABEZA DE MOTOR 30 MM MERCEDES M272 M273 (FREY),1806,0,3,7,10
0009986590 *5,TAPON TRASERO CABEZA MOTOR 30 MM MERCEDES M272 (WALKER) SSF,1271,2,8,5,15
0010940301 *3,FILTRO POLEN AIRE CABINA SMART FORTWO (MAHLE LAK430),1409,6,2,6,14
0010942704,FILTRO ENTRADA AIRE MOTOR MERCEDES W123 MANN C36157,1318,5,3,2,10
0011531132 *1,SENSOR NIVEL ACEITE MOTOR MERCEDES M272 M273 M276 (FREY),1789,6,7,8,21
0011531932 *1,SENSOR NIVEL ACEITE MERCEDES C117 W176 W246 (FREY),1473,7,1,1,9
0011593701 *1,BUJIA PRECALENTADOR DIESEL VITO OM646 SPRINTER OM612 2.7 L 5 CILINDROS 2004 A 2006 (FREY TEGNOLOGIA ALEMANA),1557,9,9,3,21
0011596601 *1,BUJIA PRECALENTADOR DIESEL SPRINTER OM651 2.1 L 4 CIL (FREY),1423,5,7,9,21
0013045860 *3,FILTRO POLEN AIRE CABINA MERCEDES W211- MAHLE (LA156) DGO,1574,1,6,4,11
0013307735 *1,TERMINAL DIRECCION SIN BIELETA SUSPENSION DELANTERA (L/R) MERCEDES W202 (FREY),1674,9,0,5,14
0013307735-2,TERMINAL DIRECCION SIN BIELETA SUSPENSION DELANTERA (L/R) MERCEDES W202 (DELPHI),1443,8,1,4,13
0014211291 *1,KIT 10 PZ HERRAJES BALATAS FRENOS DELANTEROS TRASEROS (L/R) SPRINTER W906 VW CRAFTER 2006 A 2016 (FREY),1811,6,2,7,15
0014211391 *1,KIT 6 PZ HERRAJES BALATAS FRENOS DELANTEROS TRASEROS (L/R) SPRINTER W906 VW CRAFTER 2006 A 2016 (FREY),1959,1,4,6,11
0015405117 *1,SENSOR DE OXIGENO DELANTERO  MERCEDES W210 FREY,1514,6,4,6,16
0015406017 *1,SENSOR  DE OXIGENO MERCEDES W210 FREY,1961,0,2,0,2
0015407617 *1,SENSOR DE OXIGENO TRASERO MERCEDES W211 FREY,1567,7,6,9,22
0015427418 *1,SENSOR DE ESTACIONAMIENTO MERCEDES W164 FREY,1365,6,1,0,7
0015452009 *1,INTERRUPTOR DE LUZ DE FRENO SPRINTER W901-W904 VITO W163 W168 W203 W245 W638 W639 (FREY),1843,4,9,4,17
0015456309 *1,INTERRUPTOR DE LUZ DE FRENO MERCEDES W204-M272 FREY,1405,3,1,9,13
0018203945 *1,LIMPIAPARABRISAS DELANTERO SPRINTER W906 (FREY),1615,7,0,5,12
0018204921 *1,CUARTO CALAVERA DELANTERA IZQUIERDA COLOR AMBAR SPRINTER W901 A W905 (FREY),1585,1,6,1,8
0018228920 *1,DIRECCIONAL ESPEJO LATERAL (L) SPRINTER W906 CRAFTER 2006 A 2016 (FREY),1596,5,1,7,13
0018229020 *1,DIRECCIONAL ESPEJO LATERAL (R) SPRINTER W906 CRAFTER 2006 A 2016 (FREY),1489,5,2,2,9
0018300684 *1,VALVULA SELENOIDE MERCEDES / SPRINTER 901 FREY,1247,4,1,9,14
0019931896 *1,BANDA ACCESORIOS MOTOR MEDIDA 6PK 2398 MM MERCEDES W164 W204 W251 X204 M272 M273 (FREY),1484,3,9,6,18
0019938696 *1,BANDA ACCESORIOS MOTOR MEDIDA 6PK 2260 MM SPRINTER OM611 5 CIL (FREY),1784,8,0,1,9
0022304711 *1,COMPRESOR AIRE ACONDICIONADO MERCEDES W169 W245 (FREY),1206,2,0,3,5
0024203820 *1,BALATAS FRENOS TRASEROS 141 x 46.6 MM SPRINTER W901 A W905 (FREY),1916,7,7,4,18
0024203920 *1,BALATAS FRENOS DELANTEROS MEDIDA 156X65 MM (L/R) SPRINTER W901 A W905 (FREY),1698,5,4,4,13
0024204020 *1,CONJUNTO ALMOHADILLA DE FRENO MERCEDES BENZ SPRINTER 1995-2006 (FREY),1992,4,6,5,15
0024204120 *1,BALATAS FRENOS FRENOS DELANTEROS SPRINTER W901 A W905 (FREY),1306,1,3,1,5
0024206183 *1,Drivers Delantero Derecho FREY,1936,2,7,4,13
0024206283 *1,CALIPER FRENOS DELANTEROS (R) SPRINTER W901 A W905 (FREY),1402,4,7,3,14
0024662901 *1,BOMBA DIRECCION HIDRAULICA HIDRAULICA MERCEDES R170 W202 KOMPRESSOR (FREY),1602,2,8,0,10
0024668101 *1,BOMBA DIRECCION POLEA 124 MM 6 RANURAS MERCEDES W163 M112 M113 (FREY),1982,9,1,4,14
0024668101 *2,BOMBA DIRECCION POLEA 124 MM 6 RANURAS MERCEDES W163 M112 M113 (EMBLER),1578,2,4,0,6
0024668101-100,BOMBA DIRECCION POLEA 124MM 6 RANURAS W163 M112 M113 (FRE) INACTIVO,1259,1,1,2,4
0024669701 *1,BOMBA DIRECCION POLEA 130 MM 6 MM MERCEDES SLK CLK W203 M112 M113 (FREY),1677,6,0,7,13
0024772801 *3,FILTRO COMBUSTIBLE GASOLINA MERCEDES W210 M104 (MAHLE KL65),1271,3,4,9,16
0024773001 *1,FILTRO COMBUSTIBLE GASOLINA CON REGULADOR MERCEDES W202 W203 (FREY TEGNOLOGIA ALEMANA ),1292,1,7,5,13
0024773001 *3,FILTRO COMBUSTIBLE GASOLINA MERCEDES W202 W203 (MAHLE KL82),1371,2,9,4,15
0024773001 *5,FILTRO COMBUSTIBLE GASOLINA MERCEDES W202-W203 MAHLE KL82,1597,9,7,8,24
0025400617 *1,SENSOR DE OXIGENO TRASERO MERCEDES W203 FREY,1473,1,1,2,4
0028115233 *1,LUNA ESPEJO RETROVISOR CON DESEMPAï¿½ANTE (L) SPRINTER W906 CRAFTER 2006 A 2016 (FREY),1606,4,3,1,8
0028115333 *1,LUNA ESPEJO RETROVISOR CON DESEMPAï¿½ANTE (R) SPRINTER W906 CRAFTER 2006 A 2016 (FREY),1202,7,0,1,8
0028115333-100,LUNA ESPEJO CON DESEMPAï¿½ANTE (L) SPRINTER W906 (EMBLER) INACTIVO,1910,0,7,5,12
0028303108 *1,MOTOR DE VENTILACION MERCEDES / SPRINTER 906 FREY,1327,4,3,2,9
0029806502 *1,BALERO EXTERIOR DE RUEDA DELANTERA L-R MERCEDES W210 FREY,1282,9,3,4,16
0029806502 *3,KIT BALERO EXTERIOR DE RUEDA DELANTERA L-R MERCEDES W210 (TOPRAN),1224,4,2,5,11
0029806502 *5,BALERO EXTERIOR DE RUEDA DELANTERA L-R MERCEDES W210 (BCA NTN) SSF,1683,8,5,7,20
0029930996,BANDA ACCESORIOS MOTOR MEDIDA 6PK 2134 MM MERCEDES W166 W212 M276 (GATES),1602,3,6,9,18
0029930996 *1,BANDA ACCESORIOS MOTOR MEDIDA 6PK 2134 MM MERCEDES W166 W212 M276 (FREY),1879,2,8,0,10
0029930996 *5,BANDA ACCESORIOS MOTOR MEDIDA 6PK 2134 MM MERCEDES W166 W212 M276 (CONTINENTAL) SSF,1221,0,0,4,4
0029931196,BANDA ACCESORIOS MOTOR MEDIDA 5PK 1510 MM MERCEDES C117 X156 M133 M270 (DAYCO),1345,1,4,3,8
0029931196 *2,BANDA ACCESORIOS MOTOR MEDIDA 5PK 1510 MM MERCEDES C117 X156 M133 M270 (EMBLER),1226,4,8,2,14
0029931196 *5,BANDA ACCESORIOS MOTOR MEDIDA 5PK 1510 MM MERCEDES C117 X156 M133 M270 (CONTINENTAL),1357,5,4,4,13
0030915301 *1,BOMBA DE GASOLINA MERCEDES W124-L6 FREY,1803,3,0,5,8
0030947504 *3,FILTRO ENTRADA AIRE MOTOR 315 X 277 MM MERCEDES SPRINTER 2.7 L 5 CIL (MAHLE LX511/1) DGO,1244,2,8,6,16
0030948304 *1,FILTRO ENTRADA AIRE MOTOR SPRINTER W901 A W905 (FREY),1655,3,5,1,9
0031532828 *1,SENSOR DE CIGUEï¿½AL MERCEDES W203-M111 FREY,1808,3,7,5,15
0031532828 *3,SENSOR DE CIGUEï¿½AL MERCEDES W203-M111 (WALKER),1518,5,2,1,8
0031596703-100,BUJIA DE IGNICION DOBLE PLATINO MERCEDES W140 GENUINA INACTIVO,1933,5,4,1,10
0031597303 *3,BUJIA IGNICION ENCEDIDO MOTOR 1 ELECTRODO MERCEDES M111 (NGK),1603,4,0,7,11
0032305811 *1,COMPRESOR AIRE SUSPENSION MERCEDES W166 (FREY),1858,4,1,9,14
0034202820,BALATAS FRENOS TRASEROS 64X78 MM MERCEDES W203 W210 C208 C209 R171 PAGID T1152,1470,3,5,1,9
0034202820 *1,BALATAS FRENOS TRASEROS 64X78 MM MERCEDES W203 W210 C208 C209 R171 (FREY),1595,1,0,2,3
0034202820 *3,BALATAS FRENOS TRASEROS 64X78 MM MERCEDES W203 W210 C208 C209 R171 (TRW GDB1421),1611,8,0,9,17
0034202820 *6,BALATAS FRENOS TRASEROS 64X78 MM MERCEDES W203 W210 C208 C209 R171 (ATE) SSF,1912,5,9,9,23
0034202820-100,BALATAS FRENOS TRASEROS MERCEDES W203 INACTIVO,1805,6,9,1,16
0034206020 *1,BALATAS FRENOS DELANTEROS 131X70 MM MERCEDES W203 R171 (FREY),1836,5,0,7,12
0034206020 *3,BALATAS FRENOS DELANTEROS 131X70 MM MERCEDES W203 R171 (TRW GDB1413),1980,3,7,0,10
0034206020 *5,BALATAS FRENOS DELANTEROS 131X70 MM MERCEDES W203 R171 (ATE)  SSF,1708,1,6,5,12
0034207383 *1,CALIPER FRENOS TRASEROS 2 PISTONES 48 MM (L) SPRINTER W906 CRAFTER 2006 A 2016 (FREY),1346,8,8,8,24
0034207483 *1,CALIPER FRENOS TRASEROS 2 PISTONES 48 MM (R) SPRINTER W906 CRAFTER 2006 A 2016 (FREY),1565,4,9,5,18
0034664301 *1,BOMBA DIRECCION POLEA 143 MM 7 RANURAS MERCEDES R171 W203 W204 W211 M271 (FREY),1361,8,5,8,21
0034667201 *1,BOMBA DIRECCION HIDRAULICA VITO VIANO W639 OM646 (FREY),1711,9,3,8,20
0034669301 *1,BOMBA DIRECCION HIDRAULICA SPRINTER W906 (FREY),1969,8,2,4,14
0035427018 *1,SENSOR OXIGENO ANTES DE CATALIZADOR 530 MM MERCEDES W204 W212 X204 (FREY),1756,9,3,1,13
0035427018 *2,SENSOR DE OXIGENO MERCEDES W204 FAE,1856,1,6,8,15
0035427118 *1,SENSOR DE OXIGENO DELANTERO MERCEDES W203 W211 SPRINTER 906 (FREY),1855,8,7,2,17
0035427318 *1,SENSOR DE OXIGENO TRASERO MERCEDES W203 W211 SPRINTER 906 (FREY),1669,8,7,6,21
0038202956 *1,LUZ DIRECCIONAL INFERIOR LATERAL (L/R) COLOR AMBAR SPRINTER W906 (FREY),1908,9,5,5,19
0039937296 *2,BANDA ACCESORIOS MOTOR MEDIDA 6PK 2404 MM MERCEDES W164 W204 W251 X204 M272 M273 DAYCO,1891,0,0,4,4
0039937296 *3,BANDA ACCESORIOS MOTOR MEDIDA 6PK 2404 MM MERCEDES W164 W204 W251 X204 M272 M273 CONTINENTAL,1345,7,8,1,16
0039970689 *1,TUBO DEPOSITO ANTICONGELANTE RADIADOR MERCEDES W203 M271 (FREY),1797,4,2,5,11
00403160A8 ,SENSOR NIVEL DE ACEITE BMW E60 E90 SEMINUEVO (ORIGINAL),1783,0,7,8,15
0041530028 *1,SENSOR DE ARBOL DE LEVAS MERCEDES W202-M111 FREY,1291,8,2,8,18
0041536928 *1,SENSOR ARBOL LEVAS MOTOR (L) MERCEDES M112 M113 (FREY),1332,4,5,7,16
0041591303,BUJIAS DE IGNICION DOBLE PLATINO MERCEDES W203-M271 1a GEN BOSCH,1557,1,1,1,3
0041591803 *1,BUJIA IGNICION MOTOR IRIDIUM MERCEDES M271 M272 M273 (FREY TEGNOLOGIA ALEMANA),1739,2,2,0,4
0041591803 *5,BUJIA IGNICION MOTOR DOBLE PLATINO MERCEDES M271 M272 M273 (BOSCH) SSF,1647,0,5,9,14
0041591803-100,BUJIA IGNICION DOBLE PLATINO MERCEDES M272 M273 (GENUINA) INACTIVO,1845,5,8,0,13
0041591903 *3,BUJIA IGNICION DOBLE PLATINO MERCEDES W163 (DENSO 4503),1440,4,2,2,8
0041591903 *5,BUJIA DOBLE PLATINO HIGH POWER MERCEDES M112 M113 (BOSCH) SSF,1840,8,7,2,17
0041591903-100,BUJIA IGNICION DOBLE PLATINO MERCEDES W163 (GENUINA) INACTIVO,1368,8,9,0,17
0041594503 *1,BUJIA IGNICION DOBLE PLATINO MERCEDES M271 1a GEN (FREY TEGNOLOGIA ALEMANA),1385,0,9,1,10
0041597903 *1,BUJIA IGNICION IRIDIUM MERCEDES M270 M256 (FREY TEGNOLOGIA ALEMANA),1791,2,0,8,10
0041597903 *5,BUJIA ENCENDIDO IGNICION DOBLE PLATINO HIGH POWER MERCEDES M274 M276 (BOSCH) SSF,1960,4,4,9,17
0041597903 *6,BUJIA ENCENDIDO IGNICION DOBLE PLATINO HIGH POWER MERCEDES M274 M276 (NGK) DSC,1846,7,2,5,14
0041597903-100,BUJIA IGNICION IRIDIUM MERCEDES M274 M276 (GENUINA) INACTIVO,1327,4,6,2,12
0041598103 *2,BUJIA IGNICION IRIDIUM MERCEDES M152 M156 M157 M276 (GENUINA),1588,0,1,3,4
0041598103 *5,BUJIA IGNICION IRIDIUM MERCEDES M152 M156 M157 M276 (BOSCH) SSF,1207,3,0,9,12
00442-100,BALATAS FRENOS INACTIVO,1483,6,4,2,12
004420022067-1,BALATAS FRENOS DELANTEROS MERCEDES R170 W202-W210 TEXTAR,1357,7,7,5,19
0044200520 *3,BALATAS FRENOS DELANTEROS MERCEDES W203 C230K (TRW GDB1543),1210,5,1,0,6
0044205120 *1,BALATAS FRENOS DELANTEROS 102X79 MM MERCEDES W203 C209 R171 (FREY),1386,9,8,1,18
0044205120 *3,BALATAS FRENOS DELANTEROS 102X79 MM MERCEDES W203 C209 R171 (TRW GDB1693),1251,6,0,7,13
0044205120 *5 ,BALATAS FRENOS DELANTEROS 102X79 MM MERCEDES W203 C209 R171 (JURID) SSF,1797,4,1,3,8
0044205583 *1,CALIPER FRENOS DELANTEROS 2 PISTONES 48 MM (L) SPRINTER W906 CRAFTER 2006 A 2016 (FREY),1248,8,9,1,18
0044205683 *1,CALIPER FRENOS DELANTEROS 2 PISTONES 48 MM (R) SPRINTER W906 CRAFTER 2006 A 2016 (FREY),1536,5,5,0,10
0044205883 *1,CALIPER FRENOS DELANTEROS 2 PISTONES 52 MM (R) SPRINTER W906 (FREY),1573,9,5,9,23
0044206920 *1,BALATAS FRENOS DELANTEROS MERCECES SPRINTER (FREY),1334,3,7,5,15
0044208120 *1,BALATAS FRENOS TRASEROS 165X68.2 MM SPRINTER W901 A W905 (FREY),1421,2,1,0,3
0044208220 *1,BALATAS FRENOS DELANTEROS 169 X 73 MM SPRINTER W906 VW CRAFTER 2006 A 2016 (FREY),1568,0,8,5,13
0044208720 *1,BALATAS FRENOS DELANTEROS 137X68 MM MERCEDES W211 (FREY),1291,8,6,1,15
0044208720 *5,BALATAS FRENOS DELANTEROS 137X68 MM MERCEDES W211 (FERODO) SSF,1409,2,5,9,16
0044209120 *3,BALATAS FRENOS TRASEROS MERCEDES R170-W202 (TRW GDB1335),1299,8,9,0,17
0045420718,SENSOR DE OXIGENO TRASERO R-L MERCEDES W204-M272 BMTR,1207,8,4,1,13
0045420718 *1,SENSOR DE OXIGENO TRASERO R-L MERCEDES W204-M272 FREY,1932,8,4,7,19
0045420818 *1,SENSOR DE OXIGENO DELANTERO R-L MERCEDES W204-M272 FREY,1603,9,1,6,16
0051513901 *1,MARCHA DE MOTOR DE ARRANQUE W203 FREY,1245,1,9,0,10
0051513901 *2,MARCHA DE MOTOR DE ARRANQUE W203 (EMBLER),1517,5,8,7,20
0051535528 *1,SENSOR PRESION ESCAPE MERCEDES W211 SPRINTER W906 (FREY),1730,3,6,0,9
0054204220 *3,BALATAS FRENOS TRASEROS 123X52 MM MERCEDES W204 X204 (TRW GDB2051),1524,5,4,1,10
0054204220 *5,BALATAS FRENOS TRASEROS 123X52 MM MERCEDES W204 X204 (ATE) SSF,1264,2,8,7,17
0054204220 *6,BALATAS FRENOS TRASEROS 123X52 MM MERCEDES W204 X204 (FERODO) SSF,1542,7,5,2,14
0054204220 *7,BALATAS FRENOS TRASEROS 123X52 MM MERCEDES W204 X204 (JURID) SSF,1887,2,4,1,7
0054204220 *8,BALATAS FRENOS TRASEROS 123X52 MM MERCEDES W204 X204 (ATE CERAMIC) SSF,1200,7,9,5,21
0054204220-100,BALATAS FRENOS TRASEROS 123X55 MM MERCEDES W204 INACTIVO,1788,5,5,7,17
0054204820 *1,BALATAS FRENOS DELANTEROS 165.3 X 68.2 MM MERCEDES X204 (FREY),1723,7,8,6,21
0054207720-100 ,BALATAS FRENOS MERCEDES W212 X218 INACTIVO,1845,3,6,8,17
0054661401 *1,BOMBA DIRECCION POLEA 124 MM 6 RANURAS MERCEDES W211 M272 (FREY),1573,5,1,9,15
0054662201 *1,BOMBA DIRECCION POLEA 128 MM 6 RANURAS MERCEDES W164 M272 M273 (FREY),1509,5,3,5,13
0054662201 *2,BOMBA DIRECCION POLEA 128 MM 6 RANURAS MERCEDES W164 M272 M273 (EMBLER),1516,8,3,6,17
0054662201-100,BOMBA DE DIRECCION HIDRAULICA MERCEDES W164 SEMINUEVA INACTIVO,1594,5,3,0,8
0054662201-101,BOMBA DIRECCION HIDRAULICA MERCEDES W164 M272 (BEMQW) INACTIVO,1963,9,1,7,17
0054664201 *1,BOMBA DIRECCION POLEA 120 MM 7 RANURAS MERCEDES W204 W164 X164 W251 (FREY),1859,3,2,2,7
0061510301 *1,MARCHA MOTOR ARRANQUE MERCEDES W169 W245 (FREY),1598,5,5,5,15
0061510501 *1,MARCHA MOTOR ARRANQUE MERCEDES W164 M112 M272 V8 5.0 L (FREY),1939,4,4,3,11
0061514501 *1,MARCHA MOTOR ARRANQUE START STOP SPRINTER OM646 OM651 VITO 639 (FREY),1340,8,1,6,15
0061533928 *1,SENSOR POSICION CIGï¿½Eï¿½AL SMART FORTWO W451 M132 2010 A 2015 (FREY),1870,7,3,9,19
0061539528 *1,SENSOR DIRENCIAL PRESION ESCAPE GASES MOTOR SPRINTER OM651 (FREY),1204,5,6,1,12
0063230200 *1,AMORTIGUADOR AIRE SUSPENSION DELANTERA (L/R) MERCEDES W463 (FREY),1800,1,2,4,7
0064200120-1,BALATAS FRENOS TRASEROS MERCEDES W211 TEXTAR 2333403,1763,2,4,6,12
0064202320 *1,BALATAS FRENOS TRASEROS 106.3 X58.9 MM MERCEDES W176 W246 C117 R172 (FREY),1965,4,6,5,15
0064202320 *3,BALATAS FRENOS TRASEROS 106.3 X58.9 MM MERCEDES W176 W246 C117 R172 (TRW GDB1920),1671,9,6,1,16
0064202320 *5,BALATAS FRENOS TRASEROS 106.3 X58.9 MM MERCEDES W176 W246 C117 R172 (FERODO) SSF,1753,3,0,8,11
0064208520 *4,BALATAS FRENOS DELANTEROS 144 X 71 MERCEDES W176 W246 ( BREMBO ),1851,0,9,2,11
0064662301 *1,BOMBA DIRECCION POLEA 128 MM 6 RANURAS MERCEDES X204 M272 (FREY),1929,8,7,3,18
0064664301 *1,BOMBA DIRECCION POLEA 128 MM 6 RANURAS MERCEDES R172 W204 W212 M271 (FREY),1863,1,1,6,8
0064664501 *1,BOMBA DIRECCION POLEA 128 MM 6 RANURAS CON SENSOR MERCEDES W212 M272 M273 (FREY),1966,6,3,6,15
0064667801 *1,BOMBA DIRECCION LICUADORA SPRINTER VITO VIANO OM646 OM651 (FREY),1462,5,1,7,13
0065422218 *1,SENSOR DE OXIGENO TRASERO MERCEDES W204 FREY,1809,8,8,3,19
0065451014 *1,INTERRUPTOR SWICH PEDAL CLUTCH SPRINTER W906 (FREY),1599,6,5,1,12
0074205520 *1,BALATAS FRENOS DELANTEROS 146.2 X 71.5  MM MERCEDES W204 W212 R172 (FREY),1414,1,1,6,8
0074206120 *1,BALATAS FRENOS TRASEROS 123X52 MM MERCEDES W204 X204 (FREY),1501,1,3,3,7
0074206420 *3,BALATAS FRENOS MERCEDES BENZ W202 (TRW GDB1822),1697,0,3,3,6
0074206720 *3,BALATAS FRENOS TRASEROS MERCEDES W211 (TRW GDB1546),1678,1,0,6,7
0074206720 *4,BALATAS FRENOS TRASEROS MERCEDES W211 (TEXTAR),1743,3,9,9,21
0074206820 *3,BALATAS FRENOS TRASEROS MERCEDES W212 TRW,1691,9,3,2,14
0074206920 *3,BALATAS DELANTERAS MERCEDES W166 (TRW GDB1972),1686,9,0,3,12
0074207420 *3,BALATAS FRENOS DELANTEROS 165X68 MM MERCEDES X204 (TRW GDB1798),1275,9,2,1,12
0074207420 *5,BALATAS FRENOS DELANTEROS 165X68 MM MERCEDES X204 (FERODO) SSF,1582,1,4,1,6
0074207420 *9,BALATAS FRENOS DELANTEROS 165X68 MM MERCEDES X204 (FTE),1814,1,7,3,11
0074207520 *1,BALATAS FRENOS DELANTEROS 188X74 MM MERCEDES W204 W212 W213 R172 (FREY),1846,9,8,6,23
0074207520 *5,BALATAS FRENOS DELANTEROS 188X74 MM MERCEDES W204 W212 W213 R172 (FERODO) SSF,1272,4,8,4,16
0074207520 *6,BALATAS FRENOS DELANTEROS 188X74 MM MERCEDES W204 W212 W213 R172 (ATE) SSF,1585,0,0,0,0
0074207720,BALATAS FRENOS TRASEROS 116X50 MM MERCEDES W166 X156 (TEXTAR 2521501),1528,3,5,8,16
0074207720 *1,BALATAS FRENOS TRASEROS 116X50 MM MERCEDES W166 X156 (FREY),1575,3,2,9,14
0074207720 *3,BALATAS FRENOS TRASEROS 116X50 MM MERCEDES W166 X156 (TRW GDB1947),1580,7,8,9,24
0074207720 *5,BALATAS FRENOS TRASEROS 116X50 MM MERCEDES W166 X156  (FERODO) SSF,1947,7,3,8,18
0074207720 *6,BALATAS FRENOS TRASEROS 116X50 MM MERCEDES W166 X156 (ATE) SSF,1809,5,6,5,16
0074208020 *3,BALATAS FRENOS DELANTEROS MERCEDES W166-X166 (TRW GDB1946),1575,1,7,6,14
0074208120 *1,BALATAS FRENOS DELANTEROS 193.3 X 64 MM MERCEDES W166 X166 (FREY),1436,8,9,0,17
0074208120 *3,BALATAS FRENOS DELANTEROS MERCEDES W166-X166 TEXTAR,1487,2,2,0,4
0074208120-100,BALATAS FRENOS DELANTEROS MERCEDES W166-X166 INACTIVO,1713,4,2,4,10
0074208620 *1,BALATAS FRENOS TRASEROS 116X50 MM MERCEDES W166 (FREY),1857,0,0,9,9
0074208620 *3,BALATAS FRENOS TRASEROS 116X50 MM MERCEDES W166 (TRW GDB1947),1454,3,3,1,7
0074208620 *5,BALATAS FRENOS TRASEROS 116X50 MM MERCEDES W166 (FERODO) SSF,1380,9,0,8,17
0074209220,BALATAS FRENOS DELANTEROS 146X71 MM MERCEDES W204 W212 R172  FTE BL2027A4,1287,7,4,8,19
0074209220 *3,BALATAS FRENOS DELANTEROS 146.2 X 71.5  MM MERCEDES W204 W212 R172 (TRW GDB1736),1228,9,8,3,20
0074209220 *5,BALATAS FRENOS DELANTEROS 146.2 X 71.5  MM MERCEDES W204 W212 R172 (ATE) SSF,1461,6,0,2,8
0074209220 *6,BALATAS FRENOS DELANTEROS 146.2 X 71.5  MM MERCEDES W204 W212 R172 (FERODO) SSF,1438,2,7,6,15
0074209320 *3,BALATAS TRASERAS MERCEDES C63 AMG CON CONTRAPESO (TRW GDB1856),1950,8,9,2,19
00742095-100,BALATAS FRENOS TRASEROS 106 X 59 MERCEDES W176 W246 INACTIVO,1295,4,5,3,12
0075426418 *2,SENSOR OXIGENO TRASERO 390 MM MERCEDES W205 W212 X204 (EMBLER),1971,0,3,9,12
0084200020 *3,BALATAS FRENOS DELANTEROS 193X72 MM MERCEDES X166 W166 (TRW GDB1970),1304,0,0,1,1
0084200020 *5 ,BALATAS FRENOS DELANTEROS 193X72 MM MERCEDES X166 W166 (JURID) SSF,1773,6,7,5,18
0084200320,BALATAS FRENOS DELANTEROS 144.3X71.5 MM MERCEDES W176 W246 C117 X156 (TEXTAR),1524,9,9,8,26
0084200320 *1,BALATAS FRENOS DELANTEROS 144.3X71.5 MM MERCEDES W176 W246 C117 X156 (FREY),1733,3,3,4,10
0084200320 *3,BALATAS FRENOS DELANTEROS 144.3X71.5 MM MERCEDES W176 W246 C117 X156 (TRW GDB1932),1997,4,4,5,13
0084200320 *5,BALATAS FRENOS DELANTEROS 144.3X71.5 MM MERCEDES W176 W246 C117 X156 (FERODO) SSF,1744,3,1,0,4
0084200320 *6,BALATAS FRENOS DELANTEROS 144.3X71.5 MM MERCEDES W176 W246 C117 X156 (AKEBONO EURO) SSF,1449,1,0,5,6
0084200420 *3,BALATAS FRENOS DELANTEROS 129X71 MM MERCEDES W176 W246 (TRW GDB1933),1941,0,9,4,13
0084201120 *3,BALATAS FRENOS TRASEROS W222 S500 S600 R190 AMG GT (TRW GDB2079),1910,3,4,1,8
0084202020 *1,BALATAS FRENOS DELANTEROS 189.8 X93.2 MM MERCEDES W166 AMG X166 AMG (FREY),1967,4,2,8,14
0084202020 *3,BALATAS FRENOS DELANTEROS 189.8 X93.2 MM MERCEDES W166 AMG X166 AMG (TRW GDB1734),1430,7,1,5,13
0084202020 *6,BALATAS FRENOS DELANTEROS 189.8 X93.2 MM MERCEDES W166 AMG X166 AMG (FERODO) SSF,1868,1,2,9,12
0084202020-100,BALATAS FRENOS DELANTEROS 189X93 MM MERCEDES W166 (TRW GDB1734) INACTIVO,1254,8,3,4,15
008420362-100,BALATAS FRENOS DELANTEROS MERCEDES INACTIVO,1792,5,1,0,6
0084203820 *3,BALATAS FRENOS DELANTERAS 176 X 77 MERCEDES W205 NO PAQ AMG (TRW GDB2097),1571,0,3,0,3
0091533128 *1,VALVULA SOLENOIDE CONTROL VACIO TUBOCARGADOR SPRINTER OM651 (FREY),1513,8,3,1,12
0109977992 *1,BANDA ACCESORIOS MOTOR MEDIDA 6PK 2140 MM MERCEDES W202 M11 (FREY),1744,9,0,7,16
0111542702 *1,ALTERNADOR GENERADOR VOLTAJE 12V MERCEDES M112 (FREY),1309,8,1,0,9
0114216198 *1,KIT PERNO PINZA DE FRENO MERCEDES VITO W639 (FREY),1402,2,4,9,15
0115425117 *5,SENSOR DE TEMPERATURA DE MOTOR MERCEDES R129 W124 W140 W202 W210 (FACET) SSF,1931,0,0,1,1
0119970292 *1,BANDA DE ALTERNADOR MERCEDES MOTOR M111 FREY 6KX1875,1716,1,0,3,4
0119970647 *1,RETEN DE CIGUEï¿½AL TRASERO MERCEDES W202 FREY,1325,0,5,3,8
0119972192 *1,BANDA ACCESORIOS 6PK2205 SPRINTER OM611 MERCEDES M111 (FREY),1493,7,8,8,23
0119973492 *1,BANDA ACCESORIOS MOTOR MEDIDA 6PK 2380 MM MERCEDES C209 C215 W203 W211 W219 W220 M113 (FREY),1750,0,9,3,12
0119974992 *1,BANDA ACCESORIOS MOTOR 6PK 2215 MERCEDES SPRINTER OM611 (FREY),1413,0,2,4,6
0119975892 *1,BANDA DE SUPERCARGADOR MERCEDES MOTOR M111 FREY 6KX1330,1352,5,0,6,11
0119979792 *1,BANDA ACCESORIOS MOTOR MEDIDA 6PK 2390 MM MERCEDES C208 W163 W202 W210 M112 M113 (FREY),1489,6,0,6,12
0119979792 *2,BANDA ACCESORIOS MOTOR MEDIDA 6PK 2390 MM MERCEDES C208 W163 W202 W210 M112 M113 BMT,1866,4,7,1,12
0129973592 *1,BANDA MERCEDES W176 FREY,1569,3,8,0,11
0129975592 *1,BANDA SUPERCARGADOR 6PK1352 MERCEDES R170 (FREY),1898,8,1,9,18
0129975992 *1,BANDA ACCESORIOS MOTOR MEDIDA 6PK 1775 MM MERCEDES R170 M111 (FREY),1720,8,7,7,22
0139976946 *1,RETEN DIFERENCIAL TRASERO 98X75X10 MM SPRINTER W906 (FREY),1603,6,8,0,14
0139977492 *1,BANDA ACCESORIOS MOTOR MEDIDA 7PK 2418 MM MERCEDES W203 M271 1a GEN (FREY),1865,8,9,7,24
0139977492-100,BANDA DE ACCESORIOS MERCEDES W203 INACTIVO,1342,1,0,3,4
0141543002 *1,ALTERNADOR GENERADOR VOLTAJE 150 AMPERES MERCEDES W204 W212 R172 M272 SPRINTER W906 (FREY),1392,9,6,5,20
0159971246 *1,SELLO DEL EJE DE SALIDA DE TRANSMISION MERCEDES W204 FREY,1855,5,7,2,14
0160310008-100,BIELETA DE DIRECCION INTERNA L-R MERCEDES W164-X164 M273 INACTIVO,1892,0,9,9,18
0179977447 *2,RETEN DE CIGUEï¿½AL TRASERO MERCEDES W202-M111 FREY,1794,1,5,8,14
0189970447 *1,SELLO DE BOMBA DE TRANSMISION MERCEDES W204 FREY,1675,0,1,6,7
0199973647 *1,Cubo De Rueda Para Mercedes-Benz  FREY,1818,3,5,5,13
02-36950-01 *1,JUEGO JUNTAS COMPLETO MOTOR DIESEL SPRINTER OM651 (FREY),1374,8,1,7,16
021115562A *3,FILTRO ACEITE MOTOR AUDI Q7 V6 CAYENNE 3.2L TOUAREG V6 (MAHLE OX160D),1666,2,5,0,7
022103245B *S,SEPARADOR ACEITE MOTOR PCV AUDI VW MOTOR 3.2 FSI 1a GEN (EMBLER) GOG,1464,3,9,6,18
022103483E *5,JUNTA TAPA PUNTERIAS AUDI VW MOTOR 3.2 L ( ELRING) SSF,1955,0,1,0,1
022103483E *6,JUNTA TAPA PUNTERIAS AUDI VW MOTOR 3.2 L (VICTOR REINZ) SSF,1450,9,3,4,16
0221506002 *1,BOBINA ENCENDIDO IGNICION MOTOR MERCEDES M111 KOMPRESSOR (FREY),1262,7,6,9,22
022905715D *5,BOBINA DE ENCENDIDO VW (BREMI),1253,6,5,7,18
0232500201 *1,KIT 2 PZ CLUTCH PLATO DISCO SPRINTER OM651 2.1 L 4 CIL (FREY),1719,4,6,9,19
023695001B-100,JUEGO JUNTAS MOTOR SPRINTER OM651 (FREY) INACTIVO,1553,9,3,5,17
0239971245 *1,RETEN DE CIGUEï¿½AL TRASERO MERCEDES W203 FREY,1669,7,9,3,19
0239978447 *1,RETEN CIGï¿½Eï¿½AL DELANTERO 45X12X8 MERCEDES M112 M113 M272 M273 (FREY),1333,6,0,7,13
0258017209 *5,SENSOR DE OXIGENO DELANTERO MINI R56 / 710 MM ( BOSCH ) SSF,1633,2,9,3,14
0258986774 *3,SENSOR OXIGENO DESPUES CATALIZADOR BANCO (2) 300MM MERCEDES W164 (BOSCH),1354,2,4,6,12
0259971647 *1,RETEN INTERIOR DE RUEDA DELANTERA ( L / R ) MERCEDES W210 FREY,1392,4,2,1,7
0261520572 *3,BOMBA GASOLINA ALTA PRESION CONECTOR ANCHO AUDI A1 A3 VW SEAT (BOSCH),1998,1,6,3,10
0275456432 *1,MODULO CONTROL MOTOVENTILADOR ENFRIAMIENTO MOTOR MERCEDES W202 (FREY),1821,9,3,1,13
0280217810 *1,SENSOR MASA AIRE MOTOR MAF MERCEDES C209 C215 W202 W210 W219 W220 W163 M113 (FREY),1870,2,4,8,14
028103171B *5,RETEN CIGUEï¿½AL TRASERO 131X85 MM AUDI VW SEAT 1.8 TURBO 20 VALVULAS (CORTECO) SSF,1933,3,4,4,11
02E305051B *3,FILTRO ACEITE TRANSMISION AUTOMATICA 0D9 AUDI VW SEAT (MAHLE),1719,3,2,8,13
02E409061B *2,ENFRIADOR ACEITE TRANSMISION AUTOMATICA VOLKSWAGEN BORA PASSAT (EMBLER) GOG,1798,3,3,3,9
030103175B,VALVULA PCV (EMBLER) GOG,1968,6,1,0,7
030105561G *5,METALES DE BIELA EN ESTANDAR AUDI A1-1.4L KOLBENSCHMIDT 77836600,1621,5,1,5,11
030121121B *5,CARCASA ADAPTADOR TERMOSTATO DE MOTOR AUDI VW (FEBI) SSF,1488,5,0,7,12
032905106B *5,PAQUETE BOBINA IGNICION VW GOL JETTA BEETLE 2.0 L (BREMI) SSF,1635,4,5,7,16
036105701AB,METALES DE CENTRO EN ESTANDAR BMW AUDI A1 / 1.4L ( KOLBENSCHMIDT 77534600 ),1739,4,6,0,10
036129620H *3,FILTRO ENTRADA AIRE MOTOR SEAT IBIZA V 1.6L (MAHLE LX2010),1694,6,8,0,14
036905715C *2,BOBINA ENCENDIDO IGNICION MOTOR AUDI VW SEAT 1.4 L (EMBLER) GEM,1556,9,2,6,17
038103085C *5,RETEN ARBOL LEVAS (L/R) MOTOR 47X32X10 AUDI VW SEAT 1.8 TURBO 20 VALVULAS (ELRING) SSF,1648,0,2,0,2
038109309C,PUNNTERIAS HIDRAULICAS MOTOR 1.9 Y 2.0 VW (EMBLER),1602,6,9,5,20
038109309C -1,PUNNTERIAS HIDRAULICAS MOTOR 1.9 Y 2.0 VW (INA),1504,9,9,9,27
038903803E *3,REGULADOR DE ALTERNADOR AUDI A2 A3 A4 A6 A8 SEAT VW (BOSCH),1297,5,4,8,17
03C103383R *2,JUNTA CABEZA MOTOR MEDIDA STANDAR 0.8 MM AUDI SEAT VW 1.4 TSI (EMBLER) GOG,1988,2,1,3,6
03C103383R *3,JUNTA CABEZA MOTOR MEDIDA STANDAR 0.8 MM AUDI SEAT VW 1.4 TSI (CORTECO),1476,6,2,7,15
03C117021J *2,ENFRIADOR ACEITE MOTOR AUDI VW SEAT A1 A3 1.4L (EMBLER) GOG,1982,1,6,6,13
03C121004D *2,BOMBA AGUA MECANICA ENFRIAMIENTO MOTOR CON SENSOR MAGNETICO AUDI A1 1.4 TSI (EMBLER) HT,1733,3,6,5,14
03C121008H *2,BOMBA AGUA MECANICA ENFRIAMIENTO MOTOR SEAT TOLEDO 4a GEN. 1.4 NO TURBO (EMBLER) HT,1273,0,8,1,9
03C121019J *1,BOMBA AGUA MECANICA ENFRIAMIENTO MOTOR AUDI A1 1.6 (EMBLER),1782,7,8,0,15
03C121111AM *2,TOMA AGUA TERMOSTATO ENFRIAMIENTO MOTOR  BEETLE GOL JETTA 2.5  L 5 (EMBLER) GOG,1789,1,1,5,7
03C906031A *2,INYECTOR COMBUSTIBLE GASOLINA ALTA PRESION AUDI A4 A6 VW SEAT (EMBLER),1323,5,2,9,16
03F121004E *2,BOMBA AGUA ENFRIAMIENTO MOTOR AUDI VW 1.2 L (EMBLER) GOG,1570,0,3,5,8
03F133062B *2,CUERPO ACELERACION AUDI A1 A3 A4 5 VW SEAT 1.2 TSI 1.4 (EMBLER),1271,2,8,5,15
03H103202A-1,MANGUERA DE VENTILACION PCV AUDI MOTOR 3.6L (VIKA),1289,8,9,8,25
03H103429H *2,TAPA PUNTERIAS MOTOR AUDI 3.6L V6  2007 A 2010 VW 3.6L V6 2007 A 2016 (EMBLER) GOG,1764,1,5,1,7
03H103429H *S,SEPARADOR ACEITE PCV MOTOR AUDI 3.6L V6  2007 A 2010 VW 3.6L V6 2007 A 2016 (EMBLER) GOG,1389,8,8,2,18
03H121008M *5,BOMBA AGUA MECANICA ENFRIAMIENTO MOTOR TUAREG 2011 A 2017 TERAMONT 2018 A 2023 3.6 L (GENUINA) SSF,1650,9,7,8,24
03H121113 *1,TERMOSTATO ENFRIAMIENTO MOTOR 3.6 FSI Q7 TUAREG PASSAT (EMBLER),1958,7,0,4,11
03H121113D *5,TERMOSTATO ENFRIAMIENTO MOTOR AUDI Q7 VW PASSAT TUAREG 2007 A 2010 3.6 L (REIN) SSF,1752,0,0,6,6
03H121117B *2,TERMOSTATO ENFRIAMIENTO MOTOR AUDI Q7 VW PASSAT TOURAGE (EMBLER) GOG,1317,3,8,9,20
03H127025S *5,BOMBA COMBUSTIBLE GASOLINA ALTA PRESION CAYENNE PASSAT PORSCHE TOUAREG VW V6 3.6L (HITACHI) SSF,1996,5,3,2,10
03L105266EK *3,VOLANTE MOTRIZ DOBLE MASA SIN KIT CLUTCH AUDI A3 SEAT VW (LUK),1820,5,1,6,12
03L115389 *2,SEPARADOR TOMA ACEITE MOTOR CON ENFRIADOR AUDI SEAT VW 1.6 2.0 TDI (EMBLER) GOG,1761,0,4,8,12
03L115389-100,SEPARADOR ACEITE MOTOR PCV AUDI SEAT VW 1.6 2.0 TDI INACTIVO,1853,7,2,6,15
03L115389h-100,CAJA DE FILTRO DE ACEITE Y ENFRIADOR AUDI VIKA GOG INACTIVO,1492,4,3,8,15
03L115466 *3,FILTRO ACEITE MOTOR VOLKSWAGEN-AUDI (MAHLE OX388D),1906,4,4,5,13
03L121132AA,TERMOSTATO DE MOTOR AUDI A3 (EMBLER),1304,2,3,8,13
03L253014A *2,TURBO CARGADOR CARTUCHO VOLKSWAGEN AMAROK 2.0 TDI (EMBLER) GOG,1660,2,7,0,9
041591803-100,BUJIA IGNICION DOBLE PLATINO MERCEDES MOTOR INACTIVO,1226,7,5,9,21
049103485A *5,TAPON LLENADO DE ACEITE MOTOR AUDI VW SEAT (FEBI) SSF,1953,6,0,6,12
04E109675,SELLO VALVULA CABEZA  AUDI SEAT VOLKS WAGEN MOTOR 1.4 TSI 1.8 2.0 CORTECO,1646,8,5,3,16
04E115561H *3,FILTRO ACEITE MOTOR AUDI VW SEAT 1.4 TSI (MAHLE OC593/3),1253,1,7,0,8
04E115561T *3,FILTRO ACEITE MOTOR VOLKSWAGEN GOLF 1.4 L (MAHLE OC977/1),1437,4,8,9,21
04E115561T *5,FILTRO ACEITE MOTOR MM 85 X 72 MM AUDI VW (GENUINO) SSF,1251,3,9,2,14
04E121600AN *2,BOMBA AGUA ENFRIAMIENTO MOTOR CON TERMOSTATO AUDI A1 1.4L (EMBLER) HT,1608,6,1,5,12
04E121600AN-100,BOMBA DE AGUA MECANICA SIN TERMOSTATO AUDI A1-1.4L (EMBLER) INACTIVO,1539,9,1,4,14
04E121605E *3,BANDA DENTADA AUDI A3 1.4TFSI SEAT VW (FEBI),1568,9,1,4,14
04E121605E *5,CORREA DENTADA (CONTINENTAL) SSF,1310,9,1,0,10
04E129620 *3,FILTRO ENTRADA AIRE MOTOR AUDI 2016 A 2018 A3 E TRON VW 2013 A 2016 JETTA (MAHLE LX3525) DGO,1718,7,0,3,10
04E129620A *3,FILTRO ENTRADA AIRE MOTOR SEAT IBIZA 1.6 (LX2876/1),1431,6,8,3,17
04E905601B *5,BUJIA DE IGNICION DOBLE PLATINO AUDI A3 A1 Q3 1.4L (BOSCH),1844,7,7,9,23
04L121011M *2,BOMBA AGUA MECANICA ENFRIAMIENTO MOTOR AUDI A1 1.6 (EMBLER) GOG,1864,4,6,9,19
050121113C *5,TERMOSTATO ENFRIAMIENTO MOTOR 87ï¿½ AUDI WV 1.8L TURBO 20 VALVULAS (MAHLE) SSF,1318,2,9,2,13
05066386AA *5,1 GALON CON 3.785  LITROS ANTICONGELANTE CONSENTRADO COLOR AZUL (VALVOLINE ) SSF,1571,7,4,6,17
05175571AA *3,FILTRO ACEITE MOTOR MERCEDES W211 (MAHLE OX380D),1947,8,5,1,14
056115561G *3,FILTRO ACEITE MOTOR AUDI A3 A4 2.0L (MAHLE OC47),1672,3,5,7,15
057115561 *3,FILTRO ACEITE MOTOR AUDI Q7 CAYENNE TOUAREG 8 CIL 4.2L (MAHLE OX196/3D),1905,4,9,5,18
0580254911 *1,BOMBA GASOLINA ELECTRICA MERCEDES W124 (FREY),1732,5,1,2,8
058103383Q *5,JUNTA CABEZA MOTOR MEDIDA STANDAR 1.22 MM AUDI A4 VOLKSWAGEN 1.8 (ELRING) SSF,1340,9,0,4,13
058109088 *T,TENSOR HIDRï¿½ULICO CADENA ARBOLES LEVAS AUDI VW SEAT 1.8T 20 VALVULAS (EMBLER),1299,8,0,0,8
058109088KXLBQ *2,KIT 4 PZ JUNTAS TENSOR CADENA ARBOLES LEVAS AUDI VW SEAT 1.8T 20 VALVULAS (EMBLER) HPS,1890,4,4,1,9
058109119C *5,BANDA DISTRIBUCION TIEMPO MOTOR AUDI VW SEAT 1.8 TURBO 20 VALVULAS (CONTINENTAL) SSF,1689,1,7,3,11
058109229B *3,CADENA SUPERIOR ARBOLES LEVAS CABEZA MOTOR AUDI VW SEAT 1.8T 20 VALVULAS (EMBLER) HPS,1657,7,9,2,18
058109601C *5,VALVULA ADMISION CABEZA MOTOR 6 MM AUDI 1.8L TURBO 20 VALVULAS 2.7L 2.8L 3.0L (INTERVALVES) SSF,1734,3,1,1,5
058109611E *5,VALVULA ESCAPE GASES MOTOR 6 MM AUDI VW SEAT 1.8 TURBO 20 VALVULAS (CRP) SSF,1784,1,4,6,11
058121301B *5,ASPAS DE VENTILADOR MECANICO AUDI A4 VW PASSAT (URO) SSF,1580,6,1,4,11
058129717D *1,JUNTA MULTIPLE ADMISION AIRE MOTOR AUDI VW SEAT 1.8 TURBO 20 VALVULAS (ELRING) SSF,1748,4,8,6,18
058133753 *K,KIT MANGUERAS VACIO FRENOS AUDI SEAT VW 1.8 TURBO 20 VALVULAS (EMBLER) GOG,1673,9,2,4,15
058133843 *6,FILTRO ENTRADA AIRE MOTOR 212 X 254 MM AUDI VW SEAT (MAHLE) SSF,1361,2,8,1,11
058198025A,JUNTA TAPA PUNTERï¿½AS AUDI VW SEAT MOTOR 1.8T 20 VALVULAS EMBLER,1374,1,6,8,15
058198025A *3,JUNTA TAPA PUNTERï¿½AS MOTOR AUDI VW SEAT 1.8T 20V (CORTECO),1814,2,7,5,14
058198025A *5,JUNTA TAPA PUNTERï¿½AS AUDI VW SEAT MOTOR 1.8 TURBO 20 VALVULAS (VICTOR REINZ) SSF,1367,7,8,1,16
058198025A *6,JUNTA TAPA PUNTERï¿½AS AUDI VW SEAT MOTOR 1.8T 20 VALVULAS (ELRING) SSF,1371,0,1,1,2
058198217,JUNTA DE TENSOR HIDRï¿½ULICO AUDI VW SEAT 1.8T 20 VALULAS (EMBLER),1849,4,7,4,15
058905105-1,BOBINA DE IGNICION AUDI A4 1.8 L BMTR,1996,7,8,2,17
058905161B *5,SENSOR POSICION ARBOL DE LEVAS AUDI VW SEAT 1.8 TURBO 20 VALVULAS (BREMI) SSF,1231,2,1,9,12
059121012B *2,BOMBA AGUA AUXILIAR ELECTRICA ENFRIAMIENTO MOTOR TUAREG 3.6 FSI (EMBLER) GOG,1843,8,7,9,24
059919501A,SENSOR DE TEMPERATURA DE MOTOR (VERDE) AUDI A4 1.8L FEBI,1620,8,8,0,16
068115561B *3,FILTRO ACEITE MOTOR AUDI A4 1.8L (MAHLE OC51),1671,7,0,9,16
068117021B *2,ENFRIADOR ACEITE TRANSMISION MOTOR JETTA AUDI (EMBLER) GOG,1226,1,7,5,13
06A103171A,RETEN DE CIGï¿½Eï¿½AL TRASERO CON BRIDA AUDI A4 1.8L 2.0L ELRING,1895,7,6,3,16
06A103213F *K,KIT 6 PZ. MANGUERAS VALVULA SISTEMA PCV AUDI SEAT VW 1.8 TURBO 20V (EMBLER) GOG,1595,1,1,8,10
06A103213F *M,MANGUERA CODO VALVULA PCV AUDI SEAT VW 1.8 TURBO 20V (EMBLER) GOG,1752,3,6,5,14
06A103213F-100,KIT MANGUERA DE VENTILACION DE VALVULA PCV AUDI A4-B6 1.8 L DORMAN ALEMAN INACTIVO,1311,3,5,6,14
06A103213F-101,MANGUITO DE VENTILACION PARA CAJA DE CIGUEï¿½AL FEBI 36274 INACTIVO,1635,1,1,9,11
06A103385A *5,KIT 10 PZ. TORNILLOS CABEZA MOTOR AUDI VW SEAT TURBO 1.8 20 VALVULAS (VICTOR REINZ) SSF,1529,0,2,3,5
06A103385A *6,KIT 10 PZ. TORNILLOS CABEZA MOTOR AUDI VW SEAT TURBO 1.8 20 VALVULAS (ELRING) SSF,1639,4,4,4,12
06A103663B-2,TUBO CON BAYONETA AUDI A4 1.8 TURBO ( EMBLER ),1697,6,8,2,16
06A103663B-3,BAYONETA AUDI A4 1.8 TURBO (EMBLER),1737,7,4,6,17
06A103663B-T-1,TUBO DE BAYONETA SIN BAYONETA VW AUDI1.8 TURBO ( KZR GERMANY ),1578,1,3,1,5
06A103663C *B,BAYONETA NIVEL ACEITE VW MOTOR 2.0 NO TURBO (EMBLER),1809,6,4,0,10
06A103663C *TC,TUBO ACEITE MOTOR CON BAYONETA VW MOTOR 2.0 NO TURBO (EMBLER),1382,0,4,9,13
06A103663C *TS,TUBO ACEITE MOTOR SIN BAYONETA VW MOTOR 2.0L NO TURBO (EMBLER),1816,3,3,7,13
06A103663C-100,BAYONETA DE NIVEL ACEITE VW MOTOR 2.0L NO TURBO (EMBLER) INACTIVO,1278,2,0,7,9
06A109119D,BANDA DE DISTRIBUCION VW JETTA 2.0L GENUINA,1888,8,1,8,17
06A115105B,BOMBA DE ACEITE DE MOTOR AUDI A4 1.8 L KLG,1801,9,0,9,18
06A115105B-1,BOMBA DE ACEITE DE MOTOR AUDI A4 1.8 L FEBI,1762,3,0,3,6
06A115441J,JUNTA DE ADAPTADOR DEL FILTRO ACEITE MOTOR AUDI A4 1.8T VICTOR REINZ,1716,2,2,6,10
06A115441J-1,JUNTA DE ADAPTADOR DEL FILTRO ACEITE MOTOR AUDI A4 1.8T DORMAN ALEMAN,1900,8,5,3,16
06A115561B *3,FILTRO ACEITE MOTOR AUDI A 4-B6  1.8 L TURBO (MAHLE OC264),1736,8,7,8,23
06A115561B-9,FILTRO ACEITE MOTOR AUDI A 4-B6  1.8 L TURBO MANN W719/30,1929,1,2,3,6
06A121011Q *2,BOMBA AGUA ENFRIAMIENTO MOTOR AUDI WV SEAT 1.8 TURBO 20V VW 2.0 SO (EMBLER) HT,1909,4,3,5,12
06A121111A,TERMOSTATO DE MOTOR AUDI A3 / 1.6L ( GENERICO ),1497,2,7,1,10
06A121121C,CODO BOMBA AGUA BRIDA AUDI TT 1.8L ( GENERICO ),1923,0,2,5,7
06A129101D *2,VALVULA VENTILACION CARTER MOTOR AUDI A4 PASSAT GOLF 1.8 20 VALVULAS (EMBLER) GOG,1638,5,4,0,9
06A145704P *2,TURBO CARGADOR K04 COMPLETO AUDI A3-1.8L (EMBLER) GOG,1371,2,0,9,11
06A145713B *2,TURBO CARGADOR K04 AUDI A4 1.8 L TURBO 20 VALVULAS (EMBLER) GOG,1413,7,5,8,20
06A145832C,MANGUERA DE INTERCOOLER DE TURBOCARGADOR AUDI A3 1.8 GENERICO,1490,9,0,8,17
06A905115D *5,BOBINA IGNICION AUDI VW SEAT 1.8 L TURBO 20 VALVULAS (BREMI) SSF,1311,8,5,6,19
06A906283E,VALVULA SELENOIDE DE CONTROL DE PRESION TURBO AUDI A4 - 1.8L  URO,1487,1,2,5,8
06A906433-1,SENSOR DE CIGUEï¿½AL AUDI A3 / A4 2.0 L MEISTERSATZ,1236,7,3,2,12
06A906433C,SENSOR DE CIGUEï¿½AL AUDI VW SEAT 1.8 T 20 (EMBLER),1607,9,7,9,25
06A906433G,SENSOR DE CIGUEï¿½AL AUDI A3 / A4 2.0 L ( ORIGINAL ),1968,9,0,5,14
06A906461A *5,SENSOR MAF MASA AIRE MOTOR VOLKS WAGEN (BOSCH) SSF,1636,4,4,0,8
06A906461L *5,SENSOR MASA AIRE MOTOR MAF AUDI WV SEAT 1.8 TURBO 20 VALVULAS (BOSCH) SSF,1478,3,3,1,7
06A919501A *5,SENSOR DE TEMPERATURA DE RADIADOR AUDI A3-A4 (FEBI) SSF,1731,6,9,4,19
06B103113C,TAPON DE CABEZA DE MOTOR AUDI  A4  2.0 L ( ORIGINAL ),1214,9,8,1,18
06B103213-1,KIT MANGUERAS Y VALVULA PCV PASSAT-B5 1.8T ( TOPRAN ),1223,6,0,1,7
06B103213G,KIT DE MANGUERAS Y VALVULA PCV PASSAT-B5 1.8T ( EMBLER ),1662,7,8,1,16
06B103245,VALVULA PCV WV PASSAT 1.8L MODELO 2003 VAICO,1429,8,7,7,22
06B103245-1,SEPARADOR DE ACEITE PCV VW PASSAT B-5 1.8T (EMBLER),1960,7,5,3,15
06B109243D *2,POLEA TENSORA AUDI S3 A4 (EMBLER),1745,6,0,2,8
06B109244,POLEA TENSORA DE BANDA DE DISTRIBUCION ( R ) AUDI A3 P8 / A4 / 1.8L / 2.0L ( INA ),1748,8,9,4,21
06B109477A *2,TENSOR HIDRAULICO BANDA DISTRIBUCION AUDI VW SEAT 1.8 20 VALVULAS (EMBLER) GOG,1210,0,7,8,15
06B109477A *5,TENSOR HIDRAULICO BANDA DISTRIBUCION AUDI VW SEAT 1.8 TURBO 20 VALVULAS (FEBI) SSF,1711,4,7,9,20
06B121011C *3,BOMBA AGUA MECANICA ENFRIAMIENTO MOTOR 8P 1.6-2.0L 4CIL (VIKA),1461,6,7,0,13
06B121011E,BOMBA AGUA MECANICA ENFRIAMIENTO MOTOR 8P 1.6-2.0L 4CIL (SALERI),1204,8,3,8,19
06B121071L *5,TUBO DISTRIBUCION ANTICONGELANTE ENFRIAMIENTO MOTOR AUDI A4 1997 A 2002 VW 1999 A 2005 1.8 TURBO (JP) SSF,1995,8,1,9,18
06B121111K *2,TERMOSTATO ENFRIAMIENTO MOTOR AUDI TURBO 1.8 L 20 VALVULAS (EMBLER) GOG,1460,0,9,0,9
06B121111K *5,TERMOSTATO ENFRIAMIENTO MOTOR AUDI 1.8 L TURBO 20 VALVULAS (MAHLE TM3100) SSF,1623,6,3,3,12
06B121111K *6,TERMOSTATO ENFRIAMIENTO MOTOR AUDI VW SEAT 1.8 TURBO 20 VALVULAS (VERNET) SSF,1352,5,6,2,13
06B121121L *5,CARCASA ADAPTADOR TERMOSTATO DE MOTOR AUDI A6 VW (URO) SSF,1619,5,6,1,12
06B121132E,TOMA DE AGUA (BRIDA DE SENSOR DE TEMPERATURA) AUDI A4 1.8L TURBO AFTERMARKET,1874,6,7,2,15
06B198119A *5,KIT 4 PZ BANDA DISTRIBUCION TENSOR BALERO RODILLO TORNILLO SUJECION AUDI VW SEAT 1.8 TURBO 20 VALVULAS (CONTINENTAL) SSF,1434,9,6,5,20
06B198151B *5,KIT 3 PZ ANILLOS MOTOR STD PARA 1 PISTON AUDI VW 1.8 2.7 (GOETZE) SSF,1707,7,7,0,14
06B198151B *6,KIT 12 PZ ANILLOS MOTOR STD PARA 4 PISTONES VW AUDI 1.8 2.7 VALVULAS (MAHLE) SSF,1361,7,5,5,17
06B903133E *5,TENSOR DE BANDA DE ACCESORIOS AUDI A4 / 1.8L / 2.0L ( URO ) SSF,1921,2,0,3,5
06B903133E *6,TENSOR DE BANDA DE ACCESORIOS AUDI A4 / 1.8L / 2.0L (INA) SSF,1991,1,2,6,9
06B903137D *5,BANDA ACCESORIOS MOTOR 6KX1590 AUDI A4 2002 A 2004 1.8 TURBO 20 VALVULAS (CONTINENTAL) SSF,1215,3,5,0,8
06B905115G,BOBINA DE IGNICION AUDI A4 1.8 L GENERICA,1685,1,4,4,9
06C121004G,BOMBA AGUA MECANICA ENFRIAMIENTO MOTOR AUDI A4 3.0 (TUBA),1895,8,7,1,16
06C121111E *3,TERMOSTATO ENFRIAMIENTO MOTOR AUDI 3.0 L (MAHLE TI20592D) DGO,1276,8,4,9,21
06C133843 *5,FILTRO ENTRADA AIRE MOTOR 212 X 266 MM AUDI VW SEAT (HENGST) SSF,1688,1,1,9,11
06C905163B *5,SENSOR ARBOL LEVAS (R) AUDI A4 3.0 TFSI A6 4.2 VW JETTA 2.0 TFSI 1a GEN (BOUGICORD) SSF,1387,5,5,2,12
06D105701KGLB,METALES DE BIELA AUDI A3 / A4 / 1.8 L  ( BMTR ),1379,6,5,3,14
06D109119B,BANDA DE DISTRIBUCION AUDI A4 2.0 L CONTITECH,1421,3,3,3,9
06D109119B-2,BANDA DE DISTRIBUCION AUDI A4 2.0 L VIKA,1744,0,8,3,11
06D109229B *1,CADENA DE DISTRUBICION AUDI A4-B7 2.0 L (KZR GERMANY),1913,7,9,6,22
06D109244E,POLEA TENSORA DE BANDA DE DISTRIBUCION ( L ) AUDI A3 / A4 / 2.0L ( GENUINO ),1350,4,9,1,14
06D109601M,VALVULA DE ADMSION DE CABEZA AUDI A4 B7 - B8 MOTOR 1.8 Y 2.0 TFSI  MAHLE,1556,3,5,8,16
06D109601M *3,VALVULA DE ADMSION DE CABEZA AUDI A4 B7 - B8 MOTOR 1.8 Y 2.0 TFSI  (TRW),1740,4,0,8,12
06D109601M *4,VALVULA DE ADMSION DE CABEZA AUDI A4 B7 - B8 MOTOR 1.8 Y 2.0 TFSI (VIKA),1478,0,5,7,12
06D109611H,VALVULA DE ESCAPE DE CABEZA AUDI A4 B7 - B8 MOTOR 1.8 Y 2.0 TFSI  MAHLE,1612,6,0,7,13
06D109611H-1,VALVULA DE ESCAPE DE CABEZA AUDI A4 B7 - B8 MOTOR 1.8 Y 2.0 TFSI  BGA,1567,5,0,6,11
06D109611L *3,VALVULA ESCAPE GASES MOTOR 6 MM AUDI A4 Q5 VW 2.0T 1.8T (VIKA),1563,8,5,6,19
06D115397G-100,TOMA ACEITE MOTOR SEPARADOR GASES PCV AUDI VW SAET 1.8L TFSI INACTIVO,1502,7,9,5,21
06D115397J *2,SEPARADOR ACEITE MOTOR PCV CON ENTRADA SENSOR AUDI SEAT VW 1.8 2.0 TFSI (EMBLER) GOG,1401,3,9,2,14
06D115562 *3,FILTRO ACEITE MOTOR AUDI A3 A4 RS3 TT TTS VW SEAT (MAHLE OX379D),1696,1,9,5,15
06D115562 *5,FILTRO ACEITE MOTOR AUDI A3 A4 RS3 TT TTS VW SEAT (HENGS ALEMAN) SSF,1865,9,3,0,12
06D115562-100,FILTRO DE ACEITE DE MOTOR AUDI A4 2.0L VIKA HU719/6X INACTIVO,1448,1,6,0,7
06D115562-2,FILTRO ACEITE MOTOR AUDI A4 2.0L MANN HU719/6X,1421,9,0,0,9
06D117021C *2,ENFRIADOR ACEITE MOTOR AUDI VW SEAT 1.8 2.0 TFSI (EMBLER) GOG,1307,3,0,6,9
06D117021C *5,ENFRIADOR ACEITE MOTOR AUDI VW SEAT 1.8 2.0 TFSI (FEBI) SSF,1946,2,3,2,7
06D117070 *5,JUNTA ENFRIADOR ACEITE MOTOR AUDI A4 TFSI (AJUSA) SSF,1991,3,4,9,16
06D117070-1,JUNTA DE ENFRIADOR DE ACEITE DE MOTOR AUDI A4 TFSI ELRING,1975,2,4,9,15
06D117070-2,JUNTA DE ENFRIADOR DE ACEITE DE MOTOR AUDI A4 TFSI VIKA,1901,2,5,3,10
06D117070-3,JUNTA DE ENFRIADOR DE ACEITE DE MOTOR AUDI A4 TFSI TOPRAN,1933,6,3,0,9
06D117070-6,JUNTA DE ENFRIADOR ACEITE DE MOTOR AUDI A4 (EMBLER),1814,9,2,9,20
06D121101B *5,MANGUERA CONECTOR DE RARIADOR AUDI A6 VOLKSWAGUEN (REIN) SSF,1668,1,1,2,4
06D121111-1,TERMOSTATO DE MOTOR AUDI A4 2.0 VIKA,1324,0,0,5,5
06D121111G *5,TERMOSTATO ENFRIAMIENTO MOTOR AUDI 2.0 L TFSI 2A GEN 2005 A 2009 (MAHLE T1787) SSF,1220,1,5,4,10
06D121492J *5,MANGUERA DE RADIADOR AUDI A4 A6 2.0L (COHLINE) SSF,1832,9,4,8,21
06D145701G *2,TURBOCARGADOR AUDI VW SEAT 1.8 L 2.0 L TFSI TSI 16 VALVULAS (EMBLER) GOG,1492,5,7,1,13
06D145701G *C,CARTUCHO TURBOCARGADOR AUDI VW SEAT 1.8 L 2.0 L TFSI TSI 16 VALVULAS (EMBLER) GOG,1542,4,0,8,12
06E103483Q,JUNTA DE TAPA DE PUNTERIAS L AUDI A4-3.2L VICTOR REINZ,1881,9,1,2,12
06E103484P *5,JUNTA DE TAPA DE PUNTERIAS R AUDI A4 (VICTOR REINZ) SSF,1824,8,9,6,23
06E103547N,SEPARADOR DE ACIETE CARTER AUDI A6 3.0T 2012 EMBLER,1713,5,3,4,12
06E103547P *S,SEPARADOR ACEITE PCV VW AUDI MOTOR 3.2 TFSI (EMBLER) GOG,1746,1,1,9,11
06E105251,POLEA DE CIGUEï¿½AL AUDI Q7 Q5 A5 A6 A7 CORTECO,1269,0,9,9,18
06E115562C,FILTRO ACEITE MOTOR AUDI A4 3.2L MANN HU722Z,1391,3,2,3,8
06E115562C *3,FILTRO ACEITE MOTOR AUDI A4 3.2L (MAHLE OX381D),1463,6,6,5,17
06E115562E *3,FILTRO ACEITE MOTOR AUDI A6 A7 A8 Q7 2015-2019 (MAHLE OX1185D) DGO,1746,9,7,4,20
06E117021G,ENFRIADOR DE ACEITE DE MOTOR AUDI A4 QUATTRO A5 A6 A7 Q5 Q7 BMTRS,1215,3,9,2,14
06E117070J,JUNTA DE ENFRIADOR DE ACEITE DE MOTOR AUDI A4-3.2L VICTOR REINZ,1206,0,8,4,12
06E117070J-1,JUNTA DE ENFRIADOR DE ACEITE DE MOTOR AUDI A4-3.2L BFGERMANY,1549,2,3,0,5
06E121018A *2,BOMBA AGUA ENFRIAMIENTO MOTOR AUDI VW 3.0 L FSI 3.2 L TFSI (EMBLER) HT,1496,9,9,7,25
06E121018A-100,BOMBA DE AGUA MECANICA AUDI MOTOR V6 3.0 TFSI (SALERI) INACTIVA,1231,5,4,1,10
06E121018B *2,BOMBA AGUA MECANICA ENFRIAMIENTO MOTOR SIN TOMA AUDI MOTOR V6 3.2 FSI (EMBLER),1621,3,1,9,13
06E121018F -100,BOMBA DE AGUA MECANICA AUDI A6-C7 Q5-R8 3.0L GENUINA INACTIVA,1573,7,0,8,15
06E121018F-100,BOMBA DE AGUA MECANICA AUDI MOTOR V6 3.0 TFSI (BFGERMANY) INACTIVA,1491,9,4,1,14
06E121031E *5,POLEA BOMBA AGUA ENFRIAMIENTO MOTOR AUDI A4 3.2 L (URO) SSF,1847,8,6,7,21
06E121045T,TUBO DE AGUA VAICO,1574,1,3,4,8
06E121045T *2,TUBO DE AGUA AUDI A4 A5 A6 VW (EMBLER),1387,8,8,6,22
06E121111AL,TERMOSTATO DE MOTOR AUDI A5 VIKA,1764,7,6,8,21
06E121111M *5,TERMOSTATO ENFRIAMIENTO MOTOR AUDI A4 A5 A6 Q5 3.2 L (URO PARTS) SSF,1960,4,2,3,9
06E903133K,TENSOR DE BANDA DE ACCESORIOS AUDI / Q7 ( URO ),1907,7,7,3,17
06E903133Q,TENSOR DE BANDA DE ACCESORIOS AUDI A4 / 3.2L ( INA ),1300,9,3,1,13
06E905115F *1,BOBINA DE IGNICION DE ENCENDIDO AUDI A4 3.2L EMBLER,1509,1,7,9,17
06E905115F *2,BOBINA DE IGNICION DE ENCENDIDO SEMINUEVA AUDI A4 3.2L GENUINA,1310,9,1,1,11
06E905115G *5,BOBINA ENCENDIDO IGNICION MOTOR AUDI VW SEAT (BOSCH) SSF,1619,7,9,6,22
06E906433,SENSOR DE CIGUEï¿½AL AUDI A6 / TM ( GENUINO ),1256,2,7,5,14
06E906517-1,VALVULA DE CANISTER AUDI A3 A6 EMBLER,1825,4,8,2,14
06E906517A,VALVULA DE CANISTER AUDI A3 A6 VIKA,1692,6,3,0,9
06E906517A *5,VALVULA SOLENOIDE CANISTER AUDI VW SEAT (BOSCH) SSF,1803,2,4,9,15
06E907660 *5,SENSOR NIVEL ACEITE MOTOR AUDI VW SEAT 2.0L 3.2 4.2 TFSI TSI FSI (HELLA) SSF,1277,0,6,5,11
06F103221E,MANGUERA VENTILACION PCV AUDI A4 2.0 TFSI SIN PROTECCION (EMBLER),1431,1,9,5,15
06F103221E-1,MANGUERA FLEXIBLE DE 2 VIAS PCV AUDI A4 1.8L 2.0L TFSI ( EMBLER ),1204,2,1,2,5
06F103235,MANGUERA LARGA VALVULA PCV AUDI SEAT 1.8 TFSI 1A GEN EMBLER,1582,0,2,6,8
06F103383J *5,JUNTA CABEZA MOTOR MEDIDA STANDAR 0.90 MM AUDI VW SEAT 2.0 TURBO (VICTOR REINZ) SSF,1887,0,7,0,7
06F103383J-1,JUNTA CABEZA MOTOR MEDIDA STANDAR 0.90 MM AUDI VW SEAT 2.0 TURBO BFGERMANY,1700,0,6,3,9
06F103483D,JUNTA DE TAPA DE PUNTERIAS AUDI A3-A4 2.0L ELRING,1956,2,3,8,13
06F103483D-1,JUNTA DE TAPA DE PUNTERIAS AUDI A3-A4 2.0L BFGERMANY,1290,3,8,2,13
06F103483E,JUNTA DE VALVULA REGULADORA DE PRESION AUDI A4 ELRING,1436,4,6,7,17
06F109217A *2,TENSOR DE CADENA AUDI A4-B7 2.0 L (EMBLER) GOG,1371,7,0,8,15
06F109217A *3,TENSOR DE CADENA AUDI A4-B7 2.0 L (CALIDAD ORIGINAL),1865,9,0,0,9
06F109257C,SOLENOIDE DE TIEMPO VARIABLE AUDI A4 / 2.0 TFSI  ( BMTR ),1408,0,7,5,12
06F109257C-1,SOLENOIDE DE TIEMPO VARIABLE AUDI A4 / 2.0 TFSI ( VAICO ),1854,5,3,2,10
06F115397J *2,SEPARADOR ACEITE MOTOR PCV SIN ENTRDA SENSOR AUDI SEAT VW 1.8L 2.0L TFSI (EMBLER) GOG,1341,6,3,6,15
06F115441-1,JUNTA TOMA DE FILTRO ACEITE MOTOR AUDI A4 2.0 TFSI DORMAN ALEMAN,1327,3,8,8,19
06F115441-2,JUNTA TOMA DE FILTRO ACEITE MOTOR AUDI A4 2.0 TFSI VIKA,1203,3,2,2,7
06F115441A *2,JUNTA TOMA ACEITE MOTOR SIN ENTRDA SENSOR AUDI A3 (EMBLER) GOG,1431,0,9,0,9
06F115441B *5,JUNTA TOMA DE FILTRO ACEITE MOTOR AUDI A4 2.0 TFSI (VICTOR REINZ) SSF,1962,9,6,6,21
06F121011,BOMBA AGUA MECANICA ENFRIAMIENTO MOTOR AUDI A4 2.0L (CALIDAD ORIGINAL),1299,0,3,5,8
06F121057D,MANGUERA DE AGUA PARA TERMOSTATO AUDI A4 2.0 L REIN,1958,3,5,7,15
06F121057D-1,MANGUERA DE AGUA PARA TERMOSTATO AUDI A4 2.0 L VIKA,1454,0,3,0,3
06F121111F *3,TERMOSTATO ENFRIAMIENTO MOTOR AUDI VW 2.0 L TFSI (MAHLE TI687) DGO,1517,0,8,8,16
06F121111F *5,TERMOSTATO ENFRIAMIENTO MOTOR AUDI VW 2.0 L TFSI (BEHR) SSF,1786,1,5,7,13
06F121111F-2,TERMOSTATO DE MOTOR AUDI A3 2.0 L TFSI VEMO,1908,8,5,9,22
06F121111F-3,TERMOSTATO DE MOTOR AUDI A3 2.0 L TFSI (EMBLER),1235,4,9,1,14
06F121133,BRIDA REFRIGERANTE  VAG AUDI (EMBLER),1591,3,7,7,17
06F121133H,BRIDA REFRIGERANTE VW VIKA,1440,7,1,9,17
06F127025,BOMBA DE GASOLINA DE ALTA PRESION AUDI A4 2.0 L HITACHI,1306,2,3,8,13
06F127025M *5,BOMBA DE GASOLINA DE ALTA PRESION AUDI A4 2.0 L (PIERBURG) SSF,1387,7,8,4,19
06F129101P-100,RECUPERADOR DE ACEITE PCV AUDI EMBLER INACTIVO,1789,0,9,3,12
06F129101R *D,DIAFRGAMA VALVULA PCV MOTOR AUDI SEAT VW 1.8 2.0 TFSI 1 GEN (EMBLER) GOG,1267,5,6,3,14
06F129101R *K,KIT DE MANGUERAS PCV ACEITE MOTOR AUDI SEAT VW 1.8 2.0 TFSI 1a GEN (EMBLER) GOG,1307,0,3,4,7
06F129101R *S,SEPARADOR PCV ACEITE MOTOR AUDI SEAT VW 1.8 2.0 TFSI 1a GEN (EMBLER) GOG,1892,1,9,9,19
06F129717D,JUNTA MULTIPLE DE ADMISION AUDI SEAT 2.0 TFSI EMBLER,1786,3,4,7,14
06F129717D -1,JUNTA MULTIPLE DE ADMISION AUDI SEAT 2.0 TFSI (VIKA),1539,8,2,1,11
06F129717D-3,JUNTA MULTIPLE DE ADMISION AUDI SEAT 2.0 TFSI GENUINA,1327,5,1,5,11
06F133843A,FILTRO ENTRADA AIRE MOTOR AUDI A3 PASSAT 2.0L MANN C41110,1752,5,3,4,12
06F133843A *3,FILTRO ENTRADA AIRE MOTOR AUDI A3 PASSAT 2.0L (MAHLE LX1262),1827,3,8,9,20
06F198119A,KIT DE DISTRIBUCION BANDA 3 POLEAS AUDI A4 B6 2.0 TFSI FSI CIC USA,1514,0,8,5,13
06F253039F *2,JUNTA MULTIPLE GASES ESCAPE MOTOR AUDI A1 A3 A4 A5 A6 Q2 Q5 VW SEAT (EMBLER),1928,7,2,8,17
06F906283,VALVULA TURBOCARGADOR AUDI  A3-A4-A5 VIKA,1936,6,2,7,15
06F906283F *3,VALVULA SOLENOIDE CONVERTIDOR TURBOCOMPRESOR AUDI A3 A4 A5 Q3 BEETLE VW (BRUCK GERMANY),1726,3,6,2,11
06F906461A,SENSOR DE MASA DE AIRE MAF AUDI A4 / 2.0L ( HITACHI ),1534,1,3,9,13
06F906461A *5,SENSOR MAF MASA AIRE MOTOR AUDI A4 2.0 TFSI (BREMI) SSF,1211,8,1,0,9
06G127027D *3,BOMBA COMBUSTIBLE GASOLINA ALTA PRESION AUDI A3 Q2 VW SEAT 2.0T (GENUINA),1663,0,9,9,18
06G127027H *2,BOMBA COMBUSTIBLE GASOLINA ALTA PRESION AUDI A3 VW SEAT 2.0T (GENUINA),1497,5,7,6,18
06H103226,MANGUERA DE VENTILACION PCV AUDI A4 2.0 TFSI PROTECCION ALUMINIO,1674,8,2,1,11
06H103269H *2,TAPA DISTRIBUCION AUDI VW SEAT 2.0 TFSI 5 ORIFICIOS (EMBLER) GOG,1532,6,3,6,15
06H103269H *5,TAPA DISTRIBUCION AUDI VW SEAT 2.0 TFSI 5 ORIFICIOS (REIN) SSF,1370,7,7,7,21
06H103383AD,JUNTA CABEZA MOTOR MEDIDA STANDAR 0.90 MM AUDI A4 2.0 L TFSI 2a GEN TFSI ELRING,1721,0,9,7,16
06H103383AD *2,JUNTA CABEZA MOTOR MEDIDA STANDAR 0.90 MM AUDI A4 2.0 L TFSI 2a GEN (EMBLER) GOG,1607,5,1,3,9
06H103383AD-1,JUNTA CABEZA MOTOR MEDIDA STANDAR 0.90 MM AUDI A4 2.0 L TFSI 2a GEN ORIGINAL VW,1394,6,0,4,10
06H103383Q *3,JUNTA CABEZA MOTOR MEDIDA STANDAR 0.90 MM AUDI A3 A4 A5 SEAT VW (BRUCK GERMANY),1714,3,0,3,6
06H103483C *2,JUNTA TAPA DISTRIBUCION 5 TORNILLOS AUDI WV SEAT 2.0 TFSI 2a GEN (EMBLER) GOG,1644,8,5,6,19
06H103483C *3,JUNTA TAPA DISTRIBUCION 5 TORNILLOS AUDI WV SEAT 2.0 TFSI 2a GEN (VIKA),1777,5,8,6,19
06H103495 *D,DIAFRAGMA VALVULA PCV VW AUDI SEAT VW 1.8 2.0 TFSI 2a GEN (EMBLER) GOG,1439,8,2,7,17
06H103495 *K,KIT MANGUERAS SEPARADOR ACEITE PCV AUDI SEAT VW 1.8 2.0 TFSI 2a (EMBLER) GOG,1594,1,4,3,8
06H103495A *S,SEPARADOR ACEITE MOTOR PCV AUDI SEAT VW 1.8 2.0 TFSI 2a GEN (EMBLER) GOG,1773,6,5,6,17
06H103495B,VALVULA PCV AUDI A3 / A4 / JETTA MKV 1.8 - 2.0 L TSI  EMBLER,1934,8,9,6,23
06H103495B-1,VALVULA PCV AUDI A3 / A4 / JETTA MKV 1.8 - 2.0 L TSI  GENERICA,1352,2,3,1,6
06H105701C,METALES DE BIELA EN ESTANDAR AUDI A4-B8 2.0L TFSI KOLBENSCHMIDT 77906600,1523,4,4,4,12
06H109021J *2,ARBOL DE LEVAS DE ADMISION AUDI A3 A4 A5 1.8T 2.0T VW SEAT (EMBLER),1489,6,7,7,20
06H109210Q *3,TAPA PUNTERIAS MOTOR AUDI A3 A4 A5 A6 VW 2.0 T (VIKA),1595,1,7,9,17
06H109257A,VALVULA SOLENOIDE AUDI A4 - 2.0L  INA,1856,5,4,9,18
06H109257A-1,VALVULA SOLENOIDE AUDI A4 - 2.0L  VIKA,1482,6,9,1,16
06H109257C ,VALVULA WT ARBOL DE LEVAS AUDI VW 1.8 TFSI (EMBLER) GOG,1653,1,8,5,14
06H109467-1,TORNILLO DEL TENSOR DE LA CADENA DE DISTRIBUCION AUDI A3 TOPRAN,1378,1,9,2,12
06H109467AE *T,TENSOR HIDRï¿½ULICO CADENA DISTRIBUCIï¿½N AUDI VW SEAT 1.8 2.0 TFSI (EMBLER),1781,2,7,5,14
06H109467AE -1,TENSOR HIDRï¿½ULICO CADENA DISTRIBUCIï¿½N AUDI VW SEAT 1.8 2.0 TFSI FEBI,1975,7,5,8,20
06H109467AE-100,KIT DE CADENA DE DISTRIBUCION AUDI A4 2.0 TFSI EMBLER INACTIVO,1951,6,2,7,15
06H109467AL,TORNILLO DEL TENSOR DE LA CADENA DE DISTRIBUCION AUDI A3 ( ORIGINAL ),1319,9,6,2,17
06H109507M,TENSOR PARA CADENA DE DISTRIBUCION AUDI A3 / A4 / 2.0 ( EMBLER ),1900,0,0,1,1
06H109507M *T,TENSOR MECANICO CADENA DISTRIBUCION AUDI SAET VW 1.8 2.0 TFSI (EMBLER),1675,4,9,9,22
06H115105AC *2,BOMBA ACEITE MOTOR AUDI SEAT VW 1.8 2.0 TFSI (EMBLER) GOG,1792,3,8,9,20
06H121026,BOMBA AGUA MECANICA ENFRIAMIENTO MOTOR AUDI A4-2.0 L TFSI KLG (ALEMAN),1400,9,8,8,25
06H121026-1,CABEZA BOMBA AGUA MECANICA SIN TERMOSTATO AUDI A4 1.8 2.0 L TFSI (INA ),1343,8,3,3,14
06H121026N *2,BOMBA AGUA MECANICA ENFRIAMIENTO MOTOR CON TERMOSTATO AUDI A4 TFSI 1.8 2.0 1a GEN (EMBLER) HT,1558,8,8,9,25
06H121026N-4,BOMBA AGUA MECANICA ENFRIAMIENTO MOTOR CON TERMOSTATO AUDI A4 TFSI 1.8 2.0 1a GEN (VIKA),1550,7,1,1,9
06H121131-100,COPLE DE BOMBA DE AGUA AUDI A4-B7-B8 2.0 TFSI INACTIVO,1763,0,2,1,3
06H121131C *2,COPLE BOMBA AGUA ENFRIADOR ACEITE MOTOR AUDI VW SEAT (EMBLER) GOG,1283,8,1,9,18
06H121131C *5,COPLE BOMBA AGUA ENFRIADOR ACEITE MOTOR AUDI VW SEAT (FEBI) SSF,1222,6,0,9,15
06H121131C-100,COPLE DE BOMBA DE AGUA AUDI A4-B7-B8 2.0 TFSI BORSEHUNG INACTIVO,1506,5,0,6,11
06H121132H *5,BRIDA TOMA AGUA ENFRIAMIENTO MOTOR AUDI 2.0 L TFSI (FEBI) SSF,1986,0,2,4,6
06H121132H-1,TOMA DE AGUA AUDI A5 2.0 TSI GENUINO,1914,4,7,2,13
06H121142C,MUELLE DE SUJECION DE BOMBA DE AGUA AUDI A3 / A4 / 2.0L ( GENUINO ),1250,1,1,9,11
06H121605E,BANDA DE BOMBA DE AGUA AUDI A4 2.0 L TFSI GENUINA,1266,9,1,2,12
06H121605E *5 ,BANDA BOMBA AGUA ENFRIAMIENTO MOTOR AUDI 2.0L TFSI VW 2.0L TSI (FEBI) SSF,1605,4,3,1,8
06H121605E-1,BANDA DE BOMBA DE AGUA AUDI A4 2.0 L TFSI FEICHI,1411,5,9,2,16
06H127025N *5,BOMBA COMBUSTIBLE GASOLINA ALTA PRESION AUDI VW SEAT 2.0 L  TFSI ( BOSCH) SSF,1837,7,7,9,23
06H145702G *2,TURBO CARGADOR CARTUCHO AUDI A5 2.0 L TURBO (EMBLER) GOG,1908,3,8,5,16
06H145710D *2,VALVULA LIBERADORA PRECION TURBO AUDI TSI TFSI 1.8 2.0 (EMBLER) GOG,1786,9,8,1,18
06H145710D *5,VALVULA LIBERADORA PRECION TURBO AUDI TSI TFSI 1.8 2.0 (PIERBURG) SSF,1999,6,7,7,20
06H903133G,TENSOR DE BANDA DE TRANSMISION AUDI A4 / 2.0L ( INA ),1321,3,2,9,14
06H903137C *5,BANDA ACCESORIOS MOTOR 6KX1590 AUDI 2.0L TFSI (CONTINENTAL) SSF,1756,9,5,5,19
06H903341D,POLEA TENSORA AUDI A4 2.0 INA,1814,7,7,5,19
06H905110L,BOBINA DE ENCENDIDO AUDI TSI EMBLER,1912,4,1,1,6
06H905115BB0,BOBINA DE ENCENDIDO AUDI A3 BOSCH,1571,5,4,2,11
06H905601-100,BUJIA DE IGNICION DOBLE PLATINO AUDI A6 2013 GENUINA INACTIVO,1412,4,1,0,5
06H905601A *5,BUJIA IGNICION DOBLE PLATINO AUDI VW SEAT 2.0 L 4.2 L 5.2 L (BOSCH) SSF,1242,9,1,6,16
06H905611-100,BUJIA IGNICION DOBLE PLATINO VW AUDI 2.0 TFSI INACTIVO,1405,2,7,7,16
06H906036AE *5,INYECTOR COMBUSTIBLE GASOLINA AUDI VW SEAT 2.0L (BOSCH) SSF,1829,6,9,0,15
06H906051F,SENSOR DE PRESION DE GASOLINA AUDI A4 ALLROAD ( 2.0 L ),1321,7,8,2,17
06H906433 *5,SENSOR POSICION CIGUEï¿½AL MOTOR AUDI VW SEAT 2.0 L TFSI (OEM) SSF,1997,9,0,9,18
06J103213D,MANGUERA INFERIOR DE RADIADOR AUDI A3 EMBLER,1599,1,1,8,10
06J103213D-1,MANGUERA INFERIOR DE RADIADOR AUDI A3 DORMAN ALEMAN,1924,3,5,9,17
06J103221A *2,MANGUERA SISTEMA VENTILACION CARTER PCV AUDI VW SEAT 2.0 TFSI 2a GEN (EMBLER) GOG,1318,1,2,5,8
06J115105AG,BOMBA ACEITE MOTOR AUDI VW SEAT 1.8 2.0 TFSI (EMBLER),1465,9,1,6,16
06J115105AG *2,BOMBA ACEITE MOTOR AUDI VW SEAT 1.8 2.0 TFSI (PIERBURG) GOG,1511,3,7,8,18
06J115403Q *3,FILTRO ACEITE MOTOR AUDI VW SEAT MAHLE (OC456) DGO,1377,5,4,6,15
06J115403Q *5,FILTRO ACEITE MOTOR AUDI VW SEAT (MANN) SSF,1615,2,2,7,11
06J115441A *2,JUNTA CARCASA TOMA ACEITE MOTOR AUDI 1.8 2.0 TSI TFSI (EMBLER) GOG,1434,5,8,8,21
06J115441A *3,JUNTA CARCASA TOMA ACEITE MOTOR AUDI 1.8 2.0 TFSI TSI (VICTOR REINZ),1272,7,9,6,22
06J117021Q *2,ENFRIADOR ACEITE MOTOR SIMENTRICO EN LA BASE AUDI 2.0L TFSI VW 2.0L 1.4 TSI (EMBLER) GOG,1964,6,3,3,12
06J117021Q *3,ENFRIADOR ACEITE MOTOR SIMENTRICO EN LA BASE AUDI 1.4 TSI (CALIDAD ORIGINAL),1900,2,3,2,7
06J117021Q *5,ENFRIADOR ACEITE MOTOR SIMENTRICO EN LA BASE AUDI 2.0L TFSI VW 2.0L 1.4 TSI (FEBI) SSF,1740,4,2,6,12
06J117070-100,JUNTA DE ENFRIADOR DE ACEITE DE MOTOR AUDI A4-2.0L VIKA INACTIVO,1814,2,3,4,9
06J117070C *2,JUNTA RECTANGULAR ENFRIADOR ACEITE MOTOR AUDI 1.8 2.0 TFSI TSI (EMBLER) GOG,1559,6,0,0,6
06J117070C *5,JUNTA RECTANGULAR ENFRIADOR ACEITE MOTOR AUDI 1.8 2.0 TFSI TSI (ELRING) SSF,1430,6,2,6,14
06J121065F,TUBO REFRIGERANTE A3 VIKA,1647,1,5,4,10
06J121065F *2,TUBO REFRIGERANTE AUDI A3 TT SEAT VW (EMBLER) GOG,1448,0,2,3,5
06J121065F *5,TUBO REFRIGERANTE A3 (CALIDAD ORIGINAL) SSF,1906,0,0,3,3
06J121113A,TERMOSTATO DE MOTOR AUDI A4-B8 1.8 L-2.0 L TFSI MEISTERTASK,1957,4,1,0,5
06J121132G *5,BRIDA TOMA AGUA ENFRIAMIENTO MOTOR AUDI 2.0L TFSI VW 2.0L TSI (FEBI) SSF,1854,5,1,0,6
06J127025G *3,BOMBA COMBUSTIBLE GASOLINA ALTA PRESION AUDI A4 A5 A6 Q5 1.8L 2.0L SEAT VW (HITACHI),1521,5,0,6,11
06J127025J,BOMBA DE ALTA PRESION DE GASOLINA AUDI A4 2.0 BMTR,1913,0,3,7,10
06J198151M,ANILLOS DE MOTOR STD X 4 PISTONES AUDI A4 TFSI - 1.8L 16 VALVULAS MAHLE,1656,1,5,7,13
06J198151M-1,ANILLOS DE MOTOR STD X 1 PISTON AUDI A4 TFSI 1.8L 16 VALVULAS KOLBENSCHMIDT,1394,3,0,8,11
06J260849D,BANDA DE ALTERNADOR AUDI A3 2.0L CONTITECH 6PK1120,1636,6,2,8,16
06J906461D,SENSOR DE MASA DE AIRE MAF AUDI A4 VIKA,1836,9,1,6,16
06K103171G,RETEN DE CIGï¿½Eï¿½AL AUDI A3 / 1.8 ( ELRING ),1910,6,8,6,20
06K103171P *2,RETEN CIGUEï¿½AL MOTOR LADO TRASERO AUDI SEAT VW (EMBLER) GOG,1725,0,9,6,15
06K103171P *5,RETEN CIGUEï¿½AL MOTOR LADO TRASERO AUDI SEAT VW (FEBI) SSF,1460,0,7,5,12
06K103495 *D,DIAFRAGMA VALVULA PCV AUDI VW 1.8 2.0 TFSI 3a GEN (EMBLER) GOG,1743,9,6,9,24
06K103495 *S,SEPARADOR ACEITE PCV AUDI VW 1.8 2.0 TFSI 3a GEN (EMBLER) GOG,1560,6,8,4,18
06K103495-100,SEPARADOR DE ACEITE AUDI A3 VIKA INACTIVO,1416,5,8,1,14
06K103583 ,JUNTA DE DISTRIBUCION AUDI A6 Q5 2.0 GENUINA,1392,2,9,1,12
06K103600R *3,CARTER ACEITE MOTOR AUDI 2.0 TFSI 2014 A 2020 VW 2.0 TSI (GENUINO),1436,8,7,0,15
06K103649 *3,JUNTA CARTER ACEITE MOTOR AUDI A1 A3 Q3 TT VW (VIKA),1577,7,8,6,21
06K109158F *K,KIT 13 PZ GUIAS TENSOR CADENAS DISTRIBUCIï¿½N AUDI VW SEAT TFSI 1.8 2.0 (EMBLER) HPS,1806,7,2,4,13
06K115562,FILTRO ACEITE MOTOR AUDI A3 2.0L MANN HU6002Z,1984,6,8,7,21
06K121111P *2,BOMBA AGUA MECANICA ENFRIAMIENTO MOTOR CON TERMOSTATO BEETLE JETTA PASSAT TFSI 2a GEN (EMBLER) HT,1335,2,1,3,6
06K121132 *2,TOMA AGUA MOTOR A3 Q3 TT ATLAS GOLF TIGUAN (EMBLER) GOG,1375,8,2,5,15
06K121132 *5,BRIDA TOMA AGUA ENFRIAMIENTO MOTOR AUDI A3 A4 Q3 2.0 L TFSI (VAICO) SSF,1332,3,1,8,12
06K121605C,BANDA DENTADA DE BOMBA DE AGUA AUDI A4 1.8 L-2.0 L ORIGINAL,1860,8,4,5,17
06K121605C *2,BANDA DENTADA BOMBA AGUA MOTOR A3 Q3 TT ATLAS GOLF TIGUAN (EMBLER) GOG,1533,5,3,3,11
06K121605C *5,BANDA DENTADA DE BOMBA DE AGUA AUDI A4 1.8 L-2.0 L (CONTINENTAL) SSF,1506,4,1,8,13
06K127025B *2,BOMBA COMBUSTIBLE GASOLINA ALTA PRESION AUDI A3 A6 S3 1.8T SEAT VW (EMBLER),1493,0,4,1,5
06K905611C *3,BUJIA ENCENDIDO IGNICION DOBLE PLATINO AUDI VW SEAT PORSCHE (GENUINA),1288,7,8,3,18
06K905611C *6,BUJIA DE IGNICION DOBLE PLATINO AUDI A4-B9 1.8L-2.0 L TFSI (NGK),1722,9,7,5,21
06K905611C-100,BUJIA IGNICION LASER PLATINUM AUDI 1.8 2.0 TSI ULTIMA GEN (BOSCH) INACTIVO,1472,2,0,8,10
06L103085B,RETEN DE CIGUEï¿½AL DELANTERO AUDI A3 ( ORIGINAL ),1641,9,1,4,14
06L103085B *5,RETEN DE CIGUEï¿½AL DELANTERO AUDI A3-A4-A5 (CORTECO) SSF,1803,7,8,0,15
06L103483A  ,JUNTA DE DISTRIBUCION AUDI A3 A4 A5 GENUINO,1376,4,3,9,16
06L103483A *5,JUNTA TAPA DISTRIBUCION MOTOR 6 ORIFICIOS AUDI VW SEAT 2.0 TFSI TSI (ELRING) SSF,1336,5,1,7,13
06L109259A *2,SENSOR AJUSTE DEL ARBOL LEVAS (L/R) AUDI A3 A4 A5 A6 Q5 VW (EMBLER),1947,9,6,1,16
06L115441 *2,JUNTA ENFRIADOR DE ACIETE AUDI A5 A4 Q5 1.8 (EMBLER) GOG,1412,0,0,2,2
06L115441 *3,JUNTA ENFRIADOR DE ACIETE AUDI A5 A4 Q5 1.8 (GENUINA),1927,3,4,5,12
06L115562B *3,FILTRO ACEITE MOTOR 24 X 52 X 112 MM VW GOLF 1.4 JETTA 1.4 1.5 (MAHLE OX1217D) DGO,1405,3,4,4,11
06L115562B *5,FILTRO ACEITE MOTOR 24 X 52 X 112 MM VW GOLF 1.4 JETTA 1.4 1.5 (MANN) SSF,1498,7,2,6,15
06L117021C *2,ENFRIADOR ACEITE MOTOR ASIMETRICO AUDI VW SEAT 1.8 2.0 TFSI (EMBLER) GOG,1775,2,0,0,2
06L117070,JUNTA DE ENFIRADOR DE ACEITE AUDI A5 A6 Q3 1.8 GENUINA,1379,9,1,6,16
06L117070 *2,JUNTA ENFIRADOR ACEITE AUDI A5 A6 Q3 1.8 (EMBLER) GOG,1827,5,7,3,15
06L117070 *3,JUNTA ENFIRADOR ACEITE AUDI A5 A6 Q3 1.8 (VIKA),1733,0,9,1,10
06L121011B,BOMBA AGUA MECANICA ENFRIAMIENTO MOTOR AUDI A4 2.0 TFSI (GENUINA),1850,2,9,2,13
06L121012A-100,BOMBA AGUA MECANICA ENFRIAMIENTO MOTOR CON TERMOSTATO MECANICO VW BEETLE INACTIVO,1253,8,7,7,22
06L121081K *2,MANGUERA RADIADOR ENFRIAMIENTO MOTOR AUDI A4 A5 A6 Q5 2.0 TFSI (EMBLER),1784,0,5,1,6
06L121111C-100,CABEZA BOMBA AGUA TERMOSTATO ELECTRONICO AUDI VW SEAT 1.8 2.0 TFSI 2a GEN (EMBLER) INACTIVO,1426,8,9,6,23
06L121111G *2,BOMBA AGUA TERMOSTATO ELECTRONICO AUDI VW SEAT 1.8 2.0 TFSI 2a GEN (EMBLER) HT,1909,3,4,0,7
06L121111G *3,BOMBA AGUA TERMOSTATO ELECTRONICO AUDI SEAT VW 1.8 2.0 TFSI 2a GEN (GENUINA),1272,3,8,9,20
06L121111G-100,BOMBA DE AGUA CON TERMOSTATO ELECTRONICO VW BEETLE KAIZZER INACTIVO,1495,4,5,9,18
06L903133D *2,TENSOR BANDA ACCESORIOS MOTOR A3 Q3 TT ATLAS GOLF TIGUAN (EMBLER) GOG,1292,2,0,8,10
06L903133D *5,TENSOR DE BANDA DE TRANSMISION AUDI A3 A4 A5 / 2.0L (LITENS) SSF,1634,6,9,3,18
06M121013D *3,BOMBA AGUA ENFRIAMIENTO MOTOR AUDI VW A6 A7 A8 Q7 3.0L V6 (GENUINA),1317,9,5,8,22
06N115441 *5,JUNTA ENFRIADOR DE ACEITE AUDI A5 A4 Q5 1.8 (ELRING) SSF,1554,9,7,2,18
06Q905601A *5,BUJIA ENCENDIDO IGNICION MOTOR AUDI  VW SEAT (NGK) SSF,1546,5,8,0,13
07119963418 *1,ANILLO DEL TENSOR DE LA CADENA DE DISTRIBUCION BMW MOTOR M43-M44-M50-M52 FREY,1235,6,1,2,9
07131487226 *5,JUEGO DE TORNILLOS DE CABEZA 10X150 MM MINI R50 R52 R53 (VICTOR REINZ) SSF,1751,6,9,7,22
07149158194 *6,GRAPA MOLDURA INTERIOR PUERTAS TRASERAS DELANTERAS BMW E46 E53 E90  (GENUINO) SSF,1451,2,3,8,13
074115561,FILTRO ACEITE MOTOR VOLVO MANN W950/4,1848,5,2,7,14
077109087C *K,KIT 12 PZ JUNTAS TENSOR CADENA DISTRIBUCION AUDI VW 4.2 L V8 (EMBLER) HPS,1468,3,7,7,17
077117021P *2,ENFRIADOR ACEITE TRANSMISION AUTOMATICA VW TOUAREG 4.2 (EMBLER),1921,2,0,6,8
077129620B-4,FILTRO ENTRADA AIRE MOTOR AUDI A6 A8 3.7LTS MANN C28214/1,1808,0,4,6,10
077129620D *3,FILTRO ENTRADA AIRE MOTOR AUDI A6 A8 3.7LTS (MAHLE LX469/1),1774,0,9,2,11
078109119J,BANDA DE DISTRIBUCION AUDI A4 2.8L CONTITECH,1438,7,1,5,13
078121113G *3,TERMOSTATO ENFRIAMIENTO MOTOR AUDI VW V6 2.8 L (MAHLE TX3092D) DGO,1564,6,0,1,7
078121121K,CAJA DE TERMOSTATO,1747,0,9,0,9
078198025,JUNTA DE TAPA DE PUNTERIAS L-R PASSAT 2.8L ELRING,1892,0,0,2,2
078198025 *1,JUNTA TAPA PUNTERIAS (L/R) AUDI 95 A 02 V6 CIL 2.7L 2.8L (CORTECO),1833,5,1,3,9
079103483T,JUNTA DE TAPA DE PUNTERIAS L VW-TOUAREG 4.2 8 CIL ELRING,1596,5,8,9,22
079103483T-1,JUNTA DE TAPA DE PUNTERIAS L VW TOUAREG 4.2L 8 CIL (VIKA),1763,1,0,6,7
079103484C,JUNTA DE TAPA DE PUNTERIAS R VW TOUAREG 4.2 8 CIL GENUINA,1775,1,5,4,10
079103484C-1,JUNTA DE TAPA DE PUNTERIAS R VW TOUAREG 4.2 8 CIL ELRING,1437,3,6,4,13
079117015A,ENFRIADOR DE ACEITE DE MOTOR AUDI RS4 A5 S6 A8 S8 Q7 TOUAREG BMTRS,1441,2,4,1,7
079121115BK,TERMOSTATO DE MOTOR AUDI Q7 4.2 L V8 GENUINO AUDI,1302,7,5,5,17
079121115BK-1,TERMOSTATO DE MOTOR AUDI Q7 4.2 L V8 MAHALE TM4495,1662,3,3,7,13
079133062C,CUERPO DE ACELERACION AUDI A4 / 3.2 L ( GENERICO ),1694,3,2,9,14
079198405E *5,FILTRO ACEITE MOTOR AUDI  A6 A8 Q7 R8 SR4 SS S6 S8 VW TUAREG 4.2 L (MAHLE) SSF,1517,4,9,3,16
079198405E *6,FILTRO ACEITE MOTOR AUDI  A6 A8 Q7 R8 SR4 SS S6 S8 VW TUAREG 4.2 L (MANN) SSF,1905,5,0,8,13
079911022 *M,MARCHA MOTOR ARRANQUE 1.4 KW AUDI A6 A7 S4 S5 SQ5 (EMBLER) TECH,1964,0,4,5,9
07K103469 *2,TAPA PUNTERIAS MOTOR VW BORA MOTOR 2.5L 5 CILINDROS (EMBLER) GOG,1895,8,2,4,14
07K103483B *2,JUNTA DE TAPA DE PUNTERIAS BORA 2.5 ( EMBLER ) GOG,1359,1,6,0,7
07K103483B *5 ,JUNTA TAPA PUNTERIAS MOTOR VW BORA BEETLE JETTA GOLF PASSAT 2.5 L 5 CIL. (VICTOR REINZ) SSF,1986,9,9,5,23
07K115397D,BASE DE FILTRO DE ACEITE DE MOTOR VW BEETLE JETTA V 2.5L GENUINO,1670,5,4,3,12
07K121113B,TERMOSTATO DE MOTOR PASSAT V6 2.5L VAICO,1388,3,2,7,12
07K121113B-1,TERMOSTATO DE MOTOR PASSAT V6 2.5L VEMO,1467,6,0,9,15
07K121115C *2,TERMOSTATO ENFRIAMIENTO MOTOR BEETLE GOL JETTA 2.5  L 5 (EMBLER) GOG,1540,9,8,5,22
07K121133E *2,TOMA AGUA ENFRIAMIENTO MOTOR  BEETLE GOL JETTA 2.5  L 5 (EMBLER) GOG,1464,2,1,5,8
07K129620 *3,FILTRO ENTRADA AIRE MOTOR VW AUDI (MAHLE LX2093),1651,5,4,8,17
07K905715F-100,BOBINA DE IGNICION ENCENDIDO AUDI SEAT INACTIVO,1388,1,2,2,5
07K905715G *5,BOBINA IGNICION AUDI VW SEAT 2.0 L 16 VALVULAS TURBO TFSI (BREMI) SSF,1637,0,8,0,8
07K905715G *6,BOBINA IGNICION AUDI VW SEAT 2.0 L 16 VALVULAS TURBO TFSI (BOSCH) SSF,1701,1,3,8,12
07K906433B,SENSOR DE CIGUEï¿½AL JETTA / 2.5L L5 ( GENUINO ),1904,2,4,8,14
07K907601,SENSOR DE ARBOL DE LEVAS AUDI A4 -2.0L ( TOPRAN ),1817,4,6,9,19
07K907601A,SENSOR DE ARBOL DE LEVAS AUDI A4 / 2.0L ( GENUINO ),1862,2,1,7,10
07L905163C,SENSOR DE ARBOL DE LEVAS AUDI A4 2.0 TFSI GENUINO,1551,1,9,3,13
081RS001040N0 *3,KIT DE AROS DE PISTON BMW MINI 2007 A 2016 (MAHLE 081RS001040N0) DGO,1841,3,8,8,19
090906288 *1,JUNTA DE TAPA DE PUNTERIAS ( L-R ) BMW F10-N63 FREY,1838,2,8,5,15
096409061G,ENFRIADOR DE ACEITE DE TRANSMISION AUTOMATICA JETTA A3-A4 ORIGINAL,1610,0,7,5,12
096409061G *2,ENFRIADOR ACEITE TRANSMISION AUTOMATICA JETTA (EMBLER),1622,3,8,6,17
096409061G-1,ENFRIADOR DE ACEITE DE TRANSMISION AUTOMATICA JETTA A3-A4 TAIFA,1496,6,6,6,18
0986BF0018,FILTRO COMBUSTIBLE GASOLINA VW-AUDI A3 1.6 L MANN WK58/3,1667,4,8,4,16
0995001300 *1,ENFRIADOR ACEITE TRANSMISION AUTOMATICA MERCEDES W222 W205 W217 W213 (FREY),1230,6,2,6,14
0995001303 *1,RADIADOR ENFRIAMIENTO MOTOR MERCEDES BENZ W164 W166 M276 (FREY),1663,2,1,3,6
0995002300 *1,ENFRIADOR DE ACEITE DE MOTOR MERCEDES BENZ W204 C250-R172-SLK250 (FREY),1816,9,9,3,21
0995006203 *1,RADIADOR ENFRIAMIENTO MOTOR MERCEDES W204 M271 R172 M276 (FREY),1392,1,7,5,13
0995007303 *1,RADIADOR DE MOTOR MERCEDES BENZ W205 W213 FREY,1701,4,8,4,16
0997200135 *1,ACTUADOR ELECTRICO DE CHAPA DELANTERO (L) MERCEDES X204 GLK (FREY),1511,2,2,8,12
0997200435 *1,ACTUADOR ELECTRICO DE CHAPA DELANTERO (R) MERCEDES X204 GLK (FREY),1607,0,4,3,7
0999053800 *1,SENSOR DE TEMPERATURA MERCEDES W203 / M112 FREY,1377,2,4,7,13
0999053800-2,SENSOR DE TEMPERATURA MERCEDES W203-M112 FACET,1426,2,8,5,15
0999060612 *1,MOTOVENTILADOR MERCEDES W222 FREY,1567,4,2,0,6
0999061100 *1,MOTOVENTILADOR ENFRIAMIENTO MOTOR MERCEDES W205 W213 X253 (FREY),1755,3,1,4,8
0999061200,MOTOVENTILADOR MERCEDES W205 FREY,1851,9,5,4,18
0999062500 *1 ,MOTOVENTILADOR ENFRIAMIENTO MOTOR 600W MERCEDES W166 M276 X166 M278 (FREY),1381,8,5,8,21
09G301189 *5,RETEN DE FLECHA IZQUIERDA TRANSMISION AUTOMATICA VOLVO S40 (CORTECO) SSF,1763,2,4,8,14
09G321361 *2,CARTER ACEITE TRANSMISION JETTA A4 A6 BORA VENTO BEETLE (EMBLER) GOG,1993,2,5,6,13
09G321361-100,CARTER ACEITE TRANSMISION JETTA A4 A6 BORA VENTO POLO BEETLE EMBLER INACTIVO,1616,4,8,5,17
09G409061,ENFRIADOR DE ACEITE DE TRANMISION AUTOMATICA SEAT A3 PASSAT JETTA GOLF BETTLE GENUINO,1551,4,9,5,18
09G409061 *2,ENFRIADOR DE ACEITE DE TRANMISION AUTOMATICA SEAT A3 PASSAT JETTA GOLF BETTLE (EMBLER) GOG,1694,8,6,1,15
0AT325429,FILTRO ACEITE TRANSMISION AUDI Q7 3.6L REIN,1882,1,4,8,13
0BH325183A*3,FILTRO TRANSMISION AUDI Q3 2.0L (MAHLE HX139DECO),1835,1,0,0,1
0GC325183A *2,FILTRO ACEITE MOTOR AUTOMATICO DSG 0D9 AUDI (EMBLER),1601,7,1,9,17
0GC325183A *5,FILTRO LIQUIDO TRANSMISION DSG DOBLE CLUTCH AUDI VW SEAT (FEBI) SSF,1267,5,6,3,14
0PB115466 *5,FILTRO ACEITE MOTOR PORSCHE (MAHLE OX254/D4) SSF,1891,4,8,3,15
1,ORING BMW E46,1229,4,4,4,12
1-100,SENSOR FRENOS ABS DELANTERO (L/R) MERCEDES R172  (FREY) INACTIVO,1449,0,3,7,10
10,EMBLEMA DE BMW DE LLAVE,1561,7,1,0,8
1000,RENTA DE HERRAMIENTA PARA SINCRONIZAR MOTOR BMW E46 ( MOTOR M54 ),1694,9,5,4,18
10000,EMBLEMA DE CAJUELA BMW E53 LETRAS X5,1209,2,7,7,16
10000000,LLAVERO MERCEDES BENZ,1398,4,8,4,16
100000000,EMBLEMA DE CAJUELA  M3  BMW E46,1621,6,1,6,13
1000000000,"EMBLEMA """"M"""" DE SALPICADERA CROMO CON NEGRO BMW ( 3M )",1940,2,9,9,20
10001,EMBLEMA DE PARRILLA M3 BMW E46,1397,6,7,5,18
10002,EMBLEMA DE VOLANTE BMW  ( 45 MM ),1929,9,6,8,23
1003688 *5,LIQUIDO LIMPIADOR CUERPO ACELERACION AEROSOL 12 OZ. (CRC) SSF,1238,6,0,2,8
101000062AB-100,BUJIA DE PLATINO VW JETTA 2.0L NGK PZFR5D11 GENUINA INACTIVO,1529,6,7,6,19
101905601F *3,BUJIA ENCENDIDO IGNICION DOBLE PLATINO HIGH POWER VW 2.5L (NGK),1916,1,9,8,18
101905631C,BUJIA DOBLE PLATINO AUDI A4 2.0 TFSI BOSCH,1444,6,2,6,14
1020302040,METALES DE CENTRO EN ESTANDAR MERCEDES W203 ( KOLBENSCHMIDT 87435600 ),1640,9,6,2,17
1020302040 *1,METALES DE CENTRO EN ESTANDAR MERCEDES W203 FREY,1998,8,6,9,23
1022000417,TOMA DE AGUA CAJA DE TERMOSTATO MERCEDES W203 / M102 ( BMTR ),1587,4,0,4,8
1022000417 *1,TOMA DE AGUA CAJA DE TERMOSTATO MERCEDES W203-M102 FREY,1669,1,6,5,12
1032000114,AMORTIGUADOR TENSOR DE BANDA (EMBLER),1328,5,7,3,15
1032000422,FAN CLUTCH DE 3 TORNILLOS MERCEDES W124 URO,1353,2,4,6,12
1032000422 *1,FAN CLUTCH DE 3 TORNILLOS MERCEDES W124 FREY,1994,5,2,4,11
1040102130,JUNTA DE TAPA DE PUNTERIAS MERCEDES M104 BGA,1324,9,2,6,17
1040102130 *1,JUNTA TAPA PUNTERIAS MOTOR MERCEDES M102 M104 (FREY),1202,9,5,8,22
1040162820 *1,JUNTA CABEZA MOTOR MEDIDA STANDAR 1.74 MM MERCEDES M104 (FREY),1667,6,6,5,17
1040162820-1,JUNTA CABEZA MOTOR MEDIDA STANDAR 1.74 MM MERCEDES M104 ELRING,1605,8,5,1,14
1041800109 *1,FILTRO ACEITE MOTOR MERCEDES M111 (FREY),1251,3,8,0,11
1041800109 *3,FILTRO ACEITE MOTOR MERCEDES M111 (MAHLE OX133),1630,0,6,3,9
1041800109 *5,FILTRO ACEITE MOTOR MERCEDES M111 (MANN HU727/1X) SSF,1305,4,7,0,11
1041800109 *6,FILTRO ACEITE MOTOR MERCEDES M111 (BOSCH) SSF,1926,9,2,0,11
1041800109 *7,FILTRO ACEITE MOTOR MERCEDES M111 (HENGST) SSF,1460,8,4,6,18
1042050210,POLEA FAN CLUTCH MERCEDES W124 ( GENUINA ),1806,2,0,6,8
1042050210 *1,POLEA FAN CLUTCH MERCEDES W124 FREY,1477,5,6,1,12
11,RENTA HERRAMIENTA DE SICRONIZACION DE MOTOR N46 / N46N,1252,2,0,1,3
110111000000,SOPORTE DE BULBO LUZ XENON BMW D1S-D1R-D3S-D3R,1452,5,4,4,13
110696 *3,LIQUIDO PRESURIZADO LIMPIADOR INYECTORES COMBUSTIBLE MOTOR (MOTUL),1271,8,2,4,14
1110102820,JUEGO DE JUNTAS DE MOTOR MERCEDEZ BENZ W202 BMTSR,1962,4,1,9,14
1110160921,JUNTA DE PUNTERIAS DE MERCEDES BENZ M111 ELRING,1990,6,6,0,12
1110160921-1,JUNTA DE PUNTERIAS DE MERCEDES BENZ M111 CORTECO,2000,7,9,7,23
1110162620 *1,JUNTA CABEZA MOTOR MEDIDA STANDAR 1.75 MM MERCEDES M111 (FREY),1425,9,4,7,20
1110163220,JUNTA CABEZA MOTOR MEDIDA STANDAR 1.70 MERCEDES M111 (VICTOR REINZ),1599,4,6,3,13
1110163220-1,JUNTA CABEZA MOTOR MEDIDA STANDAR 1.70 MERCEDES M111 (BGA ),1449,8,6,9,23
1110180302,TAPON DE ACEITE MERCEDES BENZ W176 TOPRAN,1842,3,4,3,10
1110180302 *3,TAPON DE ACEITE MERCEDES BENZ W176 (MEISTERSATZ),1652,4,4,6,14
1110380910,METALES DE BIELA EN ESTANDAR MERCEDES W203 KOLBENSCHMIDT 77530600,1261,1,4,9,14
1110940148,SENSOR DE MASA DE AIRE MAF MERCEDES MOTOR M111 BREMI,1927,9,5,7,21
1110940204,FILTRO ENTRADA AIRE MOTOR MERCEDES W203 2.3 L KOLBENSCHMIDT,1678,7,7,2,16
1110940204 *3,FILTRO ENTRADA AIRE MOTOR MERCEDES W203 2.3 L (MAHLE LX939),1408,3,5,3,11
1110940204-1,FILTRO ENTRADA AIRE MOTOR MERCEDES W203 2.3 L MANN C47109,1926,9,3,8,20
1110981037,SUPERCARGADOR DE COMPRESOR SEMINUEVO MERCEDES W203 ( GENUINO ),1362,7,7,5,19
1110981037 *1,SUPERCARGADOR DE COMPRESOR SEMINUEVO MERCEDES W203 FREY,1462,9,5,6,20
11110008361,JUEGO JUNTAS DE MOTOR INFERIOR BMW E53-N62 BMTSR,1888,2,0,2,4
11110008361 *1,JUEGO JUNTAS DE MOTOR INFERIOR BMW E53-N62 FREY,1929,5,9,0,14
11111432478 *1,JUEGO JUNTAS MOTOR INFERIOR BMW M54 (FREY),1387,9,4,9,22
11111485171 *5,RETEN DE CIGï¿½Eï¿½AL DELANTERO MINI R50 R52 R53 (VICTOR REINZ) SSF,1863,6,3,5,14
11111492244 *5,RETEN TRASERO CIGUEï¿½AL MOTOR MINI W10 W11 (VICTOR REINZ) SSF,1848,1,9,0,10
11117511395,RETEN DE CIGUEï¿½AL DELANTERO 65X79X20 BMW MOTOR N46N-N46 ELRING,1283,4,8,4,16
11117511396-100,RETEN TRASERO CIGUEï¿½AL 90X110X12 BMW N52N N54 INACTIVO,1701,4,3,0,7
11117511529,JUEGO DE JUNTAS DE MOTOR INFERIOR BMW MOTOR N46-N46N BMTSR,1778,1,8,8,17
1111751395-100,RETEN DE CIGUEï¿½AL DELANTERO 65X7920 BMW MOTOR N46N-N4 INACTIVO,1928,1,3,1,5
11117530262,TAPA DE MONOBLOCK DE MOTOR BMW E90 / N52 / N52N / N54 ( ELRING ),1580,5,4,6,15
11117530262 *1,TAPA DE MONOBLOCK DE MOTOR BMW E90 / N52 / N52N / N54 FREY,1626,9,7,4,20
11117547842 *1,RETEN CIGUEï¿½AL DELANTERO MOTOR 65X79X20 BMW N46 N46N N52 N52N N54 N55 (FREY),1920,3,7,6,16
11117547842-1,RETEN DE CIGUEï¿½AL DELANTERO 65X79X20  BMW MOTOR N52-N52N-N54 CORTECO,1567,8,2,8,18
11117547842-100,RETEN DE CIGUEï¿½AL DELANTERO 65X7X20  BMW MOTOR INACTIVO,1722,1,4,5,10
11117547842-3,RETEN DE CIGUEï¿½AL DELANTERO 65X79X20  BMW MOTOR N52-N52N-N54 ELRING,1949,1,2,1,4
11117548101,JUEGO DE JUNTAS DE MOTOR INFERIOR BMW MOTOR N52-N52N BMTSR,1541,4,8,4,16
11117551866,JUEGO JUNTAS DE MOTOR INFERIOR BMW MOTOR E60-N62 BMTSR,1391,5,6,8,19
11117568263 *3,RETEN DE CIGï¿½Eï¿½AL TRASERO 105X85X8 MINI R56 (VIKA),1485,1,6,3,10
11117568264 *5,RETEN DELANTERO CIGUEï¿½AL MOTOR MINI N12 N13 N14 N16 N18 (VICTOR REINZ) SSF,1989,3,9,2,14
11117568264 *6,RETEN DELANTERO CIGUEï¿½AL MOTOR MINI N12 N13 N14 N16 N18 (ELRING) SSF,1411,1,4,6,11
11117584398 *1,RETEN TRASERO CIGUEï¿½AL MOTOR 90X110X12 BMW N20 N46N N52N N54 N55 (FREY),1509,0,9,3,12
11117584398 *5,RETEN TRASERO CIGUEï¿½AL 90X110X12 BMW N20 N46N N52 N54 N55 (VICTOR REINZ) SSF,1875,3,8,6,17
11117584398 *6,RETEN TRASERO CIGUEï¿½AL 90X110X12 BMW N20 N46N N52 N54 N55 (ELRING) SSF,1567,0,7,7,14
11117587168 *1,RETEN CIGUEï¿½AL TRASERO 90X110X8 BMW N20 N52N N54 N55 (FREY),1656,3,3,2,8
11117593353 *1,RETEN CIGUEï¿½AL DELANTERO 65X79X10 BMW N20 N55 (FREY),1837,1,5,8,14
11117797932 *1,TAPA EXTREMO DEL MOTOR CON JUNTA BMW F60 G01 G30 G38  (FREY),1987,5,2,5,12
11118511205 *1,TOMA AGUA MONOBLOCK PLASTICO ENFRIAMIENTO MOTOR BMW B42 B46 B48 MINI B36 B38 (FREY),1762,1,3,5,9
11118511205B,TOMA AGUA MONOBLOCK ALUMINIO ENFRIAMIENTO MOTOR BMW B42 B46 B48 MINI B36 B38 (FREY),1382,6,1,1,8
11118571141 *1  ,BRIDA TOMA AGUA ENFRIAMIENTO MOTOR BMW MINI F30 F31 F20 F21  F48 (FREY),1557,2,7,4,13
11118604931 *1,RETEN DELANTERO CIGUEï¿½AL MOTOR 55X68X8 MM  BMW B46 B48 B58 (FREY),1648,9,7,9,25
11118618864-1,RETEN DE CIGUEï¿½AL DELANTERO 65X79X10 BMW MOTOR N20-N55 ELRING,1381,1,5,4,10
11119070240,JUEGO JUNTAS DE MOTOR INFERIOR BMW MOTOR M62-B30 B40 BMTRS,1389,0,1,5,6
1112000070,POLEA DE TENSOR DE BANDA DE ACCESORIOS MERCEDES W202-M111 URO,1811,9,8,1,18
1112000070 *1,POLEA DE TENSOR BANDA DE ACCESORIOS MERCEDES M111 (FREY),1549,2,6,6,14
1112000070-1,POLEA DE TENSOR DE BANDA DE ACCESORIOS MERCEDES W202-M111 INA,1306,8,1,7,16
1112000401 *1,BOMBA AGUA ENFRIAMIENTO MOTOR MERCEDES W202 M111 (FREY),1849,7,3,0,10
1112000414,AMORTIGUADOR DE TENSOR HIDRAULICO MERCEDES W202 C220A-C230A-C230K STABILUS,1944,5,2,7,14
1112000414  *1,AMORTIGUADOR DE TENSOR HIDRAULICO MERCEDES W202 C220A-C230A-C230K FREY,1997,6,3,2,11
11120004553,JUNTA DE CABEZA DE MOTOR L BMW E53-M62 VICTOR  (REINZ ),1386,3,0,2,5
11120004553 *1,JUEGO DE JUNTAS BMW E53-M62 FREY,1843,5,3,0,8
11120004553-2,JUNTA DE CABEZA DE MOTOR L BMW E53-M62 BMTR,1584,4,0,4,8
1112000770,TENSOR DE BANDA DE ACESORIOS MERCEDES W202 / M111 ( FEBI ),1689,0,8,2,10
1112000770 *1,TENSOR DE BANDA DE ACESORIOS MERCEDES W202-M111 FREY,1668,4,7,1,12
1112001370,TENSOR DE SUPERCARGADOR MERCEDES W202-M111 INA,1768,6,5,1,12
1112001370  *1,TENSOR DE SUPERCARGADOR MERCEDES W202-M111 FREY,1612,5,4,0,9
1112002301,BOMBA AGUA MECANICA ENFRIAMIENTO MOTOR CUELLO LARGO M202 W170 (BGA),1556,7,0,7,14
11120030496 *1,JUNTA TAPA PUNTERIAS MOTOR BMW E39 E46 E53 E60 E83 E84 M54 (FREY),1395,7,2,1,10
11120030496 *5,JUNTA TAPA PUNTERIAS MOTOR BMW E39 E46 E53 E60 E83 E84 M54 (VICTOR REINZ) SSF,1594,8,3,5,16
11120030496-100,JUNTA DE TAPA DE PUNTERIAS BMW E46 - M54 INACTIVO,1907,5,9,7,21
1112003222-100,JUNTA DE TAPA DE PUNTERIAS BMW E87-N46 INACTIVO,1982,6,3,1,10
11120032224 *1,JUNTA TAPA PUNTERIAS BMW N46 1a GEN (FREY),1953,4,1,4,9
11120032224-100,JUNTA DE TAPA DE PUNTERIAS BMW N46 INACTIVO,1559,7,4,9,20
11120032224-2,JUNTA DE TAPA DE PUNTERIAS BM,1614,6,1,6,13
11120034104-1,JUNTA DE TAPA DE PUNTERIAS BMW E39-M62 ELRING 266330,1235,3,8,8,19
11120034105 * 1,JUNTA DE TAPA DE PUNTERIAS  BMW E53-M62 APH ALEMAN,1769,1,5,2,8
11120034105 * 5,JUNTA DE TAPA DE PUNTERIAS  BMW E53-M62 BMTR,1503,0,9,4,13
11120034105-1 * 8,JUNTA DE TAPA DE PUNTERIAS  BMW E53-M62 ELRING 266370,1663,5,5,9,19
11120034107,JUNTA DE TAPA DE PUNTERIAS BMW E36 325i M50 VICTOR REINZ,1973,5,1,2,8
11120034107-100,JUNTA DE TAPA DE PUNTERIAS BMW E36 325i M50 INACTIVO,1594,0,7,2,9
11120034107-2,JUNTA DE TAPA DE PUNTERIAS BMW E36 325i M50 ELRING,1749,3,3,9,15
11120034107-4,JUNTA DE TAPA DE PUNTERIAS BMW E36 325i M50 CORTECO,1731,5,4,9,18
11120034108 *5,JUNTA PLANA TAPA PUNTERIAS MOTOR BMW Z3 E36 M52 S52 E39 M52 (EL RING) SSF,1381,9,3,3,15
11120034108-100,JUNTA DE TAPA DE PUNTERIAS BMW E36-M52 BMTR INACTIVO,1388,0,8,3,11
11120034108-3,JUNTA DE TAPA DE PUNTERIAS BMW E36-M52 (BGA),1619,3,1,5,9
11120035738 *1,JUNTA TAPA PUNTERIAS BMW N46N 2a GEN (FREY),1439,5,0,1,6
1112004201 *1,BOMBA AGUA MECANICA ENFRIAMIENTO MOTOR MERCEDES W203 R170 M111 (FREY),1668,0,3,6,9
11120143667,JUEGO DE JUNTAS DE MOTOR BMW MOTOR N46 FREY,1980,8,6,2,16
1112020119,POLEA DE REENVIO DE SUPERCARGADOR MERCEDES W202 / M111 INA,1664,0,2,4,6
1112020119 *1,POLEA TENSORA DE REENVIO DE SUPERCARGADOR MERCEDES BENZ W202-W140/M104-M111 FREY,1993,2,6,0,8
1112020119-1,POLEA DE REENVIO DE SUPERCARGADOR MERCEDES W202 - M111 URO,1390,8,6,1,15
11120308857 *1,KIT FULL JUEGO JUNTAS MOTOR JUNTA CABEZA MEDIDA STD 0.40 MM BMW N46 (FREY),1722,9,8,4,21
11120308857B,KIT 66 PZ JUEGO JUNTAS MOTOR SUPERIOR SIN JUNTA CABEZA BMW N46 (FREY),1368,8,3,2,13
11121432928,TAPA DE PUNTERIAS BMW E46 / M54 ( SEMINUEVA ORIGINAL ),1373,5,5,7,17
11121432928 *1,TAPA PUNTERIAS MOTOR CON JUNTA GRUESA BMW M52 M54 1a GEN (FREY),1243,9,2,5,16
111214334-100,JUNTA DE CABEZA DE MOTOR BMW E53-M62 BMTR INACTIVO,1303,8,0,0,8
11121433473,JUNTA CABEZA MOTOR (R) MEDIDA STANDAR 1.74 MM BMW M62 VICTOR REINZ,1817,2,7,7,16
11121433473 *1,JUNTA CABEZA MOTOR (R) MEDIDA STANDAR 1.74 MM BMW M62 (FREY),1902,8,1,1,10
11121433473-1,JUNTA CABEZA MOTOR (R) MEDIDA STANDAR 1.74 MM BMW M62 ELRING,1797,5,5,3,13
11121433477 *1,JUNTA CABEZA MOTOR (L) MEDIDA STANDAR 1.74 MM BMW M62 (FREY),1604,6,7,9,22
11121433477-1,JUNTA CABEZA MOTOR (L) MEDIDA STANDAR 1.74 MM BMW M62 VICTOR REINZ,1383,2,7,1,10
11121433950,JUNTA CABEZA MOTOR MEDIDA STANDAR 1.74 MM BMW M44 BGA,1804,3,0,1,4
11121437395 *1,1 PZ SELLO TORNILLO DE TAPA PUNTERIAS BMW M50 M52 M54 M62 (FREY),1291,1,6,0,7
11121437395-9,SELLO TORNILLO DE TAPA DE PUNTERIAS BMW E46 ( BMTR ),1378,6,1,0,7
11121485838,JUNTA TAPA PUNTERIAS MINI W10 W11 MAHLE,1975,2,2,0,4
11121485838 *5,JUNTA TAPA PUNTERIAS MINI W10 W11 (VICTOR REINZ) SSF,1485,9,8,8,25
11121485838-1,JUNTA TAPA PUNTERIAS MINI W10 W11 TOPRAN,1830,2,1,5,8
11121485838-4,JUNTA TAPA PUNTERIAS MINI W10 W11 CORTECO,1467,5,5,3,13
11121703341 *1,TAPA PUNTERIAS MOTOR CON JUNTA PLANA BMW E36 E38 E39 M52 1a GEN (FREY),1547,6,2,3,11
11121710781,TAPA DE MOTOR BMW M52 M54 SEMINUEVA (ORIGINAL),1525,3,8,2,13
11121717432,TOMA DE AGUA DE CABEZA DE MOTOR BMW MOTOR M50-M52 GENUINA,1528,3,9,1,13
11121721475,JUNTA DE GOMA CENTRAL PARA TAPA DE PUNTERIAS BMW E36-Z3 M44 MEISTERSAT,1916,9,7,1,17
11121721475 *1,JUNTA DE GOMA CENTRAL PARA TAPA DE PUNTERIAS BMW E36-Z3 M44 FREY,1480,9,0,2,11
11121721476,JUNTA DE GOMA CENTRAL PARA TAPA DE PUNTERIAS BMW E36-Z3 M44 MEISTERSATZ,1406,9,0,0,9
11121721476 *1,JUNTA DE GOMA CENTRAL PARA TAPA DE PUNTERIAS BMW E36-Z3 M44 ( FREY ),1884,5,6,7,18
11121721876,JUNTA DE TAPA DE PUNTERIAS BMW E36-Z3 M44 BMTR,1978,0,8,4,12
11121721876 *1,JUNTA DE TAPA DE PUNTERIAS BMW E36-Z3 M44 FREY,1444,1,6,5,12
11121721876-1,JUNTA DE TAPA DE PUNTERIAS BMW E36-Z3 M44 VICTOR REINZ,1577,8,4,3,15
11121726089,TAPA DE EMBELLECEDOR DE MOTOR BMW E46 ( GENUINA ),1460,8,4,3,15
11121726089 *1,TAPA DE EMBELLECEDOR DE MOTOR BMW E46 FREY,1438,3,4,6,13
11121726617 *1,JUNTA CABEZA MOTOR MEDIDA STANDAR 1.75 MM BMW M50 M52 (FREY),1357,6,6,4,16
11121726617-2,JUNTA CABEZA MOTOR MEDIDA STANDAR 1.75 MM BMW M50 M52 BGA,1420,1,8,8,17
11121726617-9,JUNTA CABEZA MOTOR MEDIDA STANDAR 1.75 MM BMW M50 M52 BMTR,1284,9,7,8,24
11121726620,JUNTA CABEZA MOTOR MEDIDA STANDAR 2.05 MM BMW M50 M52 (VICTOR REINZ),1866,1,3,8,12
11121726620 *1,JUNTA CABEZA MOTOR MEDIDA STANDAR 2.05 MM BMW M50 M52 (FREY),1894,9,4,2,15
11121735533,GUIA DE VALVULA DE CABEZA DE MOTOR BMW E46-M54 ORIGINAL,1657,5,2,2,9
11121735533 *1,GUIA DE VALVULA DE CABEZA DE MOTOR BMW E46-M54 FREY,1561,4,2,1,7
11121735533 *5,GUIA DE VALVULA DE CABEZA DE MOTOR BMW E46-M54 (CANYON) SSF,1807,3,1,7,11
11121735533-3,GUIA DE VALVULA DE CABEZA DE MOTOR BMW E46-M54 FEBI,1935,3,1,7,11
11121738963,JUNTA DE TOMA DE AGUA CABEZA DE MOTOR BMW MOTOR M50-M52 GENUINA,1351,6,2,4,12
11121740065 *1,JUEGO DE TORNILLOS DE CABEZA 10X110 MM BMW E46-M54 FREY,1508,2,8,3,13
11121740065 *3,KIT 14 PZ. TORNILLOS CABEZA 10X110 MM BMW M52 M54 (ELRING),1595,3,9,6,18
11121740065 *5,KIT 14 PZ. TORNILLOS CABEZA 10X110 MM BMW M52 M54 (VICTOR REINZ) SSF,1530,4,6,5,15
11121740065-1,JUEGO DE TORNILLOS DE CABEZA 10X110 MM BMW E46-M54 MEISTERSATZ,1665,4,7,7,18
11121740065-2,JUEGO DE TORNILLOS DE CABEZA 10X110 MM BMW E46-M54 ELRING,1366,5,5,6,16
11121743294 *1,TAPON ALIMENTACION ACEITE TAPA PUNTERIAS BMW M52 M54 N46 N52N (FREY),1352,0,5,9,14
11121743294-100,TAPON DE TAPA DE PUNTERIAS BMW E46 INACTIVO,1842,4,7,9,20
11121743294-101,TAPON DE TAPA DE PUNTERIAS BMW E46 OSSCA INACTIVO,1686,7,4,4,15
111228000000,TAPA DE PUNTERIAS BMW E53 ( SEMINUEVA ORIGINAL ),1535,9,2,2,13
1112575036,TAPA DE MOTOR BMW N54 SEMINUEVA (ORIGINAL),1691,1,5,7,13
11127500568 *2,TAPON ALIMENTACION ACEITE TAPA PUNTERIAS BMW M52 M54 N46 N52N (GENUINO),1709,8,0,4,12
11127501304 *1,JUNTA CABEZA MOTOR MEDIDA STANDAR 0.70MM BMW M52 M54 2.5 2.8 3.0 (FREY),1998,9,7,8,24
11127501304 *5,JUNTA CABEZA MOTOR MEDIDA STANDAR 0.70MM BMW M52 M54 2.5 2.8 3.0 (VICTOR REINZ) SSF,1510,3,0,6,9
11127501305 *1,JUNTA CABEZA MOTOR SOBRE MEDIDA 1.00MM BMW M52 M54 2.5 2.8 3.0 (FREY),1793,9,1,7,17
11127501305 *5,JUNTA CABEZA MOTOR SOBRE MEDIDA 1.00MM BMW M52 M54 2.5 2.8 3.0 (VICTOR REINZ) SSF,1273,9,9,7,25
11127501305-100,JUNTA CABEZA MOTOR SOBRE MEDIDA 1.00 MM BMW M52 M54 INACTIVO,1814,8,3,4,15
11127506983 *1,JUNTA CABEZA MOTOR STANDAR 0.70MM BMW MOTOR M54 2.2 SOLO PARA 320I (FREY),1593,2,7,9,18
11127506983-100,JUNTA CABEZA DE MOTOR STD 0.70 MM BMW MOTOR M54 (SOLO 320i) BMTR INACTIVO,1514,4,2,7,13
11127507217 *1,RETEN TRASERO TAPA PUNTERIAS 76X61X11.5 MM BMW N20 N26 (FREY),1841,3,6,3,12
11127507597 *1,KIT 30 PZ JUEGO JUNTAS SUPERIOR CABEZA MOTOR STANDAR 0.70MM BMW MOTOR M54 2.2 SOLO PARA 320I (FREY),1759,0,9,0,9
11127507597-100,JUEGO JUNTAS DE MOTOR SUPERIOR BMW E46-M54 INACTIVO,1278,9,0,8,17
11127508543 *5,JUNTA CABEZA MOTOR MEDIDA STANDAR 0.65 MM MINI W210 W211 (VICTOR REINZ) SSF,1812,3,5,3,11
11127508543-1,JUNTA CABEZA MOTOR MEDIDA STANDAR 0.65 MM MINI W210 W211 BGA,1942,3,1,5,9
11127508544,JUNTA CABEZA MOTOR SOBRE MEDIDA 0.90 MM MINI W10 W11 (ELRING),1738,6,4,7,17
11127509710 *1,JUNTA CABEZA MOTOR MEDIDA STANDAR 0.40 MM BMW N46 (FREY),1418,6,0,8,14
11127509710-1,JUNTA CABEZA MOTOR MEDIDA STANDAR 0.40 MM BMW N46 BMTRS ALEMANA,1272,0,4,1,5
11127509710-2,JUNTA CABEZA MOTOR MEDIDA STANDAR 0.40 MM BMW N46 BGA,1364,9,5,5,19
11127509710-3,JUNTA CABEZA MOTOR MEDIDA STANDAR 0.40 MM BMW N46 ELRING,1249,9,8,7,24
11127509711,JUNTA CABEZA MOTOR SOBRE MEDIDA 0.70 MM BMW N46 BGA,1386,5,3,4,12
11127509711 *1,JUNTA CABEZA MOTOR SOBRE MEDIDA 0.70 MM BMW N46 (FREY),1509,1,1,9,11
11127512839 *1,TAPA PUNTERIAS MOTOR 2a GENERACION BMW M54 (FREY),1247,5,3,5,13
11127513194 *1,JUNTA TAPA PUNTERIAS MOTOR (R) BMW N62 N62N (FREY),1424,7,3,2,12
11127513194 *5,JUNTA TAPA PUNTERIAS MOTOR (R) BMW N62 N62N (VICTOR REINZ),1633,0,9,6,15
11127513195 *1,JUNTA TAPA PUNTERIAS MOTOR (L) BMW N62 N62N (FREY),1489,0,4,2,6
11127513195 *5,JUNTA TAPA PUNTERIAS MOTOR (L) BMW N62 N62N (VICTOR REINZ) SSF,1856,3,2,4,9
11127513944 *1,JUNTA CABEZA MOTOR MEDIDA STANDAR 0.75 MM BMW N62 (FREY),1542,9,0,2,11
11127514543 *5,CABEZA CILINDROS MOTOR SEMINUEVA BMW M52 M54 (GENUINA) EBY,1210,1,1,9,11
11127518017,JUEGO JUNTAS DE MOTOR ( SUPERIOR ) BMW E53-N62 BMTR,1700,7,0,3,10
11127518017 *1,JUEGO JUNTAS DE MOTOR SUPERIOR BMW E53-N62 FREY,1456,4,8,6,18
11127522159,TAPA DE PUNTERIAS IZQUIERDA BMW E53 / N62  ( SEMINUEVA ORIGINAL ),1668,6,9,3,18
11127522159 *1,TAPA DE PUNTERIAS IZQUIERDA BMW E53 / N62 FREY,1486,4,3,5,12
11127522159 *2,TAPA DE PUNTERIAS IZQUIERDA BMW E53 / N62 (EMBLER),1447,7,0,5,12
11127530256 *1,JUNTA CABEZA MOTOR MEDIDA STANDAR 0.75 MM BMW N62 N62N (FREY),1628,0,5,0,5
11127530256 *5,JUNTA CABEZA MOTOR MEDIDA STANDAR 0.75 MM BMW N62 N62N (VICTOR REINZ) SSF,1968,5,7,7,19
11127530256-100,JUNTA DE CABEZA DE MOTOR  BMW E53-N62 BMTR INACTIVO,1906,0,1,7,8
11127547058,TAPON DE TAPA DE PUNTERIAS BMW E53-N62 BMTR,1481,2,3,4,9
11127547058 *1,TAPON DE TAPA DE PUNTERIAS BMW E53-N62 FREY,1362,2,8,0,10
11127547058-2,DIAFRAGMA DE VALVULA PCV BMW MOTOR N62 N62N ( EMBLER ),1974,2,8,9,19
11127547058A,KIT DE REPARACION DE VALVULA PCV 2 PZ BMW E53-N62 AFTERMARKET,1791,9,9,9,27
11127548274,TAPA DE PUNTERIAS BMW E90-N52 BMTR,1356,7,8,8,23
11127548274 *1,TAPA DE PUNTERIAS BMW E90-N52 FREY,1728,4,6,2,12
11127548799 *1,KIT 12 PZ JUEGO TORNILLOS CABEZA MOTOR BMW N52 N52N (FREY),1660,1,4,2,7
11127548799 *5,KIT JUEGO TORNILLOS CABEZA MOTOR 14 PZ. BMW N52 N52N (VICTOR REINZ) SSF,1343,9,5,8,22
11127548921,JUEGO JUNTAS DE MOTOR COMPLETO BMW E90 N52N-B25 BMTR,1629,4,0,0,4
11127548921 *1,KIT 66 PZ JUEGO JUNTAS MOTOR SUPERIOR BMW N52 (FREY),1843,4,4,7,15
11127550856 *5,RONDANA PARA TORNILLO CABEZA MOTOR BMW E60-E67 E90-E93 F20 F21 F30-F34 MINI (GENUINO) SSF,1369,5,8,5,18
11127551822 *1,KIT 114 PZ JUEGO JUNTAS MOTOR SUPERIOR MEDIDA STD BMW N62 N62N (FREY),1566,5,2,7,14
11127552280,JUNTA DE SERVOMOTOR DE VALVETRONIC BMW E90-N52N VICTOR REINZ,1302,0,2,7,9
11127552280 *1,JUNTA SERVOMOTOR SISTEMA VALVETRONIC BMW N52N (FREY),1903,9,4,7,20
11127552280 *K,KIT JUNTAS TAPA DE PUNTERIAS 2.5l BMW 125i 2011 Al 2012,1801,2,4,9,15
11127552280-2,JUNTA DE SERVOMOTOR DE VALVETRONIC BMW MOTOR N52N ELRING,1681,7,7,9,23
11127552281 *1,TAPA PUNTERIAS MOTOR CON JUNTA BMW N52N (FREY),1202,8,8,5,21
11127552281 *2,TAPA PUNTERIAS MOTOR BMW MOTOR N52N (EMBLER) GOG,1844,1,7,9,17
11127552281 *D,DIAFRAGMA VALVULA PCV BMW MOTOR N52N (EMBLER) GOG,1235,9,6,9,24
11127552281B,DIAFRAGMA VENTILACION MOTOR VALVULA PCV BMW N52N (FREY),1948,5,3,4,12
11127555212 *1,DIAFRAGMA VENTILACION MOTOR VALVULA PCV BMW N46 N46N (FREY),1970,6,1,8,15
11127555212 *2,DIAFRAGMA VENTILACION MOTOR VALVULA PCV BMW N46 N46N (EMBLER) HP,1322,2,6,4,12
11127555310 *1,JUNTA CABEZA MOTOR MEDIDA STANDAR 1.20 MM BMW N52 N53 (FREY),1313,2,3,3,8
11127555310B,KIT 73 PZ JUNTAS MOTOR B25 MEDIDA STANDAR 1.20 MM BMW N52 N52N 2.5 LITROS (FREY),1362,5,0,3,8
11127555757 *1,JUNTA CABEZA MOTOR MEDIDA STANDAR 1.16 MM BMW N52 N52N N53 (FREY),1628,5,8,0,13
11127557265 *1,JUNTA CABEZA MOTOR MEDIDA STANDAR 1.20 MM BMW N54 (FREY),1885,8,0,2,10
11127557265-1,JUNTA CABEZA MOTOR MEDIDA STANDAR 1.20 MM BMW N54 ELRING,1485,2,9,3,14
11127557265-100,JUNTA DE CABEZA DE MOTOR BMW E90-N54 BMTR INACTIVO,1783,9,4,2,15
11127559699,JUNTA DE SENSOR DE VALVETRONIC BMW E90-N52N ELRING,1588,6,4,4,14
11127559699 *1,JUNTA DE SENSOR DE VALVETRONIC BMW E90-N52N FREY,1825,8,2,2,12
11127560273 *5,JUNTA DE SERVOMOTOR DE VALVETRONIC MINI COOPER R5 (ELRING) SSF,1828,0,6,9,15
11127560274 *2,KIT 13 PZ. TORNILLOS CABEZA MOTOR BMW N13 MINI N12 N14 N16 N18 (ELRING) SSF,1512,1,2,9,12
11127560276 *1,JUNTA CABEZA MOTOR MEDIDA STANDAR 0.90 MM BMW N13 MINI N14 N18 (FREY),1903,7,9,3,19
11127560276 *5,JUNTA CABEZA MOTOR STANDAR 0.90 MM BMW N13 MINI N14 N18 (VICTOR REINZ) SSF,1489,5,0,9,14
11127560277 *2,JUNTA CABEZA MOTOR SOBRE MEDIDA 1.20 MM BMW N13 MINI N14 N18 (BGA),1644,8,1,9,18
11127560482,TAPON DE TAPA DE PUNTERIAS BMW E90-N52N ORIGINAL,1937,0,0,3,3
11127560482 *1,TAPON DE TAPA DE PUNTERIAS BMW E90-N52N FREY,1697,2,2,1,5
11127560482-1,TAPON DE TAPA DE PUNTERIAS BMW E90-N52N SEMINUEVO ORIGINAL,1662,5,9,5,19
11127561438,JUEGO DE JUNTAS DE MOTOR SUPERIOR BMW MOTOR N54 BI TURBO BMTRS,1986,1,5,0,6
11127563412 *1,JUNTA CABEZA MOTOR MEDIDA STANDAR 0.50 MM BMW N46N (FREY),1560,0,9,6,15
11127563412-2,JUNTA CABEZA MOTOR MEDIDA STANDAR 0.50 MM BMW N46N ELRING,1577,3,6,0,9
11127563474,TAPA DE PUNTERIAS DERECHA BMW E53-N62 SEMINUEVA ORIGINAL,1498,6,0,3,9
11127563474 *1,TAPA DE PUNTERIAS DERECHA BMW E53-N62 FREY,1296,4,6,7,17
11127563474 *2,TAPA DE PUNTERIAS DERECHA BMW E53-N62 (EMBLER),1495,2,8,6,16
11127565284 *1,TAPA PUNTERIAS BMW N54 BI TURBO (FREY),1657,3,9,0,12
11127565286,JUNTA DE TAPA DE PUNTERIAS BMW E90-N54 BI TURBO VICTOR REINZ,1917,4,4,6,14
11127565286 *1,JUNTA TAPA PUNTERIAS BMW MOTOR N54 BI TURBO (FREY),1545,5,0,5,10
11127565286-1,JUNTA DE TAPA DE PUNTERIAS BMW E90 - N54 BI TURBO  ( BMTR ),1452,9,6,2,17
11127565286-2,JUNTA DE TAPA DE PUNTERIAS BMW E90-N54 BI TURBO MEISTERSATZ,1211,4,0,9,13
11127565286-4,JUNTA DE TAPA DE PUNTERIAS BMW E90-N54 BI TURBO ELRING,1305,1,3,7,11
11127566288,JUNTA DE TAPA DE PUNTERIAS (R) BMW E70 S63-N63 ELRING,1229,0,7,1,8
11127566288 *1,JUNTA DE TAPA DE PUNTERIAS ( R ) BMW E70 S63-N63 FREY,1606,4,2,7,13
11127566289,JUNTA DE TAPA DE PUNTERIAS (L) BMW E70 S63-N63 ELRING,1965,9,0,9,18
11127566289 *1,JUNTA DE TAPA DE PUNTERIAS (L) BMW E70 S63-N63 FREY,1985,5,3,9,17
11127567765 *1,JUNTA CABEZA MOTOR MEDIDA STANDAR 0.75 MM BMW N63 S63 (FREY),1349,8,6,4,18
11127567765 *5,JUNTA CABEZA MOTOR MEDIDA STANDAR 0.75 MM BMW N63 S63 (VICTOR REINZ) SSF,1394,6,4,4,14
11127567877,JUNTA DE TAPA DE PUNTERIAS MINI R56-N12 VICTOR REINZ,1404,4,4,1,9
11127567877 *1,JUNTA TAPA PUNTERIAS MOTOR MINI N12 N16 (FREY),1362,3,8,8,19
11127567877-1,JUNTA DE TAPA DE PUNTERIAS MINI R56-N12 ( CORTECO ),1939,8,5,0,13
11127567877-2,JUNTA DE TAPA DE PUNTERIAS MINI R56-N12 TOPRAN,1468,1,7,0,8
11127568582 *1,TAPA PUNTERIAS MOTOR BMW N46 1a GEN (FREY),1829,9,7,9,25
11127568582-1,VALVULA PCV BMW E87 - N46N  BMTR,1792,1,1,6,8
11127568582-100,TAPA DE PUNTERIAS BMW MOTOR N46N BMTR INACTIVO,1858,2,8,6,16
11127568582-7,VALVULA PCV BMW E87 - N46N KZR,1824,0,2,8,10
11127570219 *1,TUBO PROTECTOR CALOR BOBINA IGNICION BMW N62 N62N (FREY),1555,0,7,8,15
11127570292,DIAFRAGMA DE VALVULA PCV BMW MOTOR N55 ( BMTRS ),1996,8,3,0,11
11127570292 *1,TAPA PUNTERIAS MOTOR BMW MOTOR N55 TURBO (FREY),1644,4,3,8,15
11127570292*D,DIAFRAGMA VALVULA PCV MOTOR BMW N55 TURBO (EMBLER),1625,4,3,2,9
11127570292-100,TAPA DE PUNTERIAS BMW MOTOR N55 ( KZR GERMANY ) INACTIVO,1805,6,2,7,15
11127570292B,DIAFRAGMA VALVULA PCV MOTOR BMW N55 TURBO (FREY),1556,8,9,7,24
11127571963,JUEGO JUNTAS DE MOTOR BMW E90-N52N BMTR,1424,7,2,0,9
11127571963 *1,JUEGO JUNTAS DE MOTOR SUPERIOR BMW E90 N52N-B30 FREY,1453,9,8,6,23
11127572758,JUEGO JUNTAS DE MOTOR SUPERIOR BMW MOTOR N54 BI TURBO BMTR,1546,7,1,8,16
11127572758 *1,JUEGO JUNTAS DE MOTOR BMW E92-N54 BI TURBO FREY,1613,5,0,2,7
11127572851,JUNTA DE TAPA DE PUNTERIAS MINI R56-N14 ELRING,1206,6,2,0,8
11127572851-1,JUNTA DE TAPA DE PUNTERIAS MINI R56-N14 PAYEN,1795,7,1,3,11
11127572851-2,JUNTA DE TAPA DE PUNTERIAS MINI R56-N14 TOPRAN,1819,9,9,1,19
11127574303,JUEGO DE TORNILLOS DE CABEZA BMW E90-N54 VICTOR REINZ,1264,6,0,6,12
11127574303 *1,JUEGO DE TORNILLOS DE CABEZA BMW E90-N54 FREY,1617,9,3,2,14
11127575422 *1,TUBO PROTECTOR CALOR BOBINA IGNICION BMW N52 N52N N54 (FREY),1385,3,8,1,12
11127577118-100,TUBO PROTECTOR CALOR BOBINA IGNICION BMW INACTIVO,1866,4,1,4,9
11127578077,KIT DE TORNILLOS DE CABEZA DE MOTOR 1 PZ. BMW MOTOR N46- N46N BGA,1866,3,9,6,18
11127578077 *1,KIT DE TORNILLOS DE CABEZA DE MOTOR 1 PZ. BMW E87 N46- N46N FREY,1948,4,0,5,9
11127578077 *2,KIT TORNILLOS CABEZA MOTOR BMW E60 E61 E81-E87 E90-E93 N43 N45 N45N N46 N46N (EMBLER) GOG,1763,5,3,0,8
11127578093,JUNTA CABEZA MOTOR SOBRE MEDIDA 0.80 MM BMW N46 N46N BGA,1594,9,6,2,17
11127578093 *1,JUNTA CABEZA MOTOR SOBRE MEDIDA 0.80 MM BMW N46 N46N (FREY),1424,2,1,6,9
11127581215 *1,JUNTA PLANA TAPA PUNTERIAS MOTOR BMW N52 (FREY),1610,4,8,1,13
11127581215 *5,JUNTA TAPA PUNTERIAS BMW E90 N52 (VICTOR REINZ),1620,5,0,2,7
11127581215-103,JUNTA TAPA PUNTERIAS MOTOR 1a GEN BMW E90 N52 (FREY) INACTIVO,1471,7,9,4,20
11127582245 *1,JUNTA TAPA PUNTERIAS MOTOR BMW N52N (FREY),1894,3,8,5,16
11127582245 *5,JUNTA TAPA PUNTERIAS MOTOR BMW N52N (VICTOR REINZ) SSF,1996,5,6,4,15
11127582245-2,JUNTA DE TAPA DE PUNTERIAS BMW MOTOR N52N ( ELRING ),1569,1,6,5,12
1112758240-100,JUNTA DE TAPA DE PUNTERIAS MINI BMW N13 TWIN TURBO INACTIVO,1859,8,1,3,12
11127582400 *1,JUNTA TAPA PUNTERIAS MOTOR BMW N13 TWIN MINI TURBO N18 TURBO (FREY),1788,0,6,8,14
11127583113,KIT DE TORNILLOS DE CABEZA DE MOTOR 10 PZ. BMW E53-N62 VICTOR REINZ,1562,2,9,7,18
11127583113 *1,KIT DE TORNILLOS DE CABEZA DE MOTOR 10 PZ. BMW E53-N62 FREY,1464,9,3,7,19
11127583203 *1,KIT 147 PZ JUEGO JUNTAS MOTOR COMPLETO MEDIDA STD BMW N63 (FREY),1832,5,9,1,15
11127583585 *1,TUBO PROTECTOR CALOR BOBINA IGNICION BMW N13 MINI N16 N18 (FREY),1314,2,3,7,12
11127584128 *1,MANGUERA VENTILACION GASES MOTOR PCV CON SENSOR BMW N55 (FREY),1597,3,1,6,10
11127586908 *3,JUNTA CABEZA MOTOR SOBRE MEDIDA 1.20 MM BMW N13 MINI N14 N18 (EMBLER),1346,2,7,2,11
11127586908-1,JUNTA CABEZA MOTOR SOBRE MEDIDA 1.20 MM BMW N13 MINI N14 N18 (ELRING),1420,2,3,3,8
11127587804,JUNTA DE TAPA DE PUNTERIAS BMW E70-N55 BMTR,1644,8,1,6,15
11127587804 *1,JUNTA TAPA DE PUNTERIAS BMW MOTOR N55 TWIN TURBO (FREY),1240,3,6,7,16
11127587804-1,JUNTA DE TAPA DE PUNTERIAS BMW E70-N55 VICTOR REINZ,1779,7,9,7,23
11127587804-3,JUNTA DE TAPA DE PUNTERIAS BMW E70-N55 CORTECO,1936,8,5,9,22
11127588412 *1,TAPA PUNTERIAS MOTOR BMW N20 TWIN TURBO (FREY),1740,5,3,2,10
11127588412*D,DIAFRAGMA VALVULA PCV MOTOR BMW N20 TWIN TURBO (EMBLER),1268,3,1,8,12
11127588412*T,TAPA PUNTERIAS MOTOR BMW N20 TWIN TURBO (EMBLER),1857,9,1,1,11
11127588412C,DIAFRAGMA VALVULA PCV MOTOR BMW N20 TWIN TURBO (FREY),1515,1,0,9,10
11127588417 *1,MANGUERA VENTILACION GASES MOTOR PCV CON SENSOR BMW N20 N26 (FREY),1921,8,6,3,17
11127588418,JUNTA DE TAPA DE PUNTERIAS BMW F30-N20 BMTR,1839,9,3,5,17
11127588418 *1,JUNTA TAPA PUNTERIAS MOTOR BMW N20 N26 (FREY),1479,3,6,1,10
11127588418-1,JUNTA DE TAPA DE PUNTERIAS BMW F30-N20 ELRING,1771,2,2,4,8
11127588418-3,JUNTA DE TAPA DE PUNTERIAS BMW F30-N20 BAMPIC,1544,3,1,1,5
11127589830 *1,JUNTA TAPA BUJIAS MOTOR BMW N20 N26 N55 (FREY),1609,1,0,6,7
11127595138,JUNTA CABEZA MOTOR MEDIDA STANDAR 90 MM BMW N13 MINI N14 N18 (HIGH QUALITY AUTOPARTS),1637,1,0,8,9
11127595139,JUNTA CABEZA MOTOR MEDIDA STANDAR 0.90 MM MINI N12 N16 ELRING,1902,3,0,9,12
11127595139 *1,JUNTA CABEZA MOTOR MEDIDA STANDAR 0.90 MM MINI N12 N16 (FREY),1434,7,5,3,15
11127595139-1,JUNTA CABEZA MOTOR MEDIDA STANDAR 0.90 MM MINI N12 N16 VICTOR REINZ,1250,4,7,9,20
11127598091 *1,MANGUERA VENTILACION GASES MOTOR PCV CON SENSOR BMW N20 (FREY),1379,4,4,3,11
11127599212 *1,JUNTA CABEZA MOTOR MEDIDA STANDAR 1.20 MM BMW N55 (FREY),1524,5,7,5,17
11127599212-2,JUNTA CABEZA MOTOR MEDIDA STANDAR 1.20 MM BMW N55 (BGA),1481,2,5,3,10
11127620697 *1,JUNTA CABEZA MOTOR MEDIDA STANDAR 0.70 MM BMW N20 (FREY),1426,8,1,3,12
11127620697 *5,JUNTA CABEZA MOTOR MEDIDA STANDAR 0.70 MM BMW N20 (ELRING) SSF,1657,2,1,2,5
11127620697B,KIT 50 PZ JUEGO JUNTAS MOTOR SUPERIOR MEDIDA STD BMW E84 E89 F07 F10 F11 F15 F16 F20-F26 F30-F36 (FREY),1537,4,3,2,9
11127620698 *5,JUNTA CABEZA MOTOR SOBRE MEDIDA 1.00 MM BMW N20 (ELRING) SSF,1968,5,1,6,12
11127646552 *1,TAPA PUNTERIAS MOTOR MINI R55 A R61 N18 (FREY),1974,2,7,4,13
11127646552 *2,TAPA PUNTERIAS MOTOR MINI N18 (EMBLER) GOG,1514,2,0,8,10
11127646552 *D,VALVULA PCV DIAFRAGMA VENTILACION POSITIVA CARTER MOTOR MINI R55 A R61 N18 (EMBLER) GOG,1213,7,8,5,20
11127646552B,VALVULA PCV DIAFRAGMA VENTILACION POSITIVA CARTER MOTOR MINI R55 A R61 N18 (FREY),1791,0,1,0,1
11127646553 *1,TAPA PUNTERIAS MOTOR BMW N13 TWIN TURBO (FREY),1999,3,9,1,13
11127646554 *1,TAPA PUNTERIAS MOTOR MINI N12 N16 (FREY),1460,9,4,9,22
11127646554B,DIAFRAGMA TAPA PUNTERIAS VALVULA PCV MINI N12 N16 (FREY),1853,2,6,2,10
11127646555 *1,TAPA PUNTERIAS MOTOR MINI N14 (FREY),1453,8,6,5,19
11127646555-100,TAPA DE PUNTERIAS MINI COOPER MOTOR N14 INACTIVO,1513,5,4,8,17
11127838271,JUNTA DE TAPA DE PUNTERIAS R BMW E90-S65 AJUSA,1791,5,8,4,17
11127838271 *1,JUNTA DE TAPA DE PUNTERIAS R BMW E90-S65 FREY,1264,1,4,7,12
11127838272,JUNTA DE TAPA DE PUNTERIAS L BMW E90-S65 AJUSA,1491,9,6,3,18
11127838272 *1,JUNTA DE TAPA DE PUNTERIAS L BMW E90-S65 FREY,1778,3,2,2,7
11128605598 *1,TAPA PUNTERIAS MOTOR BMW F49 F52 G38 (FREY),1937,7,4,1,12
11128618515 *1,JUNTA TAPA PUNTERIA MOTOR BMW B32 B36 B38 (FREY),1912,0,9,9,18
11128618519 *1 ,JUNTA TAPA PUNTERIAS MOTOR BMW B46 B48 MINI B46 B48 (FREY),1519,6,1,1,8
11128618520 *1,JUNTA EMPAQUE BOMBA GASOLINA MECANICA BMW B38 B42 B46 B48 MINI B36 B38 B46 B48 (FREY),1995,4,3,9,16
11128627107B,KIT 54 PZ JUEGO JUNTAS MOTOR SUPERIOR MEDIDA STD BMW MINI B42 B46 B48 (FREY),1290,5,7,7,19
11128630683 *1,JUNTA CABEZA MOTOR MEDIDA STANDAR 0.70 MM BMW MINI B38 (FREY),1995,2,5,2,9
11128638247 *5,JUNTA TAPA PUNTERIAS MOTOR MINI B46 B48 BMW B46 B48 (VICTOR REINZ) SSF,1518,9,7,2,18
11128645888 *1,TAPA PUNTERIAS MOTOR VENTILACION PCV BMW N46 1a GEN (FREY),1307,8,9,1,18
11128645888 *2,TAPA PUNTERIAS MOTOR VENTILACION PCV BMW N46 1a GEN (EMBLER) GOG,1242,6,5,7,18
11128654075B,KIT SUPERIOR JUNTAS MOTOR BMW B38 1.5 L 3 CIL (FREY),1817,5,6,4,15
11128654272 *1,JUNTA CABEZA MOTOR MEDIDA STANDAR 0.70 MM BMW MINI B48 (FREY),1758,3,6,8,17
11128655331 *1,TAPON ACEITE TAPA PUNTERIAS MOTOR BMW B38 B46 B48 B58 N20 N55 N63N (FREY),1968,1,4,8,13
11128655331-100,TAPON DE DEPOSITO DE ACEITE E90 BEMQW INACTIVO,1768,1,9,8,18
11129069055-1,JUEGO DE JUNTAS DE MOTOR SUPERIOR ( R ) BMW MOTOR M62 8CIL 4.6L BMTSR,1214,4,1,5,10
11129070532 *1,JUNTA TAPA PUNTERIAS MOTOR BMW E34 M50 E36 M50 M52 (FREY),1637,3,7,0,10
11129070532 *6,JUNTA DE TAPA DE PUNTERIAS BMW E36-M52 (VICTOR REINZ) SSF,1853,2,9,9,20
11129071589 *1,JUNTA TAPA PUNTERIAS MOTOR (R) BMW E38 E39 E52 E53 M62 (FREY),1956,5,6,9,20
11129071590 *1,JUNTA DE TAPA DE PUNTERIAS ( L ) BMW MOTOR M62 8 CIL 4.6L FREY,1784,7,1,9,17
11131437237 *1,JUNTA CARTER ACEITE MOTOR BMW M50 M52 M54 (FREY),1262,3,5,0,8
11131437237 *3,JUNTA CARTER MOTOR BMW M50 M52 M54 (CORTECO),1235,9,4,7,20
11131487221,JUNTA DE CARTER DE MOTOR MINI R53-W11 ELRING,1288,9,6,0,15
11131487221-1,JUNTA DE CARTER DE MOTOR MINI R53-W11 EMBLER,1594,4,5,5,14
11131709235 *1,CARTER DEPOSITO ACEITE MOTOR BMW E39 E60 E65 M52 M54 (FREY),1997,8,3,3,14
11131709235 *2,CARTER DEPOSITO ACEITE MOTOR BMW E39 E60 E65 M52 M54 (ORIGINAL BMW),1254,3,5,9,17
11131739813,JUNTA DE CARTER DE MOTOR BMW E36 ( CORTECO ),1481,2,3,3,8
11131739813-1,JUNTA DE CARTER DE MOTOR BMW E36 ( ELRING ),1661,2,2,9,13
11131740000 *5,TORNILLO CARTER MOTOR BMW  E36 E38 E39 E53 E60 E61 E65 E66 E85 (GENUINO) SSF,1807,3,9,8,20
11131742994,TAPON PURGADOR DE ACEITE DE MOTOR BMW E87-N46 BMTR,1859,9,9,8,26
11131742994 *1,TAPON PURGADOR DE ACEITE DE MOTOR BMW E87-N46 FREY,1448,8,3,1,12
11131742994 -6,TAPON PURGADOR DE ACEITE DE MOTOR BMW E87-N46 ( FEBI ),1406,5,0,4,9
11137511224,JUNTA DE CARTER DE MOTOR BMW E87-N46 BMTR,1575,6,3,0,9
11137511224 *1,JUNTA DE CARTER DE MOTOR BMW E87-N46 FREY,1378,5,4,0,9
11137511224-2,JUNTA DE CARTER DE MOTOR BMW E87-N46 BGA,1202,2,0,2,4
11137511602,CARTER DE MOTOR BMW M54 E46 E83  SEMINUEVO (ORIGINAL),1850,2,9,9,20
11137535106,TAPON DRENADO ACEITE MOTOR BMW,1850,7,0,4,11
11137535106 *3,TAPON DRENADO ACEITE MOTOR BMW E30 E36 E46 E90-E93 F30 F31 F34 F80 G11-G16 G20 (TOPRAN),1591,6,5,6,17
11137545293,JUNTA DE CARTER DE MOTOR BMW E70-N62N VICTOR REINZ,1363,1,0,3,4
11137545293 *1,JUNTA ACEITE CARTER MOTOR BMW N62 N62N (FREY),1919,3,0,0,3
11137545293-1,JUNTA DE CARTER DE MOTOR BMW E70-N62N ELRING,1749,5,1,2,8
11137548031,JUNTA DE CARTER DE MOTOR BMW E90 N52-N54 BMTR,1966,1,1,5,7
11137548031 *1,JUNTA CARTER ACEITE MOTOR BMW N52 N54 (FREY),1279,6,5,6,17
11137548031-1,JUNTA DE CARTER DE MOTOR BMW MOTOR N52-N54 REINZ,1425,2,0,8,10
11137552414 *1,CARTER ALUMINIO ACEITE MOTOR BMW N52 N52N (FREY),1852,7,2,2,11
11137561427,JUNTA DE SEMICARTER BMW E70 VICTOR REINZ,1891,0,0,8,8
11137561427 *1,JUNTA DE SEMICARTER BMW E70 FREY,1751,7,4,4,15
11137566644,JUNTA DE CARTER DE ACEITE BMW E70 ELRING,1900,9,2,9,20
11137566808 *5,JUNTA INFERIOR CARTER MOTOR BMW N63 N63N (ELRING) SSF,1266,8,7,4,19
11137568566 *1,CARTER ACEITE MOTOR BMW N46N (FREY),1978,7,8,2,17
11137600482 *1,JUNTA CARTER ACEITE MOTOR BMW N55 TWIN TURBO (FREY),1775,7,5,0,12
11137600482-101,JUNTA DE CARTER DE MOTOR BMW E90-N55 BMTR INACTIVO,1903,6,2,9,17
11137605018 *1,TAPON CARTER DRENADO ACEITE DE MOTOR BMW N20 N26 (FREY),1568,0,4,0,4
11137605018-2,TAPON DE CARTER DE ACEITE DE MOTOR BMW F10 (BGA),1454,4,9,0,13
11137605018B,TAPON ALIMENTACION ACEITE TAPA PUNTERIAS BMW E84 E89 F07 F10 F11 F20-F23 F25 F30-F36 (FREY),1620,6,5,2,13
11137612512-2,CARTER DE MOTOR BMW N20 (BMTSR),1383,7,3,3,13
11137618512 *1,CARTER PLASTICO ACEITE MOTOR BMW N20 N26 TWIN TURBO (FREY),1552,5,5,0,10
11137618512 *5,CARTER PLASTICO ACEITE MOTOR BMW N20 N26 TWIN TURBO (GENUINO),1511,7,8,9,24
11137618512B,CARTER ALUMINIO ACEITE MOTOR BMW N20 N26 TWIN TURBO (FREY),1970,7,7,9,23
11137627511 *1,JUNTA PLANA ALUMINIO CARTER MOTOR BMW N20 (VICTOR REINZ),1636,3,2,9,14
11137627511-2,JUNTA PLANA ALUMINIO CARTER MOTOR BMW N20 (ELRING),1714,9,2,6,17
11137627512,JUNTA LIGA CARTER PLASTICO MOTOR BMW N20 ELRING,1591,2,2,3,7
11137627512 *1,JUNTA LIGA CARTER PLASTICO MOTOR BMW N20 (FREY),1588,1,0,2,3
11137627512 *5,JUNTA DE CARTER DE MOTOR BMW F30-N20 (VICTOR REINZ) SSF,1786,0,5,4,9
11141274346 *1,RETEN DELANTERO CIGUEï¿½AL MOTOR 48X65X10 MM BMW M41 M50 M52 M54 S50 S54 (FREY),1801,3,3,8,14
11141432240 *1,JUNTA DE TAPA DE RETEN CIGUEï¿½AL LADO TRASERO BMW E46-M54 FREY,1397,8,6,1,15
11141432240 *5,JUNTA TAPA RETEN TRASERO CIGUEï¿½AL MOTOR BMW E46 M54 (VICTOR REINZ) SSF,1208,4,8,9,21
11141432240-100,JUNTA DE TAPA DE RETEN CIGUEï¿½AL LADO TRASERO BMW E46-M54 BMTR INACTIVO,1214,5,0,6,11
11141432240-3,JUNTA DE TAPA DE RETEN CIGUEï¿½AL LADO TRASERO BMW E46-M54 ELRING,1359,4,4,8,16
11141433639,JUNTA METALICA DE TAPA DE DISTRIBUCION (RECTA) BMW E46-M54 BMTR,1866,4,0,4,8
11141433639 *1,JUNTA METALICA DE TAPA DE DISTRIBUCION (RECTA) BMW E46-M54 FREY,1370,3,7,1,11
11141433639 *3,JUNTA METALICA DE TAPA DE DISTRIBUCION (RECTA) BMW E46-M54 (VICTOR REINZ),1228,3,7,9,19
11141439570,RETEN DELANTERO BMW E36 M44 VICTOR REINZ,1271,1,9,6,16
11141439717 *1,KIT JUNTAS TAPA DISTRIBUCION INFERIOR BMW N62 N62N (FREY),1778,4,0,5,9
11141707260,JUNTA METALICA DE TAPA DE DISTRIBUCION (CIRCULAR) BMW E46 VICTOR REINZ,1545,2,0,2,4
11141707260 *1,JUNTA METALICA TAPA DE DISTRIBUCION (CIRCULAR) BMW M52 M54 (FREY),1768,6,1,9,16
11141713730 *1,RETEN TRASERO CIGï¿½Eï¿½AL 100X125X13 MM BMW E31 E32 E34 E39 E52 E53 M62 (FREY),1585,3,3,3,9
11141739868 *5,JUNTA TAPA CADENA DISTRIBUCION MOTOR BMW M43 M44 (VICTOR REINZ) SSF,1649,8,9,2,19
11142245364 *1,RETEN TRASERO CIGUEï¿½AL MOTOR 90X110X12 BMW M52 M54 (FREY),1818,2,5,9,16
11142245364 *9,RETEN TRASERO CIGUEï¿½AL MOTOR 90X110X12 BMW M50 M52 M54 (ELRING),1551,5,1,5,11
11142245364-100,RETEN DE CIGUEï¿½AL TRASERO 90 X 110 X 12 BMW M52 M54 FREY INACTIVO,1611,2,4,7,13
11142249532 *5,RETEN DELANTERO CIGUEï¿½AL MOTOR 48X65X10 MM BMW M41 M50 M52 M54 S50 S54 (VICTOR REINZ) SSF,1623,9,6,6,21
11142249532 *6,RETEN DELANTERO CIGUEï¿½AL MOTOR 48X65X10 MM BMW M41 M50 M52 M54 S50 S54 (ELRING) SSF,1728,5,5,4,14
11142249532-100,RETEN DE CIGUEï¿½AL DELANTERO BMW E46 BGA 48 X 65 X 10 inactivo,1942,1,5,8,14
11142249533 *5,RETEN TRASERO CIGUEï¿½AL MOTOR 90X110X12 BMW M52 M54 (CORTECO) SSF,1883,5,9,2,16
11147507278 *1,TAPA VENTILACION CARTER PCV CON JUNTA BMW N62 N62N (FREY),1374,1,8,6,15
11147512100 *1,"RETEN DELANTERO CIGUEï¿½AL 45X75X8/11,9 BMW N62N N62 (FREY)",1632,9,7,5,21
11147512100 *2,"RETEN DELANTERO CIGUEï¿½AL 45X75X8/11,9 BMW N62N N62 (ELRING)",1251,3,4,9,16
11147512101,RETEN DE CIGï¿½Eï¿½AL TRASERO BMW E53 / N62 ( ELRING ),1902,6,6,0,12
11147512101 *1,RETEN TRASERO CIGUEï¿½AL BMW N62 N62N (FREY),1355,4,1,1,6
11147583221,RETEN DE CIGUEï¿½AL TRASERO CON BRIDA BMW N63 N63N ( ELRING ),1448,9,7,5,21
11147647381,RETEN DE CIGUEï¿½AL DELANTERO BMW E53 / N62 ( CORTECO ),1328,9,9,0,18
11147647381 *1,RETEN DE CIGUEï¿½AL DELANTERO BMW E53 / N62 FREY,1797,0,0,1,1
11147647381-2,RETEN DE CIGUEï¿½AL DELANTERO BMW E53 / N62 ( ELRING ),1745,6,8,6,20
11148602594 *1,RETEN TRASERO CIGUEï¿½AL MOTOR 90X104X9 MM  BMW MINI B36 B38 B46 B48 B58  (FREY),1483,3,4,3,10
111500000000,AMORTIGUADOR DE SUSPENSION DELANTERO R MAZDA SACHS 313415,1279,4,4,6,14
11151703484,KIT DE MANGUERAS Y VALVULA PCV BMW M50 M52 ( EMBLER ),1650,0,6,1,7
11151703484 *1,SEPARADOR DE ACEITE PCV BMW MOTOR M50 M52 ( FREY ),1698,5,2,4,11
11151703484-2,SEPARADOR DE ACEITE PCV BMW MOTOR M50 M52 (EMBLER),1653,6,7,9,22
11151703775 *1,TUBO VENTILACION DE CARTER PCV BMW M52 (FREY),1426,9,8,0,17
11151703775-1,TUBO VENTILACION DE CARTER PCV BMW M52 (EMBLER),1739,5,9,9,23
11157501567,SEPARADOR DE ACEITE PCV BMW M42 M44 (EMBLER),1498,6,0,3,9
11157501567 *1,DIAFRACMA VALVULA PCV BMW M42 M44 4 CILINDROS (FREY),1235,5,5,7,17
11157501567-8,DIAFRAGMA DE VALVULA PCV BMW M42 M44 (EMBLER),1487,5,6,3,14
11157522931 *1,MANGUERA VENTILACION CARTER PCV CON SENSOR 300 MM BMW E60 E90 N52 (FREY),1999,9,0,0,9
11157522931 *2,MANGUERA VENTILACION CARTER PCV CON SENSOR 300 MM BMW E60 E90 N52 (EMBLER),1646,5,7,0,12
11157522931 *22,MANGUERA VENTILACION PCV GRUESA CON SENSOR BMW N52 (EMBLER),1238,3,9,6,18
11157522931 *3,KIT 4 PZ CON 3 MANGUERAS VENTILACION 1 RECUPERARDOR ACEITE MOTOR BMW N52 (EMBLER) GOG,1494,6,4,0,10
11157532628,MANGUERA FLEXIBLE PARA VALVULA PCV BMW E53-M54 REIN,1827,8,6,3,17
11157532628 *1,MANGUERA FLEXIBLE PARA VALVULA PCV BMW E53-M54 FREY,1307,0,8,6,14
11157532628 *2,MANGUERA VENTILACION SISTEMA PCV VALVULA PCV BMW M54 (EMBLER) GOG,1930,0,0,2,2
11157532628-1,MANGUERA FLEXIBLE PARA VALVULA PCV BMW E53-M54 FEBI,1796,2,1,4,7
11157532628-4,MANGUERA FLEXIBLE PCV BMW E53 M52 M54 ( KZR GERMANY ),1556,3,8,4,15
11157532649,MANGUERA FLEXIBLE PCV BMW E46 M52 M54 ( KZR GERMANY ),1970,4,3,0,7
11157532649 *1,MANGUERA VENTILACION MOTOR SISTEMA PCV BMW M54 (FREY),1589,1,0,9,10
11157532649-1,MANGUERA DE SISTEMA PCV BMW E46 FEBI,1725,2,9,3,14
11157532649-2,MANGUERA DE SISTEMA PCV BMW E46 URO,1908,4,2,7,13
11157553949,MANGUERA DE VENTILACION DE CARTER BMW E90 GENUINA,1796,5,2,6,13
11157553949 *1,MANGUERA DE VENTILACION DE CARTER BMW E90 (FREY),1437,0,1,3,4
11157559528 *1,TUBO FLEXIBLE DE VENTILACION BMW E90-N52N FREY,1788,3,9,9,21
11157559528 *5,"MANGUERA FORMA ""T "" TUBO VENTILACION MOTOR PCV BMW N52N (REIN) SSF",1565,5,0,7,12
11157559528-1,TUBO FLEXIBLE DE VENTILACION BMW E90-N52N  GENUINO,1505,3,1,1,5
11157559528-2,TUBO FLEXIBLE DE VENTILACION BMW E90-N52N BMTR,1237,9,8,8,25
11157559528-4,TUBO FLEXIBLE DE VENTILACION BMW E90-N52N TOPRAN,1821,3,6,6,15
11157559528-6,TUBO FLEXIBLE DE VENTILACION BMW E90-N52N OSSCA,1731,4,5,5,14
11157567801,MANGUERA DE VENTILACION CARTER MOTOR BMW MOTOR N52 EMBLER,1933,3,5,1,9
11157567801 *1,MANGUERA VENTILACION PCV DELGADA CON SENSOR BMW N52 (FREY),1432,4,1,3,8
11157567801-1,MANGUERA DE VENTILACION CARTER MOTOR BMW MOTOR N52 JL GERMANY,1497,2,7,1,10
11157575640 *1,MANGUERA VENTILACION GASES MOTOR PCV INFERIOR (R) BMW N63 (FREY),1515,7,2,9,18
11157605186 *1,MANGUERA VENTILACION DE CARTER PCV MINI R55 R56 R57 R58 R59 (FREY),1283,5,6,0,11
11157608144,MANGUERA DE VENTILACION PCV BMW F20 N13 TOPRAN,1631,9,9,1,19
11157608144 *1,MANGUERA VENTILACION CARTER SISTEMA PCV BMW N13 (FREY),1400,2,5,3,10
11157614690 *1,TUBO FLEXIBLE VENTILACION PCV DELGADO BMW N13 (FREY),1615,0,9,7,16
11157646086 *1 ,MANGUERA VENTILACION GASES MOTOR PCV SUPERIOR (R) BMW N63 (FREY),1327,8,1,1,10
11157646087 *1,MANGUERA VENTILACION GASES MOTOR PCV SUPERIOR (L) BMW N63 (FREY),1534,4,9,9,22
11158608766 *1,MANGUERA VENTILACION GASES MOTOR PCV INFERIOR (R) BMW F20 F23 F30 F32 B38 (FREY),1496,8,3,4,15
11158647962 *1,MANGUERA VENTILACION DE CARTER PCV BMW F15 F16 (FREY),1597,7,7,6,20
1117534-100,ENFRIADOR ACEITE TRANSMISION AUTOMATICA BMW INACTIVO,1337,4,1,7,12
1118605100,FILTRO ENTRADA AIRE MOTOR BORA 5CIL 2.5L MANN C43102,1248,8,1,1,10
1119970330 *1,TAPON CARTER MOTOR 13MM SPRINTER VITO OM651 (FREY),1455,8,3,8,19
1120160221,JUNTA DE TAPA DE PUNTERIAS ( L ) MERCEDES MOTOR M112 6 CILINDROS BGA,1542,7,4,6,17
1120160221 *1,JUNTA DE TAPA DE PUNTERIAS ( L ) MERCEDES MOTOR M112 6 CILINDROS FREY,1240,7,5,5,17
1120160320,JUNTA CABEZA MOTOR (L) MEDIDA STANDAR 0.65 MM MERCEDES M112 BMTR,1668,1,2,2,5
1120160320 *1,JUNTA CABEZA MOTOR (L) MEDIDA STANDAR 0.65 MM MERCEDES M112 (FREY),1215,0,6,8,14
1120160320-2,JUNTA CABEZA MOTOR (L) MEDIDA STANDAR 0.65 MM MERCEDES M112 MHALE,1948,0,1,1,2
1120160321,JUNTA DE TAPA DE PUNTERIAS ( R ) MERCEDES MOTOR M112 6 CILINDROS BGA,1585,8,3,3,14
1120160321 *1,JUNTA DE TAPA DE PUNTERIAS ( R ) MERCEDES MOTOR M112 6 CILINDROS ( FREY ),1451,7,3,1,11
1120160420,JUNTA CABEZA MOTOR (R) MEDIDA STANDAR 0.65 MM MERCEDES M112  BMTR,1819,4,2,3,9
1120160420 *1,JUNTA CABEZA MOTOR (R) MEDIDA STANDAR 0.65 MM MERCEDES M112 (FREY),1455,2,0,4,6
1120160420-2,JUNTA CABEZA MOTOR (R) MEDIDA STANDAR 0.65 MM MERCEDES M112 BGA,1888,2,4,6,12
1120160920 *1,JUNTA DE CABEZA DE MOTOR (L) MERCEDES M112 3.5 L  (FREY),1416,4,7,8,19
1120161020 *1,JUNTA CABEZA MOTOR (R) MEDIDA STANDAR 0.65 MM MERCEDES M122 (FREY),1250,9,8,6,23
1120180682,MANGUERA DE VENTILACION DE CARTER MERCEDES MOTOR M112 6CIL VAICO,1730,6,6,2,14
1120180682  *1,MANGUERA DE VENTILACION DE CARTER MERCEDES MOTOR M112 6CIL FREY,1959,9,7,6,22
1120350800,POLEA CIGUEï¿½AL MERCEDES BENZ M113 CORTECO,1645,0,7,3,10
1120940048,SENSOR DE MASA DE AIRE MAF MERCEDES W202 / M112 ( BMTRS ),1903,0,3,1,4
1120940048 *1,SENSOR DE MASA DE AIRE MAF MERCEDES W202 / M112 FREY,1683,4,0,1,5
1120940048-1,SENSOR DE MASA DE AIRE MAF MERCEDES W202 / M112 ( BOSCH ),1657,9,7,4,20
11210390923,"METALES DE CENTRO SOBRE MEDIDA 10"""" BMW E87 N46-N46N KOLBENSCHMIDT",1975,1,1,3,5
11211706847 *1,KIT 14 PZ METALES BANCADA CENTRO MOTOR 60.00MM ESTANDAR BMW M52 M54 2.2 2.5 2.8 3.0 (FREY),1885,9,1,3,13
11211706847 *5,KIT 14 PZ METALES BANCADA CENTRO MOTOR MEDIDA ESTANDAR BMW BMW M52 M54 (GLYCO) SSF,1591,4,4,5,13
11211706847-1,METALES DE CENTRO ESTANDAR BMW MOTOR M44-M50-M25-M54 KOLBENSCHMIDT,1520,4,8,1,13
11211706848,METALES DE CENTRO ESTANDAR BMW MOTOR M43-M44 4CIL KOLBENSCHMIDT 87368600,1304,0,0,3,3
1121411080-100,JUNTA DE MULTIPLE DE ADMISION MERCEDES INACTIVO,1980,3,1,9,13
1121412080,JUNTA DE MULTIPLE DE ADMISION MERCEDES W163 - M112 VICTOR REINZ,1593,1,3,3,7
1121412080-2,JUNTA DE MULTIPLE DE ADMISION MERCEDES W163 - M112 MAHLE,1259,4,4,2,10
1121420180,KIT DE 6 JUNTAS DE ESCAPE DE MOTOR MERCEDES W163-M112 MAHLE,1785,6,6,1,13
1121420180 *1,JUNTA ESCAPE MOTOR MERCEDES M112 (FREY),1988,0,1,8,9
1121500118 *1,CABLE BUJIA IGNICION MOTOR 300 MM MERCEDES M112 M113 (FREY TEGNOLOGIA ALEMANA),1584,9,3,0,12
11217585452 *1,METALES BIELA ESTADAR 45MM BMW F20 F21 F30 F31 MINI R55-R61 (FREY),1786,4,5,4,13
11217598959 *1 ,KIT 10 METALES DE BANCADA MOTOR N20 BMW F30 F35 F20 (FREY),1432,2,3,5,10
11217616164,TORNILLO POLEA DE CIGUEï¿½AL MINI R56,1487,7,7,7,21
11217627033,METALES DE CENTRO EN ESTANDAR BMW E90 N52 / N54  ( KING INGLESES ),1246,3,3,6,12
11217627033-1,METALES DE CENTRO ESTANDAR BMW MOTOR N52N N54 N55 ( KOLBESCHMIDT 77947600 ),1505,4,0,4,8
11217627037 *1,KIT 10 PZ METALES CENTRO BANCADA MEDIDA ESTANDAR 56.00 MM BMW N46 N46N N52 N52N N54 N55 (FREY),1843,7,9,2,18
11217635660 *3,KIT 8 PZ METALES BIELA MEDIDA ESTANDAR 45.00 MM BMW F39 F45 F46 F48 MINI F54-F56 F57 F60 (TRUCKTEC),1645,7,3,5,15
1121800311,ENFRIADOR ACEITE MOTOR MERCEDES MOTOR M112 (OSSCA),1882,4,2,7,13
1121800311-2,ENFRIADOR DE ACEITE DE MOTOR MERCEDES MOTOR M272 OSSCA,1512,8,6,6,20
1121800710 *1,TAPA CARCASA FILTRO ACEITE MOTOR MERCEDES M112 M113 (FREY),1584,7,8,4,19
1121840061 *1,KIT 4 PZ JUNTAS ENFRIADOR FILTRO ACEITE MOTOR MERCEDES M112 M113 (FREY),1874,7,7,9,23
1121840061 *5,1 PZ JUNTA ENFRIADOR FILTRO ACEITE MOTOR MERCEDES M112 M113 (ELRING) SSF,1947,0,8,4,12
1121840261,KIT DE JUNTAS FILTRO ACEITE MOTOR MERCEDES M112 M113 ( ELRING ),1516,8,9,3,20
1121840361,JUNTAS ENFRIADOR FILTRO ACEITE MOTOR MERCEDES M112 M113 (ELRING),1211,2,7,0,9
112184_,#K,1269,4,2,1,7
11218642946,METALES DE CENTRO EN ESTANDAR  BMW F30-N20 KOLBENSHMIT,1539,0,6,7,13
1121880301-100,ENFRIADOR DE ACEITE DE MOTOR MERCEDES MOTOR INACTIVO,1392,8,6,6,20
1121880401 *1,ENFRIADOR ACEITE MOTOR MERCEDES M112 M113 (FREY),1523,4,6,6,16
1121880401-2,ENFRIADOR DE ACEITE DE MOTOR MERCEDES MOTOR M112 BMTR,1945,6,5,5,16
1122000070C,POLEA TENSORA BANDA ACCESORIOS MERCEDES M112 M113 (FREY),1268,2,7,5,14
1122000122,FAN CLUTH DE 3 TORNILLOS MERCEDES W202-W210 BEHR,1479,7,6,6,19
1122000122 *1,FAN CLUTCH ENFRIAMIENTO MOTOR DE 3 TORNILLOS MERCEDES M112 W202 W210 (FREY),1820,9,2,6,17
1122000222,FAN CLUTCH DE 3 TORNILLOS MERCEDES W163 BEHR,1223,4,1,2,7
1122000222 *1,FAN CLUTCH DE 3 TORNILLOS MERCEDES W163 FREY,1716,3,2,8,13
1122000870 *1,TENSOR BANDA ACCESORIOS MERCEDES M112 M113 (FREY),1461,4,9,7,20
1122000970 *9,POLEA TENSORA BANDA ACCESORIOS MERCEDES M112 (BMTSR),1967,6,4,2,12
1122001401 *1,BOMBA AGUA MECANICA ENFRIAMIENTO MOTOR MERCEDES W163-M112 3.2L V6 (FREY),1999,1,3,7,11
1122001401-3,BOMBA AGUA MECANICA ENFRIAMIENTO MOTOR MERCEDES W163-M112 3.2L V6 (BRUMMER),1250,9,4,4,17
1122001501,BOMBA AGUA MECANICA ENFRIAMIENTO MOTOR MERCEDES W210 M112 (BMTR),1793,5,0,6,11
1122001501 *1,BOMBA AGUA MECANICA ENFRIAMIENTO MOTOR MERCEDES W210 M112 (FREY),1292,0,1,1,2
1122030275,TERMOSTATO DE MOTOR MERCEDES W203 / M112 ( VERNET TH651387 ),1387,0,3,7,10
1122030275 *1,TERMOSTATO DE MOTOR MERCEDES W203-M112 FREY,1439,3,7,0,10
1122030275-1,TERMOSTATO DE MOTOR MERCEDES W203 / M112 ( WAHLER ),1707,6,9,9,24
1122030275-3,TERMOSTATO DE MOTOR MERCEDES W203-M112 TOPRAN,1377,2,2,7,11
11221717383,VOLANTE MOTRIZ BMW E46 (CREMALLERA DE MOTOR),1290,9,6,6,21
11227557239,VOLANTE MOTRIZ MINI COOPER R56 (CREMALLERA DE MOTOR),1644,4,9,6,19
11231438995,POLEA DE CIGUEï¿½AL DAMPER BMW M52 M54 ( ORIGINAL ),1666,3,3,8,14
11231438995 *1,POLEA DE CIGUEï¿½AL DAMPER BMW E46-M54 FREY,1466,8,6,0,14
11231485399,POLEA DE CIGUEï¿½AL DAMPER MINI R50-W210  (FEBI ),1953,0,0,1,1
1123210027,FILTRO ENTRADA AIRE MOTOR AUDI A6 TFSI KOLBENSCHMIDT 50014508,1768,0,3,1,4
1123210032,FILTRO ENTRADA AIRE MOTOR VOLKSWAGEN UP 1.0 MANN C29015,1738,7,0,8,15
11237519629,POLEA DE CIGUEï¿½AL DAMPER BMW N52 N52N ( ORIGINAL ),1981,1,5,3,9
11237519629 *1,POLEA DE CIGUEï¿½AL DAMPER BMW E90-N52 FREY,1837,8,1,6,15
11237525135 *1,POLEA CIGUEï¿½AL DAMPER MINI MOTOR SUPERCARGADO W11 (FREY),1945,6,4,3,13
11237548003 *1,POLEA DE CIGUEï¿½AL BMW N46N FREY,1477,5,8,1,14
11237573655 *1,POLEA CIGUEï¿½AL DAMPER BMW N55 TWIN TURBO (FREY),1601,4,1,4,9
11237576675 *1,POLEA DE CIGUEï¿½AL DAMPER BMW E90-E82 FREY,1298,7,1,9,17
11237576675 *5,POLEA DE CIGUEï¿½AL DAMPER BMW E90-E82 CORTECO (SSF),1810,9,4,2,15
11237622909,POLEA DE CIGUEï¿½AL DAMPER MINI R56-N14 FEBI,1263,8,9,3,20
11237624103 *1,POLEA CIGUEï¿½AL DAMPER BMW N20 N26 TWIN TURBO (FREY),1547,3,1,8,12
11237638551 *1,POLEA CIGUEï¿½AL DAMPER BMW N13 MINI N12 N14 N16 N18 (FREY),1672,3,0,4,7
11237638551-2,POLEA DE CIGUEï¿½AL DAMPER MINI R56 - N12 CORTECO,1235,2,0,8,10
11237829906 *1,POLEA CIGï¿½Eï¿½AL DAMPER R50 R52 W10 (FREY),1510,5,5,1,11
11237829906 *3,POLEA CIGUEï¿½AL DAMPER MINI R50 W10 (CORTECO),1493,5,4,4,13
11237829906-4,POLEA DE CIGUEï¿½AL DAMPER MINI R50-W210 FEBI,1866,8,0,0,8
11238638446 *1,POLEA CIGUEï¿½AL DAMPER BMW B48 TWIN TURBO (FREY),1636,7,6,7,20
11238638614 *1,POLEA CIGUEï¿½AL DAMPER MINI B32 B36 B38  (FREY),1394,1,9,5,15
11241284850 *5,KIT 12 PZ. METALES BIELA MOTOR 45.00MM STANDAR BMW M52 M54 2.2 .2.5 2.8 3.0 (GLYCO) SSF,1424,9,5,3,17
11241284851 *5,KIT 12 PZ. METALES BIELA MOTOR MEDIDA + 0.25 EN 10 BMW M52 M54 (KOLBENSCHMIDT) SSF,1728,7,2,0,9
11241284851 *6,KIT 12 PZ. METALES BIELA MOTOR MEDIDA + 0.25 EN 10 BMW M52 M54 (GLYCO) SSF,1403,5,8,3,16
11247536774-1,KIT DE METALES DE BIELA EN STD X 4 BIELAS BMW MOTOR N46N-N46 4CIL (EMBLER),1836,0,4,7,11
11247536777,"METALES DE BIELA SOBRE MEDIDA 10"""" BMW E87 N46-N46N KOLBENSCHMIDT 77944610",1308,1,7,0,8
11247586035 *1,METALES DE BIELA ESTADAR 45MM BMW F20 F21 F30 F31 MINI R55-R61 (FREY),1890,9,2,8,19
11247628034 *1,KIT 8 PZ METALES BIELA MEDIDA ESTANDAR 50.00 MM BMW N20 N26 N52 N52N N54 N55 (FREY),1984,9,0,1,10
11247628035 *5,KIT 12 PZ METALES BIELA MEDIDA ESTANDAR 50.00 MM BMW N20 N26 N52 N52N N54 N55 (KOLBENSCHMIDT),1915,2,1,3,6
11247628035-2,METALES BIELA ESTANDAR PARA 8 BIELAS BMW N20 (KOLBENSCHMIDT),1433,7,3,6,16
11247648438,METALES DE BIELA EN ESTANDAR BMW MOTOR B38 3CIL KOLBENSCHMIDT,1525,0,7,6,13
11251247917,ANILLOS DE MOTOR STD X 1 PISTON BMW E36 - M44 GOETZE,1579,7,0,0,7
11251247917-2,ANILLOS DE MOTOR STD X 1 PISTON BMW E36 - M44 HASTING,1685,4,8,2,14
11251437078,ANILLOS DE MOTOR STD 84 MM PARA 1 PISTONES BMW MOTOR M52 KOLBENSCHMIDT 800070210000,1998,1,0,6,7
11251437078-1,ANILLOS DE MOTOR STD 84 MM PARA 1 PISTONES BMW MOTOR M52 MAHLE,1704,4,6,8,18
11251437078-2,ANILLOS DE MOTOR STD 84 MM PARA 1 PISTONES BMW MOTOR M52 HASTING,1318,4,8,4,16
11252754870 *5,FILTRO COMBUSTIBLE GASOLINA MINI R55 R56 R57 R58 R59 N12 N14 N16 N18 (FEBI) SSF,1356,6,0,6,12
11257504919-5,ANILLOS DE MOTOR STD 80 MM X 6 PISTONES BMW E46-M54 2.2L HASTING,1389,5,0,8,13
11257506252,ANILLOS DE MOTOR STD 84MM X6 PISTONES BMW MOTOR M54 HASTING,1418,1,4,6,11
11257506252 *1,KIT 3 PZ. ANILLOS MOTOR PARA 1 PISTON MEDIDA ESTANDAR 84 MM M54 2.5 L 3.0 L (EMBLER) KSM,1346,2,8,8,18
11257506252-100,ANILLOS DE MOTOR STD 84MM X6 PISTONES BMW MOTOR M54 INACTIVO,1408,5,7,9,21
11257508555 *3,KIT 3 ANILLOS PARA UN PISTON CILINDROS MOTOR MINI R50 W10 (KOLBENSCHMIDT) ML,1458,8,0,2,10
11257511697 *5,KIT 3 PZ. ANILLOS MOTOR PARA 1 PISTON MEDIDA ESTANDAR 84 MM M54 2.5 L 3.0 L (MAHLE) SSF,1793,7,3,2,12
11257511697 *6,KIT 3 PZ. ANILLOS MOTOR PARA 1 PISTON MEDIDA ESTANDAR 84 MM M54 2.5 L 3.0 L (KOLBENSCHMIDT),1285,1,9,1,11
11257516838 *1,KIT 3 PZ. ANILLOS PARA UN PISTON MOTOR MEDIDA STANDAR 80 MM BMW 320i M54 2.0L (EMBLER) KSM,1501,3,8,2,13
11257516838 *3,KIT 3 PZ. ANILLOS PARA UN PISTON MOTOR MEDIDA STANDAR 80 MM BMW 320i M54 2.0L (MAHLE),1649,4,6,7,17
11257520133-3,ANILLOS DE MOTOR STD X 4 PISTONES MINI R53 - W11 SUPER CARGADO POWERSEAL,1412,7,9,3,19
11257547838,ANILLOS MOTOR BMW E60 MAHLE,1561,6,2,0,8
11257556435,ANILLOS DE MOTOR STD 84 MM X 1 PISTON BMW MOTOR N46-N46N MAHLE,1723,5,7,7,19
11257556435-1,ANILLOS DE MOTOR STD 84 MM X 4 PISTONES BMW MOTOR N46-N46N EMBLER,1550,6,2,8,16
11257556435-2,ANILLOS DE MOTOR STD 84 MM X 1 PISTON BMW MOTOR N46-N46N KOLBENSCHMIDT,1273,6,6,7,19
11257556435-3,ANILLOS DE MOTOR STD 84 MM X 4 PISTONES BMW MOTOR N46-N46N HASTINGS,1296,4,2,3,9
11257556435-4,ANILLOS DE MOTOR STD 84 MM X 4 PISTON BMW MOTOR N46-N46N KOLBENSCHMIDT,1402,6,5,2,13
11257559434 *2,ANILLOS DE MOTOR STD 85 MM X 1 PISTON BMW N51 N52 N52N N53 (BORSEHUNG),1742,9,5,9,23
11257561848 *8,KIT 3 PZ. ANILLOS MOTOR STD 82 MM X 1 PISTON BMW MOTOR N52 N52N (KOLBENSCHMIDT) ML,1938,3,6,0,9
11257561848-2,ANILLOS DE MOTOR STD 82 MM X 6 PISTONES BMW MOTOR N52-N52N GOETZE,1690,7,4,0,11
11257561848-3,ANILLOS DE MOTOR STD 82 MM X 6 PISTONES BMW MOTOR N52-N52N HASTING,1969,0,5,4,9
11257566479 *2,ANILLOS MOTOR 77 MM STD PARA 1 PISTON MINI MOTOR N14 N18 (EMBLER),1414,6,8,1,15
11257566479 *3,ANILLOS MOTOR 77 MM STD PARA 1 PISTON MINI MOTOR N14 N18 (MAHLE),1554,9,2,7,18
11257577581,KIT 3 PZ. ANILLOS DE MOTOR STD 84 MM X 1  PISTONES BMW E90 - N54  NPR EUROPE,1921,2,6,5,13
11257577581-1,ANILLOS DE MOTOR STD 84 MM X 6 PISTONES BMW E90 - N54  NPR DORMAN ALEMAN,1337,0,3,2,5
11257577581-2,ANILLOS DE MOTOR STD 84 MM X 6 PISTONES BMW E90 - N54  NPR HASTING,1946,2,3,3,8
11257577586,SET DE 6 ANILLOS DE MOTOR BMW E90 / N54 ( HASTINGS ),1977,1,3,1,5
11257594453,ANILLOS DE MOTOR STD 84 MM X 4 PISTONES BMW N20 GOETZE 0843460000,1759,0,9,1,10
11257594453-1,ANILLOS DE MOTOR STD 84 MM X 4 PISTONES BMW N20 HASTING,1749,8,5,3,16
11257610297 *3,ANILLOS PISTON BMW E82 F22 E90 F32 E60 F06 F01 E84 F25 F26 E70 E71 E89 (KOLBENSCHMIDT),1401,9,8,3,20
11257610297C,ANILLOS DE MOTOR STD 84 MM PARA 1 PISTON BMW E70 F15 F16 (FREY),1932,8,4,6,18
11258606461,PISTON SEMINUEVO BMW F30 / N20 ( GENUINO ),1777,9,4,1,14
11258606461 *1,PISTON  BMW F30 / N20 FREY,1291,9,2,4,15
11258637991C,ANILLOS DE MOTOR STD 52 MM BMW B58 (FREY),1895,0,7,2,9
11259071606 *5,KIT 3 PZ. ANILLOS PARA UN PISTON MOTOR MEDIDA STANDAR BMW M62 8 CIL 4.4L (MAHLE) SSF,1586,9,7,9,25
11259071606-2,ANILLOS DE MOTOR STD X 1 PISTON BMW MOTOR M62 8CIL 4.4L GOETZE,1292,5,4,9,18
11259071606-3,ANILLOS DE MOTOR STD X 1 PISTON BMW MOTOR M62 8CIL 4.4L HASTING,1260,6,6,9,21
1125A47A37 *4,TABLERO DE PARACHOQUES TRASERO BMW G08 (EMBLER) YIW,1427,4,7,9,20
11277500502,CADENA DE LA BOMBA DE ACEITE BMW E87-N46 GENUINA,1799,5,0,4,9
11277500502 *1,CADENA BOMBA ACEITE MOTOR BMW N12 N14 N16 N18 N46 N46N (FREY),1575,4,8,7,19
11277594471 *1,BOMBA ACEITE MOTOR SIN BALANCEADORES BMW N46 N46N (FREY),1780,2,4,0,6
11277594471 *3,BOMBA ACEITE MOTOR SIN BALANCEADORES BMW N46 N46N (KOLBENSCHMIDT),1792,1,3,5,9
11277594471 *5,BOMBA ACEITE MOTOR BMW E46 E85 E60 E81 E90 E91 E92 E93 E82 E88 E84 E87 (PIERBURG),1339,1,9,1,11
11281432104 *1,TENSOR MECANICO BANDA ACCESORIOS BMW M43 M44 (FREY),1561,4,6,9,19
11281433571-9,TENSOR DE BANDA DE AIRE ACONDICIONADO BMW E46-M54 BMT,1361,9,1,6,16
11281435594,POLEA DE REENVIO BMW E36 BMTR,1598,6,4,9,19
11281435594 *1,POLEA TENSOR BANDA ACCESORIOS MOTOR 70X66X26 MM BMW M43 M50 M52 M54 (FREY),1234,3,3,1,7
11281437369 *1,BANDA ACCESORIOS MOTOR MEDIDA 6PK 1733 MM BMW E36 M43 M44 (FREY),1553,9,7,0,16
11281437450,BANDA DE AIRE ACONDICIONADO BMW MOTOR M54-M52 BMTR 5PK865,1904,3,3,3,9
11281437450-1,BANDA DE AIRE ACONDICIONADO BMW MOTOR M54-M52 OPTIBELT 5PK865,1610,5,5,9,19
11281437450-2,BANDA DE AIRE ACONDICIONADO BMW MOTOR M54-M52 CONTINENTAL 5PK865,1945,7,6,8,21
11281437450-3,BANDA DE AIRE ACONDICIONADO 5PK865 BMW MOTOR M52-M54,1221,2,6,0,8
11281437873,BANDA ACCESORIOS MOTOR MEDIDA 5PK 906 MM BMW E36 M43 M50 M52 BMTR,1883,3,9,8,20
11281437873 *1,BANDA ACCESORIOS MOTOR MEDIDA 5PK 906 MM BMW E36 M43 M50 M52 (FREY),1678,3,8,1,12
11281437929 *1,BANDA DE BOMBA DE AGUA BMW E36 Z3 M52 FREY 6PK1555,1355,3,8,2,13
11281440237 *5,POLEA LISA REENVIO BANDA ACCESORIOS 26X70 MM BMW E53 E60 E63 E65 N62N (INA) SSF,1961,3,8,4,15
11281440378,POLEA DE REENVIO BMW E87-N46 (INA),1325,1,6,9,16
11281440378 *1,POLEA DE REENVIO BMW E87-N46 FREY,1399,7,6,4,17
11281709613,TENSOR DE BANDA DE ACCESORIOS BMW E53-M62 INA,1201,2,1,9,12
11281709613 *1,TENSOR DE BANDA DE ACCESORIOS BMW E53-M62 FREY,1819,5,3,1,9
11281731220,POLEA DE REENVIO,1607,4,9,8,21
11281743193,BANDA DE AIRE ACONDICIONADO BMW E36-M44 BMTR 4PK890,1893,3,7,9,19
11281743193 *1,BANDA DE AIRE ACONDICIONADO BMW E36-M44 FREY 4PK890,1403,8,2,0,10
11281743193-2,BANDA DE AIRE ACONDICIONADO BMW E36-M44 HUTCHINSON 4PK890,1815,3,5,5,13
11281743193-3,BANDA DE AIRE ACONDICIONADO BMW E36-M44 CONTINENTAL 4PK890,1431,2,5,3,10
11281748130 *1,POLEA LOCA BANDA ACCESORIOS MOTOR BMW MOTOR M43 M50 M52 M4 (FREY),1564,6,5,9,20
11281748130 *5,POLEA LOCA BANDA ACCESORIOS MOTOR BMW MOTOR M43 M50 M52 M54 (CONTINENTAL) SSF,1222,5,5,8,18
11281748131 *1,POLEA HUECA TENSOR HIDRAULICO 70X26X10 BMW M43 M44 M50 M52 M54 (FREY),1550,8,6,5,19
11281748131-100,POLEA DE TENSOR HIDRAULICO BMW MOTOR M43-M44-M50-M52-M54 INACTIVO,1458,5,2,8,15
11281748832 *1,TENSOR MECANICO CON POLEA BANDA ACCESORIOS MOTOR BMW M50 M52 M54 (FREY),1547,2,3,4,9
11287500560,POLEA ALTERNADOR BMW E53 FEBI,1421,5,4,0,9
1128750476,TENZOR DE BANDA DE MINI COOPER,1239,2,1,6,9
11287505566 *1,TENSOR DE BANDA DE ALTERNADOR BMW E53-N62 ( FREY ),1698,2,7,2,11
11287509476 *9,TENSOR DE BANDA DE ACCESORIOS MINI COOPER R53 / W11 TURBO INA,1454,6,3,9,18
11287509508 *1,POLEA REENVIO BANDA ACCESORIOS 69 MM RAYADA BMW Z4 E85 2.5 3.0 (FREY),1506,0,1,6,7
11287512758 *1,TENSOR DE BANDA DE AIRE ACONDICIONADO BMW E46 M54 (FREY),1465,1,4,2,7
11287512758-100,TENSOR DE BANDA DE AIRE ACONDICIONADO BMW E46-M54 INACTIVO,1537,5,6,3,14
11287512758-9,TENSOR DE BANDA DE AIRE ACONDICIONADO BMW E46-M54 BMTR,1867,0,5,5,10
11287512762 *1,BANDA ACCESORIOS MOTOR MEDIDA 4PK 863 MM BMW E39 E46 E53 E83 E85 M54 (FREY),1494,4,5,2,11
11287512762-2,BANDA ACCESORIOS MOTOR MEDIDA 4PK 863 MM BMW E39 E46 E53 E83 E85 M54 CONTITECH,1611,8,1,7,16
11287512971,BANDA ACCESORIOS MOTOR MEDIDA 4PK X 824 MM BMW E60 E63 E65 N62 N62N ( CONTITECH ),1895,4,3,2,9
11287515280 *1,POLEA DE REENVIO BMW N62 FREY,1699,9,6,3,18
11287515865 *1,TENSOR DE BANDA DE ACCESORIOS X5 E53 FREY,1595,2,2,2,6
11287515867,TENSOR DE BANDA DE ACCESORIOS X5 FREY,1442,5,7,7,19
11287516847,POLEA DE REENVIO BMW E60 E65 E83 M54 ( OPTIMAL ),1218,5,0,7,12
11287516847 *1,POLEA DE REENVIO BMW E60 E65 E83 M54 ( FREY ),1357,2,6,3,11
11287516897,TENSOR DE BANDA PRINCIPAL E81 E87 VAICO,1547,0,7,0,7
11287520199 *5,BANDA ACCESORIOS MOTOR MEDIDA 6PK 1388 MM MINI R50 W11 (CONTINENTAL) SSF,1516,4,9,6,19
11287524267,TENSOR DE BANDA DE ACCESORIOS BMW E87 / N46 / N46N ( BMTR ),1389,1,1,9,11
11287524267 *1,TENSOR BANDA ACCESORIOS MOTOR BMW E87 N46 N46N (FREY),1789,6,4,2,12
11287524267 *5,TENSOR BANDA ACCESORIOS MOTOR BMW E87 N46 N46N (HUTCHINSON),1661,7,3,5,15
11287524267-2,TENSOR DE BANDA DE ACCESORIOS BMW E87-N46-N46N INA,1399,0,3,9,12
11287524267B,KIT 3 PZ TENSOR BANDA ACCESORIOS MOTOR BMW E87 N46 N46N (FREY),1487,1,8,0,9
11287530314 *1,TENSOR BANDA ACCESORIOS MOTOR BMW N52 N52N (FREY),1721,1,1,5,7
11287534398 *2,TENSOR BANDA ACCESORIOS MINI N12 N14 N16 N18 (EMBLER) GOG,1485,0,8,4,12
11287535860,POLEA DE REENVIO BMW E90-N52 BMTR,1333,4,2,1,7
11287535860 *1,POLEA DE REENVIO BMW E90-N52 FREY,1481,8,2,4,14
11287535860-1,POLEA DE REENVIO BMW MOTOR N52-N52N INA,1519,6,5,6,17
11287535860-2,POLEA DE REENVIO BMW E90-N52 URO,1936,6,0,7,13
11287539831 *1,BANDA DE BOMBA DE AGUA BMW E53-N62 FREY 6PK1548,1571,4,6,8,18
11287540949 *1,BANDA ACCESORIOS MOTOR 7PK 1666 BMW E70 N62N (FREY),1281,2,4,7,13
11287542887 *1,POLEA LISA REENVIO BANDA ACCESORIOS MOTOR 90 MM BMW E70 N52N (FREY),1946,1,5,2,8
11287545296,TENSOR DE BANDA DE ALTERNADOR CON POLEA BMW E70 / N62N ( GENUINO ),1540,8,5,2,15
11287545296 *1,TENSOR BANDA ACCESORIOS BMW E70 N62N (FREY),1949,9,6,9,24
11287545297 *1,POLEA BANDA ACCESORIOS MOTOR 65X30 MM BMW E70 N6N (FREY),1224,3,8,2,13
11287549557 *1,POLEA LISA REENVIO BANDA ACCESORIOS 26X70 MM BMW E53 E60 E63 E65 N62N (FREY),1704,8,3,8,19
11287549588,TENSOR DE BANDA DE ALTERNADOR BMW E53 - N62 INA,1655,8,9,0,17
11287549588 *1,TENSOR DE BANDA DE ALTERNADOR BMW E53-N62 FREY,1478,8,3,4,15
11287549589,TENSOR DE BANDA DE ALTERNADOR BMW E53-N62 INA,1472,1,8,5,14
11287549873 *1,TENSOR DE CORREO MECANICO N53N FREY,1754,7,3,1,11
11287552084,BANDA DE AIRE ACONDICIONADO BMW MOTOR N62N CONTINENTAL 4PK819,1202,6,2,3,11
11287552084 *1,BANDA DE AIRE ACONDICIONADO BMW MOTOR N62N FREY 4PK819,1651,0,1,8,9
11287552236 *1,BANDA ACCESORIOS BOMBA AGUA 6PK1635 BMW N46 N46N (FREY),1953,9,0,4,13
11287556251,POLEA REENVIO DE BANDA DE ALTERNADOR BMW E90-N54 INA,1944,4,7,6,17
11287556251 *1,POLEA REENVIO DE BANDA DE ALTERNADOR BMW E90-N54 ( FREY ),1504,9,2,0,11
11287556251-1,POLEA REENVIO DE BANDA DE ALTERNADOR BMW E90-N54 URO,1741,2,1,2,5
11287556251-3,KIT DE POLEAS REENVIO DE BANDA DE ALTERNADOR BMW E90-N54 INA,1906,7,5,7,19
11287557257 *1,BANDA ACCESORIOS MOTOR MEDIDA 7PK 1370 MM BMW E70 N52N (FREY),1848,4,9,1,14
11287557257 *5,BANDA ACCESORIOS MOTOR MEDIDA 7PK 1370 MM BMW E70 N52N (CONTINENTAL) SSF,1412,9,9,2,20
11287557851,POLEA REENVIO DE BANDA DE ALTERNADOR BMW E90-N54 (INA),1805,7,0,0,7
11287557851 *1,POLEA REENVIO DE BANDA DE ALTERNADOR BMW E90-N54 FREY,1541,9,2,9,20
11287559887,POLEA DE REENVIO BMW E71-N54 VAICO,1898,6,6,8,20
11287559887 *1,POLEA REENVIO LISA BANDA ACCESORIOS 4.3X65 MM BMW F01 E71 N54 (FREY),1743,6,9,9,24
11287559889,POLEA DE REENVIO BMW E71-N54  (VAICO ),1381,8,9,8,25
11287559889 *1,POLEA DE REENVIO BMW E71-N54  (FREY ),1384,0,5,2,7
11287563927 *1,TENSOR DOBLE BANDA ACCESORIOS 70X30 MM MOTOR BMW N54 N55 (FREY),1870,5,9,2,16
11287563927 *5,TENSOR DOBLE BANDA ACCESORIOS 70X30 MM MOTOR BMW N54 N55 (INA) SSF,1440,3,2,5,10
11287563927 *6,TENSOR DOBLE BANDA ACCESORIOS 70X30 MM MOTOR BMW N54 N55 (URO) SSF,1772,1,8,5,14
11287565225 *1,TENSOR DOBLE BANDA ACCESORIOS MOTOR BMW E70 N54 (FREY),1380,5,0,1,6
11287565225 *5 ,TENSOR DOBLE BANDA ACCESORIOS MOTOR BMW E70 N54 (URO),1369,2,6,4,12
11287566789 *5 ,BANDA ACCESORIOS MOTOR MEDIDA 6PK 906 MM MINI R56 N14 N18 (CONTINENTAL) SSF,1375,2,4,1,7
11287571015 *5,TENSOR BANDA ACCESORIOS MOTOR MINI N12 N14 N16 N18 (DAYCO) SSF,1217,8,6,3,17
11287578674,POLEA DE REENVIO BMW E90-N55 INA,1690,2,3,4,9
11287578674 *1,POLEA RE ENVIO BANDA ACCESORIOS 30 X 75 MM BMW E84 E88 E90 N55 (FREY),1702,8,6,8,22
11287578675 *1,POLEA REENVIO BANDA ACCESORIOS 30X90 MM BMW E81 E82 E84 E90 E92 N55 (FREY),1330,5,1,0,6
11287582761,TENSOR DE BANDA DE ACCESORIOS BMW F25 N52 ( INA ),1455,1,6,5,12
11287582761 *1,TENSOR BANDA ACCESORIOS MOTOR BMW F10 F01 F25 N52N (FREY),1332,6,0,7,13
11287589361 *1,POLEA REENVIO BANDA ACCESORIOS MOTOR 32X65 MM BMW N55 TURBO (FREY),1228,1,5,7,13
11287589366 *5,BANDA ACCESORIOS MOTOR MEDIDA 8PK1390 MM BMW F01 F07 F15 F16 F20 F22 F25 F30 F32 N55 (CONTINENTAL) SSF,1235,2,9,1,12
11287589366-101,BANDA DE ALTERNADOR BMW F10-N55 FREY INACTIVO,1291,7,8,9,24
11287594969,TENSOR DE BANDA DE ACCESORIOS BMW F25-N20 INA,1451,3,8,9,20
11287594969 *1,TENSOR DE BANDA DE ACCESORIOS BMW F25-N20 FREY,1542,3,2,4,9
11287598832 *2,TENSOR DINAMICO CON SENSOR BOMBA AGUA MINI N12 N13 N16 N18 (EMBLER) GOG,1937,9,9,0,18
11287598832 *3,TENSOR DINAMICO CON SENSOR BOMBA AGUA MINI N12 N13 N16 N18 (DAYCO ),1998,1,3,8,12
11287598833 *2,TENSOR DINAMICO SIN SENSOR BOMBA AGUA MINI N12 N14  N16 N18 (EMBLER) GOG,1775,7,2,3,12
11287598833 *3,TENSOR DINAMICO SIN SENSOR BOMBA AGUA MINI N14 ( GENUINO ),1776,1,2,9,12
11287598833 *5,TENSOR DINAMICO SIN SENSOR BOMBA AGUA MINI N12 N14  N16 N18 (URO) SSF,1518,7,2,2,11
11287603347,TENSOR DE BANDA DE ALTERNADOR BMW F21 / N13 ( OPTIMAL ),1554,1,0,0,1
11287603347 *1,TENSOR DE BANDA DE ALTERNADOR BMW F21 / N13 FREY,1374,2,4,2,8
11287603348,BANDA DE ALTERNADOR F21-N13 CONTINENTAL 6PK0990,1945,1,4,0,5
11287603348 *1,BANDA ACCESORIOS ALTERNADOR VOLTAJE 6PK986 BMW F20 F21 F30 F31 N13 (FREY),1905,6,2,0,8
11287603348 *2,BANDA DE ALTERNADOR F21-N13 (DAYCO),1273,5,4,2,11
11287603348-1,BANDA DE ALTERNADOR F21-N13 DAYCO 6PK986,1429,4,1,0,5
11287603348-3,BANDA DE ALTERNADOR F21-N13 CONTITECH,1204,7,3,2,12
11287603348-4,BANDA DE ALTERNADOR F21-N13 HUTCHINSON  6PK985,1350,4,7,4,15
11287604014 *1,BANDA ACCESORIOS MOTOR MEDIDA 6PK 906 MM MINI R56 N14 N18 (FREY),1252,1,7,7,15
11287604014-100,BANDA DE ACCESORIOS MINI  R60-N18 DAYCO 6PK894 INACTIVO,1292,0,6,0,6
11287615130 *1,POLEA REENVIO BANDA ACCESORIOS 75X32 MM BMW F01 F06 F10 F15 E70 E71 F16 N55 (FREY),1811,4,5,0,9
11287615130-1,POLEA DE REENVIO BMW E70 / N55 ( INA ),1844,1,7,8,16
11287615130-100,POLEA DE REENVIO BMW E70-N55 BMTR INACTIVO,1206,6,9,2,17
11287618848 *1,BANDA ACCESORIOS MOTOR MEDIDA 6PK 1003 MM BMW E84 E89 F07 F15 F20 F22 F25 F26 F30 F32 N20 (FREY),1954,4,8,0,12
11287618848 *5,BANDA ACCESORIOS MOTOR MEDIDA 6PK 1003 MM BMW E84 E89 F07 F15 F20 F22 F25 F26 F30 F32 N20 (CONTINENTAL) SSF,1374,2,9,2,13
11287618848-100,BANDA DE ALTERNADOR 6PK1003 BMW F35 MOTOR N20 INACTIVO,1863,3,1,5,9
11287627052 *1,TENSOR MECANICO BANDA ACCESORIOS BMW F01 F02 E71 N54 (FREY),1263,0,0,8,8
11287627053 *1,POLEA REENVIO RAYADA BANDA ACCESORIOS MOTOR 79 MM BMW F01 E71 N54 (FREY),1969,6,9,1,16
11287628279,BANDA ACCESORIOS MOTOR MEDIDA 8DPK 1833 MM BMW F01 E71 N54 BMTRS,1923,7,3,9,19
11287628279 *1,BANDA ACCESORIOS MOTOR MEDIDA 8DPK 1833 MM BMW F01 E71 N54 (FREY),1459,3,0,4,7
11287628279-3,BANDA ACCESORIOS MOTOR MEDIDA 8DPK 1833 MM BMW F01 E71 N54 TRUCKTEC,1232,6,1,5,12
11287628650 *1,BANDA ACCESORIOS MOTOR MEDIDA 6PK 1990 MM BMW E60 E70 E81 E83 E90 N52 N52N E53 (FREY),1808,7,6,4,17
11287628650 *5,BANDA ACCESORIOS MOTOR MEDIDA 6PK 1990 MM BMW E60 E70 E81 E83 E90 N52 N52N E53 (CONTINENTAL) SSF,1258,2,4,9,15
11287628650-1,BANDA ACCESORIOS MOTOR MEDIDA 6PK 1990 MM BMW E60 E70 E81 E83 E90 N52 N52N E53 BMTRS,1372,4,0,3,7
11287628651,BANDA DE ALTERNADOR BMW MOTOR N52N-N52 CONTITECH 6PK1827,1538,4,7,9,20
11287628651 *1,BANDA DE ALTERNADOR BMW MOTOR N52N-N52 FREY 6PK1827,1469,4,3,4,11
11287628651 *3,BANDA DE ALTERNADOR BMW MOTOR N52N-N52 (DAYCO),1725,6,4,5,15
11287628652 *1,BANDA ACCESORIOS MOTOR MEDIDA 7PK 1855 MM BMW E81 E90 N54 (FREY),1373,8,5,4,17
11287628652 *5,BANDA ACCESORIOS MOTOR MEDIDA 7PK 1855 MM BMW E81 E90 N54 CONTINENTAL,1333,4,6,1,11
11287628652-1,BANDA ACCESORIOS MOTOR MEDIDA 7PK 1855 MM BMW E81 E90 N54 DAYCO,1641,3,7,4,14
11287628653 *1,BANDA ACCESORIOS MOTOR MEDIDA 7PK 1860 MM BMW E60 E81 E90 N54 N55 (FREY),1284,7,9,2,18
11287628653 *5,BANDA ACCESORIOS MOTOR MEDIDA 7PK 1860 MM BMW E60 E81 E90 N54 N55 (CONTINENTAL) SSF,1569,7,1,7,15
11287628658 *1,BANDA ACCESORIOS MOTOR MEDIDA 8PK 1786 MM BMW F07 F25 N53 N52N (FREY),1406,0,0,8,8
11287628658 *5 ,BANDA ACCESORIOS MOTOR MEDIDA 8PK 1786 MM BMW F07 F25 N53 N52N (CONTINENTAL) SSF,1673,9,7,5,21
11287628658-100,BANDA DE ACCESORIOS 8PK1786 BMW F10 N52N BMTSR INACTIVO,1518,9,3,6,18
11287628658-101,BANDA DE ACCESORIOS BMW F10 N52N FREY 8PK1786 INACTIVO,1643,7,6,0,13
11287628659,BANDA ACCESORIOS MOTOR MEDIDA 8PK 1478 MM BMW E70 E71 F01 F07 F16 N55 (BMTR),1438,8,0,6,14
11287628659 *1,BANDA ACCESORIOS MOTOR MEDIDA 8PK 1478 MM BMW E70 E71 F01 F07 F16 N55 (FREY),1534,3,5,4,12
11287628661 *1,BANDA ACCESORIOS MOTOR MEDIDA 8PK 1390 MM BMW F01 F07 F15 F20 F22 F25 F26 F30 F32 N55 (FREY),1731,6,2,6,14
11287628661-100,BANDA DE ALTERNADOR BMW MOTOR N55 8PK1390 INACTIVO,1480,5,9,7,21
11287631810,BANDA DE AIRE ACONDICIONADO 6PK1870 BMW E87 N46-N46N BMTRS,1616,6,9,3,18
11287631810 *1,BANDA COMPRESOR AIRE ACONDICIONADO BMW 6PK1870 N46 N46N (FREY),1825,9,7,4,20
11287631810-1,BANDA DE AIRE ACONDICIONADO BMW MOTOR N46-N46N DAYCO 6PK1870,1971,2,4,6,12
11287631814 *1,BANDA ACCESORIOS MOTOR MEDIDA 4PK 860 MM BMW E53 E60 E63 E65 N62 N62N (FREY),1691,6,9,3,18
11287631817,BANDA DE BOMBA DE AGUA BMW E53-N62 BMTR 6PK1548,1569,7,6,9,22
11287631821,BANDA DE AIRE ACONDICIONADO BMW MOTOR N62N CONTITECH 4PK870,1331,8,8,8,24
11287631821 *1,BANDA DE AIRE ACONDICIONADO BMW E70-N62N FREY 4PK870,1647,4,9,4,17
11287631822 *1,BANDA ACCESORIOS MOTOR AIRE ACONDICIONADO 4PK843 BMW E60 E66 M54 (FREY),1670,3,9,9,21
11287631822 *9,BANDA ACCESORIOS MOTOR AIRE ACONDICIONADO 4PK843 BMW E60 E66 M54 (BMTR),1280,1,4,6,11
11287631824,BANDA DE BOMBA DE AGUA BMW MOTOR N63 CONTINENTAL 7PK1647,1954,6,4,3,13
11287636372,BANDA ACCESORIOS MOTOR MEDIDA 6PK 1453 MM BMW E85 M54 CONTITECH,1446,6,7,7,20
11287636372 *1,BANDA ACCESORIOS MOTOR MEDIDA 6PK 1453 MM BMW E85 M54 (FREY),1536,5,4,0,9
11287636377,BANDA ACCESORIOS MOTOR MEDIDA 7PK 1635 MM BMW E38 E39 E53 M62 BMTR,1303,3,1,9,13
11287636377-1,BANDA ACCESORIOS MOTOR MEDIDA 7PK 1635 MM BMW E38 E39 E53 M62 CONTITECH,1687,7,4,9,20
11287636378,BANDA DE BOMBA DE AGUA BMW MOTOR M50-M52 BMTR 6PK1555,1434,4,5,5,14
11287636379 *1,BANDA ACCESORIOS ALTERNADOR MEDIDA 6PK 1538 MM BMW E46 E36 E39 E38 E53 E60 E83 M52 M54 (FREY),1467,4,5,0,9
11287636379-1,BANDA ACCESORIOS ALTERNADOR MEDIDA 6PK 1538 MM BMW E46 E36 E39 E38 E53 E60 E83 M52 M54 DAYCO,1767,5,6,4,15
11287636379-9,BANDA ACCESORIOS ALTERNADOR MEDIDA 6PK 1538 MM BMW E46 E36 E39 E38 E53 E60 E83 M52 M54 BMTR,1401,1,8,7,16
11287649371 *1,POLEA RE ENVIO LISA 65X26X8 MM BMW B32 B36 B38 B42 B46 B48 (FREY),1791,0,4,6,10
11287838797 *1,TENSOR HIDRAULICO BANDA ACCESORIOS MOTOR BMW M52 M54 (FREY),1294,9,9,8,26
11288519128,BANDA DE BOMBA DE AGUA BMW MOTOR N47 CONTITECH 6PK1697,1331,1,4,9,14
11288519128 *1,BANDA DE BOMBA DE AGUA BMW MOTOR N47 FREY 6PK1697,1528,0,4,7,11
11288570439 *1,TENSOR BANDA ACCESORIOS BMW B38 B46 B48 B58 (FREY),1434,2,2,3,7
11288570439 *3,TENSOR BANDA ACCESORIOS BMW B38 B46 B48 B58 (ELRING),1850,5,2,7,14
11288573253 *1,BANDA ACCESORIOS MOTOR MEDIDA 6PK 1715 MM BMW F48 B48 MINI F55 F56 B48 (FREY),1882,9,5,1,15
11288600357 *1,TENSOR MECANICO BANDA ACCESORIOS BMW B32 B38 B42 B46 B48 (FREY),1380,1,8,9,18
11288604266,TENSOR DE BANDA DE ACCESORIOS BMW F30-N55 BMTR,1948,3,9,0,12
11288604266 *1,TENSOR DE BANDA DE ACCESORIOS BMW F30-N55 FREY,1902,2,8,0,10
11288604266-1,TENSOR DE BANDA DE ACCESORIOS BMW F30-N55 INA,1504,0,0,2,2
11288620023,POLEA ED REENVIO,1346,4,3,3,10
11288620210 *1,KIT 3 PZ BASE TENSOR HIDRAULICO POLEA DE BANDA ACCESORIOS MINI COOPER R52 R53 W11 TURBO (FREY),1917,0,3,9,12
11288620210 *5,TENSOR BANDA ACCESORIOS MOTOR MINI R52 R53 W11 SUPERCARGADO (URO) SSF,1544,5,9,6,20
11288620210B,TENSOR BANDA ACCESORIOS MOTOR MINI R52 R53 W11 SUPERCARGADO (FREY),1746,2,7,1,10
11288624196,TENSOR DE BANDA DE ACCESORIOS BMW E90-N52N INA,1588,0,3,7,10
11288624196-100,TENSOR BANDA ACCESORIOS MOTOR BMW E90 N52N INACTIVO,1369,8,3,6,17
11288625983 *5,POLEA REENVIO LISA BANDA ACCESORIOS COOPER W11 SUPERCARGADO (INA) SSF,1598,5,7,4,16
11288646472 *1,BANDA ACCESORIOS MOTOR0 MEDIDA 6PK 1163 MM BMW BMW F20 F30 B38 (FREY),1698,8,6,7,21
1129970246,RETEN DE CIGï¿½Eï¿½AL TRASERO MERCEDES W203 ELRING,1215,1,4,3,8
1129970246 *1,RETEN CIGUENAL TRASERO 114X93X11.5 MM MERCEDES M112 M113 M275 (FREY),1715,3,4,5,12
1130160120 *1,JUNTA CABEZA MOTOR (R) MEDIDA STANDAR 0.65 MM MERCEDES W202 W210 W163 W220 (FREY),1273,5,2,3,10
1130160220 *1,JUNTA CABEZA MOTOR (L) MERCEDES (L) M113 8 CIL 5.0 5.5 LITROS (FREY),1811,7,9,9,25
1130160221,JUNTA DE TAPA DE PUNTERIAS L MERCEDES W245 BMTR,1281,2,8,5,15
1130160221 *1,JUNTA DE TAPA DE PUNTERIAS L MERCEDES W245 FREY,1447,8,7,1,16
1130160221-1,JUNTA DE TAPA DE PUNTERIAS L MERCEDES W245 VICTOR REINZ,1875,1,2,0,3
1130160221-2,JUNTA DE TAPA DE PUNTERIAS L MERCEDES W245 MEISTERSATZ,1778,5,1,8,14
1130160320 *1,JUNTA CABEZA MOTOR (R) MEDIDA STANDAR 0.65 MM MERCEDES M113 (FREY),1755,5,2,6,13
1130160320 *5,JUNTA CABEZA MOTOR (R) MEDIDA STANDAR 0.65 MM MERCEDES M113 (ELRING),1641,1,3,2,6
1130160321,JUNTA DE TAPA DE PUNTERIAS R MERCEDES W245 BMTR,1484,8,2,1,11
1130160321 *1,JUNTA DE TAPA DE PUNTERIAS (R) MERCEDES M113 (FREY),1998,6,3,2,11
1130160321-2,JUNTA DE TAPA DE PUNTERIAS R MERCEDES W245 VICTOR REINZ,1220,3,4,4,11
1130160420-100,JUNTA DE CABEZA DE MOTOR MERCEDES ( L ) -M113 INACTIVO,1267,2,2,4,8
1130160920,JUNTA CABEZA MOTOR (L) MEDIDA STANDAR 0.65 MM MERCEDES M113 (ELRING),1368,0,5,8,13
1130160920 *1,JUNTA CABEZA MOTOR (L) MEDIDA STANDAR 0.65 MM MERCEDES M113 (FREY),1823,5,8,4,17
1130160920-1,JUNTA CABEZA MOTOR (L) MEDIDA STANDAR 0.65 MM MERCEDES M113 VICTOR REINZ,1457,5,9,5,19
1130161020-100,JUNTA CABEZA MOTOR (R) MEDIDA STANDAR 0.65 MM MERCEDES M113 INACTIVO,1344,4,1,1,6
1130940048,SENSOR DE MASA DE AIRE MAF MERCEDES W164-M113 BREMI,2000,2,3,6,11
113112000000,GUIA DE CADENA E46 M54 BAMPIC,1444,8,7,8,23
11311432176 *1,CADENA DE DISTRIBUCION LARGA BMW MOTOR M50-M52-M54 FREY,1692,4,3,9,16
11311432176 *5,CADENA DISTRIBUCION LARGA BMW MOTOR M50 M52 M54,1227,3,8,5,16
11311432176 *6,CADENA DE DISTRIBUCION LARGA BMW MOTOR M50-M52-M54 (IWIS) SSF,1312,5,9,5,19
11311432177 *1,CADENA SUPERIOR DE DISTRIBUCION BMW MOTOR M50-M52-M54 FREY,1401,1,5,1,7
11311432177 *5,CADENA SUPERIOR DE DISTRIBUCION BMW MOTOR M50-M52-M54 (IWIS) SSF,1828,4,8,5,17
11311435416,ARBOL DE LEVAS ESCAPE SEMINUEVO BMW M52-M54 ( GENUINO ),1236,3,4,6,13
11311435416 *1,ARBOL DE LEVAS DE ESCAPE SEMINUEVO BMW MOTOR M52-M54 FREY,1726,5,9,3,17
11311438079,ARBOL DE LEVAS ADMISION SEMINUEVO BMW M52-M54 ( GENUINO ),1528,1,8,3,12
11311703717 *1,GUIA DE CADENA DISTRIBUCION (R) (CURVA) BMW M50 M52 M54 (FREY),1558,1,3,4,8
11311703717-101,GUIA DE CADENA DISTRIBUCION ( R ) ( CURVA ) BMW M50 M52 M54 INACTIVO,1614,4,2,3,9
11311703717-102,GUIA DE CADENA DISTRIBUCION ( R ) ( CURVA ) BMW M50 M52 M54  INACTIVO,1697,0,2,5,7
11311703746 *1,TORNILLO DEL TENSOR DE LA CADENA DE DISTRIBUCION BMW E46 FREY,1565,1,8,9,18
11311703746 *5,TORNILLO DEL TENSOR DE LA CADENA DE DISTRIBUCION BMW E46 (GENUINO) SSF,1706,1,6,8,15
11311703747,TENSOR DE CADENA INFERIOR BMW E46 SEMINUEVO ORIGINAL,1626,1,1,1,3
11311703747 *1,TENSOR DE CADENA INFERIOR BMW E46 FREY,1649,0,4,1,5
11311703747 *6,TENSOR DE CADENA INFERIOR BMW E46 (FEBI) SSF,1222,2,7,9,18
11311722651,"GUIA DE CADENA SUPERIOR FORMA DE """" T """" BMW E46 FEBI",1781,5,5,8,18
11311722651 *1,GUIA DE CADENA SUPERIOR FORMA ( T ) BMW M50 M52 M54 ( FREY ),1889,9,2,8,19
11311722651-1,"GUIA DE CADENA SUPERIOR FORMA DE """" T """" BMW E46 TOPRAN",1519,5,8,7,20
11311722651-2,"GUIA DE CADENA SUPERIOR FORMA DE """" T """" BMW E46 BAMPIC",1772,5,2,7,14
11311726480 *1,GUIA CADENA DISTRIBUCION (L) (RECTA) BMW M50 M52 M54 (FREY),1223,8,6,2,16
11311726480-101,GUIA DE CADENA DE DISTRIBUCION BMW E46-M54 INACTIVO,1319,4,7,0,11
11311726480-102,GUIA DE CADENA DE DISTRIBUCION BMW E46-M54  INACTIVO,1759,5,1,8,14
11311726480-104,GUIA DE CADENA DE DISTRIBUCION BMW E46-M54   INACTIVO,1868,6,7,6,19
11311726480-105,GUIA DE CADENA LADO IZQUIERDO ( RECTA ) BMW E46 FEBI INACTIVO,1791,9,5,1,15
11311738700,TENSOR DE CADENA SUPERIOR BMW E46-M54 FEBI,1904,4,4,7,15
11311738700 *1,TENSOR CADENA SUPERIOR BMW M52 M54 (FREY),1896,7,2,8,17
11311738700-2,TENSOR DE CADENA SUPERIOR BMW E46-M54 TOPRAN,1461,9,0,2,11
1131410125,CUERPO DE ACELERACION SEMINUEVO MERCEDES W203 ( GENUINO ),1867,0,3,7,10
1131410125 *1,CUERPO DE ACELERACION MERCEDES W203 FREY,1316,7,1,8,16
1131410680 *1,JUNTA DE ADMISION MERCEDES W202-M113 FREY,1833,6,2,2,10
1131410980,JUNTA DE ADMISION MERCEDES W202-M113 VICTOR REINZ,1856,1,9,9,19
11314552380-4,TENSOR DE CADENA  BMW E90 BAMPIC,1836,3,1,0,4
11317141746 *1,GUIA RECTA CADENA DISTRIBUCION (L) BMW M62 4.4L (FREY),1956,7,4,5,16
1131750-100,ENGr@ INACTIVO,1539,3,1,0,4
11317502180,ENGRANE INFERIOR DE CADENA DE DISTRIBUCION BMW E90-N52 GENUINO,1518,4,6,0,10
11317505608 *1,GUIA SUPERIOR CADENA DISTRIBUCION MOTOR BMW N46 N46N ( FREY ),1441,9,6,5,20
11317510801,TENSOR DE CADENA DE TIEMPO MINI COOPERS R53 BAMPIC,1248,3,2,9,14
11317512520 *1,GUIA SUPERIOR CADENA DISTRIBUCION BMW N46 N46N (FREY),1920,7,5,8,20
11317512520-3,GUIA DE CADENA DE DISTRIBUCION BMW N46 N46N (EMBLER),1862,5,0,9,14
11317516093,GUIA DE CADENA SUPERIOR BMW E92,1512,4,7,4,15
11317516093 *1,GUIA DE CADENA SUPERIOR BMW E92 FREY,1898,1,8,2,11
11317523884 *1,GUIA INFERIOR CADENA DISTRIBUCION MOTOR BMW N52 N52N (FREY),1500,2,7,2,11
11317523884 *2,KIT 11 PZ TENSOR ENGRANES CADENA GUIAS DISTRIBUCION MOTOR BMW N52 N52N (EMBLER) HPS,1289,7,4,8,19
11317533879 *1,GUIA CADENA (L) DISTRIBUCION MOTOR BMW N13 MINI N12 N16 N18 (FREY),1680,1,6,0,7
11317534833 *5,GUIA CORTA (R) CADENA DISTRIBUCION MOTOR MINI N14 (GENUINA) SSF,1374,4,6,9,19
11317542837 *1,GUIA CADENA PRINCIPAL MOTOR BMW N54 (FREY),1317,4,8,4,16
11317546697 *5,GUï¿½A SUPERIOR CADENA DISTRIBUCION MOTOR MIMI N14 (GENUINA) SSF,1853,0,3,9,12
11317546697 *6,GUï¿½A SUPERIOR CADENA DISTRIBUCION MOTOR MIMI N14 (OEM) SSF,1977,6,4,6,16
11317563665,ARBOL DE LEVAS DE ESCAPE BMW MOTOR N52-N52N  SEMINUEVO,1640,1,5,3,9
11317563665 *1,ARBOL DE LEVAS DE ESCAPE BMW MOTOR N52-N52N FREY,1617,8,9,7,24
11317567680 *1,TENSOR CADENA SUPERIOR DISTRIBUCION BMW N20 N46 N46N (FREY),1658,6,0,8,14
11317567680-100,TENSOR DE CADENA SUPERIOR BMW N52N 6CIL INACTIVO,1914,1,1,6,8
11317568241,GUIA DE CADENA LARGA MINI R56-N14 (FEBI),1251,8,1,8,17
11317577301,GUIA CADENA DE TIEMPO R56 TOPRAN,1290,6,3,6,15
11317577301 *1,GUIA CADENA DE TIEMPO R56 FREY,1235,0,5,7,12
11317577301 *3,KIT 10 PZ GUIAS TENSOR CADENA DISTRIBUCION 2 ENGRANES CABEZA MINI N12 N16 (EMBLER) HPS,1912,6,4,2,12
11317584723 *1,TENSOR CADENA DISTRIBUCION BMW N52N N54 N55 (FREY),1689,3,3,4,10
11317584803,ARBOL DE LEVAS DE ADMISION BMW MOTOR N54 ORIGINAL,1797,2,6,6,14
11317584803 *1,ARBOL DE LEVAS DE ADMISION BMW MOTOR N54 FREY,1541,3,8,7,18
11317584804,ARBOL DE LEVAS DE ESCAPE BMW MOTOR N54 ORIGINAL,1871,6,6,1,13
11317584804 *1,ARBOL DE LEVAS DE ESCAPE BMW MOTOR N54 FREY,1774,9,1,3,13
11317585020 *3,KIT 5 PZ ENGRANE GUIAS CADENA TENSOR DISTRIBUCIï¿½N BMW N52 N52N N55 S55 (BGA),1733,5,4,1,10
11317585020 *K,KIT 5 PZ ENGRANE GUIAS CADENA TENSOR DISTRIBUCIï¿½N BMW N52 N52N N55 S55 (EMBLER) HSP,1552,4,0,8,12
11317592850 *1,GUIA SUPERIOR CADENA DISTRIBUCION MOTOR BMW N20 N26 N52 N52N N55 (FREY),1754,3,0,2,5
11317592877 *1,GUIA PRINCIPAL CADENA DISTRIBUCION MOTOR BMW N20 N26 (FREY),1754,2,7,6,15
11317603944 *1,ENGRANDE DE DISTRIBUCION N20 ( FREY ),1618,1,2,2,5
11317607551 *1,TENSOR CADENA DISTRIBUCION MOTOR MINI N12 N14 N16 N18 (FREY),1611,4,5,8,17
11317607551-100,TENSOR DE CADENA MINI R56 N12-N14 INACTIVO,1666,7,1,9,17
11317621097 *1,TENSOR Y GUIA RAIL FREY,1445,2,4,6,12
11318618317 *3,CADENA TENSOR DISTRIBUCION MOTOR BMW N14 N43 N53 N54 (ELRING),1828,2,8,6,16
11318648732 *1,CADENA DE DISTRIBUCION BMW F30 328i FREY,1524,3,8,0,11
11318648732 *3,CADENA DE DISTRIBUCION BMW F30 328i (CALIDAD ORIGINAL),1661,9,3,5,17
1132000022,FAN CLUTCH DE 3 TORNILLOS MERCEDES W210-M113 BMTR,1268,6,7,1,14
1132000022 *1,FAN CLUTCH DE 3 TORNILLOS MERCEDES W210-M113 FREY,1643,9,7,8,24
1132000022-1,FAN CLUTCH DE 3 TORNILLOS MERCEDES W210-M113 BEHR,1242,2,4,3,9
1132000022-3,FAN CLUTCH DE 3 TORNILLOS MERCEDES W210-M113 GENUINO,1247,4,9,3,16
1132000101 *1,BOMBA AGUA ENFRIAMIENTO MOTOR MERCEDES W463 KOMPRESSOR (FREY),1218,7,9,1,17
1132000223,ASPAS DE VENTILADOR MECANICO MERCEDES W210 URO,1582,9,8,9,26
1132000223 *1,ASPAS DE VENTILADOR MECANICO MERCEDES W210 FREY,1600,0,9,4,13
11321748884 *5,PUNTERIAS HIDRAULICAS MOTOR BUZOS BMW M50 M52 M54 (INA) SSF,1997,3,2,8,13
11321748884-1,PUNTERIAS HIDRAULICAS ( BUZOS ) BMW E46 / M54 ( KOLBENSCHMIDT ),1791,8,5,9,22
11321748884-100,PUNTERIAS HIDRAULICAS ( BUZOS ) BMW E46 / M54 ( TOPRAN ) INACTIVO,1842,4,9,6,19
11321748884-3,PUNTERIAS HIDRAULICAS ( BUZOS ) BMW E46 / M54 FREY,1835,3,3,5,11
11321748884-5,PUNTERIAS HIDRAULICAS ( BUZOS ) BMW E46-M54 BGA,1336,3,0,8,11
1133-100,PUNTERIA HIDRAULICAS BUZO BMW E90 N52-N52N INACTIVO,1457,8,7,4,19
11337512116,PUNTERIAS HIDRAULICAS ( BUZOS ) BMW E87-N46  TOPRAN,1991,9,7,8,24
11337512116 *1,PUNTERIAS HIDRAULICAS ( BUZOS ) BMW E87-N46  FREY,1524,9,3,2,14
11337522124,BRAZO OSCILANTE AJUSA,1507,3,7,8,18
11337549632,PUNTERIAS HIDRAULICAS BUZOS ESCAPE MINI R56 INA,1266,7,9,4,20
11337549632-1,PUNTERIAS HIDRAULICAS BUZOS ESCAPE MINI R56 GENUINO,1530,5,8,8,21
11337549632-2,PUNTERIAS HIDRAULICAS BUZOS ESCAPE MINI R56 TOPRAN,1845,3,4,4,11
11337549633,1 PZ BUZO HIDRAULICO PUNTERIA VALVULA ADMISION CABEZA MOTOR MINI N18 N13 TOPRAN,1911,3,9,1,13
11337549633 *5,1 PZ BUZO HIDRAULICO PUNTERIA VALVULA ADMISION CABEZA MOTOR MINI N18 N13 (INA) SSF,1534,7,9,8,24
11337559792,BALANCIN SEMINUEVO BMW E90  GENUINO,1863,3,6,4,13
11337559792 *1,BALANCIN SEMINUEVO BMW E90  FREY,1397,5,5,9,19
11337605330 *1,1 PZ BUZO HIDRAULICO PUNTERIA VALVULAS CABEZA MOTOR BMW N52 N52N (FREY),1557,6,4,0,10
11337605330 *5,1 PZ BUZO HIDRAULICO PUNTERIA VALVULAS CABEZA MOTOR BMW N52 N52N (INA) SSF,1316,4,7,6,17
11340029571,SELLOS DE VALVULA ADMISION Y ESCAPE 16 PZS R53-W11 VICTOR REINZ,1960,6,9,2,17
11340029751 *1,KIT 16 PZ SELLOS VALVULAS 5 MM ADMISION ESCAPE BMW N46N N62 N62 (FREY),1692,2,1,2,5
11340029751 *5,KIT 16 PZ SELLOS VALVULAS 5 MM ADMISION ESCAPE BMW N46N N62 N62 (VICTOR REINZ) SSF,1495,5,9,6,20
11340029751 *6,KIT 16 PZ SELLOS VALVULAS 5 MM ADMISION ESCAPE BMW N46N N62 N62 (CORTECO) SSF,1506,2,4,1,7
11340029751-100,SELLOS DE VALVULAS 5 MM ADMISION Y ESCAPE BMW MOTOR N46N BMTRS INACTIVO,1363,1,1,4,6
11340032582-100,SELLOS DE VALVULA ADMISION 16 PZ. BMW N52N N54 N55 S55 B58 INACTIVO,1879,2,7,9,18
11340033950,SELLOS DE VALVULA ADMISION Y ESCAPE BMW F20-N13 R56-N12-14 VICTOR REINZ 16 PZS,1860,9,4,0,13
11340033950 *1,KIT 16 PZ SELLOS VALVULA CABEZA MOTOR ADMISION ESCAPE BMW F20 N13 MINI N12 14 (FREY),1868,5,3,6,14
11340033950 *5,SELLOS DE VALVULA ADMISION Y ESCAPE BMW F20-N13 R56-N12-14 (CORTECO) 16 PZS,1218,5,1,4,10
11340033950-2,SELLOS DE VALVULA ADMISION Y ESCAPE BMW F20-N13 R56-N12-14 ELRING 16 PZS,1498,0,7,5,12
11340034068 *1,KIT 12 PZ. SELLOS VALVULAS ADMISION AIRE MOTOR 5MM MM BMW N52 N52N N54 N55 B58 S55 (FREY),1625,2,8,1,11
11340034068 *5,KIT 12 PZ. SELLOS VALVULAS ADMISION AIRE MOTOR 5MM MM BMW N52 N52N N54 N55 B58 S55 (CORTECO) SSF,1700,2,6,2,10
11340035853 *1,KIT 12 PZ. SELLOS VALVULAS ESCAPE 6 MM BMW N52 N52N N54 N55 B58 S55 (FREY),1361,3,6,6,15
11340035853 *5,KIT 12 PZ. SELLOS VALVULAS ESCAPE 6 MM BMW N52 N52N N54 N55 B58 S55 (CORTECO) SSF,1752,5,1,0,6
11340035853-100,SELLOS DE VALVULA ESCAPE 12 PZ. BMW B48 N52N N54 N55 BMTRS INACTIVO,1540,7,1,8,16
11340038719 *3,KIT 8 PZ SELLOS VALVULA ADMISION MOTOR BMW B38 B46 B48 N20 N46 (ELRING),1274,6,5,0,11
11340038719-100,KIT 8 PZ SELLOS VALVULA ADMISION AIRE MOTOR BMW N20 B38 B48 (BMTSR) INACTIVO,1958,2,3,9,14
11340038720 *9,KIT 8 PZ SELLOS VALVULAS ESCAPE GASES MOTOR 6 MM BMW MOTOR B32 B36 B38 N20 N26 (BMTSR),1210,0,9,3,12
11341433699,VALVULA DE ESCAPE DE MOTOR BMW E53-M62 OSVAT,1893,9,8,9,26
11341433699 *1,VALVULA DE ESCAPE DE MOTOR BMW E53-M62 FREY,1445,9,1,3,13
11341435480,VALVULA DE ADMISION BMW E53-M62  OSVAT,1548,6,1,5,12
11341435480 *1,VALVULA DE ADMISION BMW E53-M62  FREY,1895,4,0,3,7
11341438385 *5,1 PZ VALVULA ADMISION AIRE CABEZA MOTOR 33X6 MM BMW M54 (FEBI) SSF,1542,8,5,9,22
11341440304,VALVULAS DE ADMISION BMW E87 - N46N  BGA,1805,2,7,4,13
11341440304 *1,VALVULAS DE ADMISION BMW E87 - N46N  FREY,1603,4,4,0,8
11341707519,VALVULA DE ESCAPE BMW MOTOR N46N-N46 DORMAN ALEMAN,1318,2,6,8,16
11341707519-1,VALVULA DE ESCAPE BMW MOTOR N46N-N46 TOPRAN,1579,7,6,7,20
11341736916,KIT 12 PZ SELLOS VALVULAS MOTOR BMW M54 N62 8 CIL  4.4  4.6  CORTECO,1562,8,2,3,13
11341739820,VALVULA DE CABEZA DE MOTOR ADMISION  BMW E46,1368,6,5,5,16
11341739820 *1,VALVULA DE CABEZA DE MOTOR ADMISION  BMW E46 FREY,1345,8,1,1,10
11341739821,VALVULA DE ADMISION ESTï¿½NDAR,1885,1,3,6,10
11347505731 *5,1 PZ VALVULA ESCAPE GASES CABEZA MOTOR 30.5X6 MM BMW M54 (FEBI) SSF,1516,6,2,4,12
11347513019,VALVULA ADMISION MINI SWISS,1477,7,1,4,12
11347513023 *2,VALVULA ADMISION CABEZA MOTOR 6MM MINI R50 R52 W10 (EMBLER) GOG,1422,7,0,9,16
11347533885,VALVULA DE ESCAPE DE CABEZA DE MOTOR MINI R56 N12-N16 OVAT,1375,7,3,7,17
11347533885 *2,VALVULA ESCAPE CABEZA MOTOR 5MM MINI R55-R61 N12 N16 (EMBLER) GOG,1637,3,4,1,8
11347547187,VALVULA DE ESCAPE DE CABEZA DE MOTOR MINI R56 - N14  INTERVALVES,1593,8,8,9,25
11347547187 *3,VALVULA DE ESCAPE DE CABEZA DE MOTOR MINI R56 - N14 (BGA),1802,1,9,9,19
11347553771 *5,1 PZ VALVULA ADMISION AIRE CABEZA MOTOR 34.2 MM BMW N52 N52N (TRW) SSF,1683,0,7,2,9
11347553771 *6,1 PZ VALVULA ADMISION AIRE CABEZA MOTOR 34.2 MM BMW N52 N52N (INTERVALVES) SSF,1830,4,0,8,12
11347553772 *5,1 PZ VALVULA ESCAPE GASES CABEZA MOTOR 29.0 MM BMW N52 N52N (INTERVALVES) SSF,1277,7,1,6,14
11347553775,VALVULA DE ADMISION BMW E90 - N54 TRW,1647,1,0,2,3
11347553775 *1,VALVULA DE ADMISION BMW E90 - N54 FREY,1835,6,9,4,19
11347553775-1,VALVULA DE ADMISION BMW E90 - N54 OSVAT,1325,5,6,0,11
11347573840,VALVULA DE ESCAPE DE MOTOR BMW E90 - N54  BGA,1827,1,0,6,7
11347573840 *1,VALVULA DE ESCAPE DE MOTOR BMW E90 - N54  FREY,1695,0,8,8,16
11347573840 -6,VALVULA DE ESCAPE DE MOTOR BMW E90 - N54 ( TRW ),1477,9,1,3,13
11347573840-1,VALVULA DE ESCAPE DE MOTOR BMW E90 - N54  OSVAT,1877,8,4,3,15
11347585901 *2,VALVULA ADMISION CABEZA MOTOR 29.7MM X 4.97 MM BMW N13 N18 (EMBLER),1348,0,9,4,13
11347585901 *3,VALVULA ADMISION CABEZA MOTOR 29.7MM X 4.97 MM BMW N13 N18 (MAHLE),1332,1,1,3,5
11347587470,VALVULA DE ADMISION DE CABEZA DE MOTOR MINI R56 - N14  INTERVALVES,1209,2,2,0,4
11349064457,SELLOS DE VALVULA DE ADMISION BMW MOTOR M54 GOETZE,1588,5,7,6,18
11349064457 *1,SELLOS DE VALVULA DE ADMISION BMW MOTOR M54 FREY,1576,1,8,3,12
11349064457 *5,KIT 12 PZ SELLOS VALVULA ADMISION Y ESCAPE MOTOR 6 MM BMW M50 M52 M54 M62 (VICTOR REINZ) SSF,1903,8,6,1,15
11349064457-2,SELLOS DE VALVULA DE ADMISION BMW MOTOR M54 CORTECO,1224,1,2,6,9
11349064457-4,SELLOS DE VALVULA DE ADMISION BMW MOTOR M54 BMTRS,1316,5,0,7,12
11361432532 *5,VALVULA SOLENOIDE VANOS BMW E46 E39 E38 E83 E53 E36 (FEBI) SSF,1614,1,4,5,10
11361433513,TAPON DE CIERRE DE VANOS BMW E46-M54 VICTOR REINZ,1238,2,6,5,13
11361433513 *1,TAPON DE CIERRE DE VANOS BMW E46-M54 FREY,1923,9,4,3,16
11361433513-1,TAPON DE CIERRE DE VANOS BMW E46-M54 GENUINO,1773,7,2,3,12
11361433817,JUNTA DE TAPA DE VANOS BMW E46-M54 BMTR,1657,0,2,7,9
11361433817 *1,JUNTA DE TAPA DE VANOS BMW E46-M54 FREY,1452,6,2,9,17
11361438338,TORNILLO DE VANOS BMW E46 ( GENUINO ),1340,2,3,8,13
11361438338 *1,TORNILLO DE VANOS BMW E46 FREY,1788,8,5,4,17
11361440134,SISTEMA VANOS BMW E46 ( RECONSTRUIDO A CAMBIO ),1765,7,2,4,13
11361440134 *2,KIT 19 PZ. REPUESTO REPARACION SISTEMA VANOS BMW MOTOR M52 M54 (EMBLER) GOG,1770,7,1,1,9
11361440134 *5,SISTEMA VANOS BMW E36 E38 E39 E46 E53 E60 E61 E65 E66 E83 (GENUINO),1423,3,3,3,9
11361440142,VANOS  SISTEMA COMPLETO,1276,9,7,2,18
11361705532 *1,MANGUERA ACEITE MOTOR SISTEMA VANOS BMW M52 M54 (FREY),1605,8,6,8,22
11361707315 *1,ENGRANE ARBOL LEVAS ESCAPE GASES MOTOR VVT (L/R) BMW E46 E60 E81-E88 E90-E93 (FREY),1903,0,9,6,15
11361738494 *5,VALVULA SOLENOIDE SISTEMA VANOS BMW M50 M52 (VAICO) SSF,1556,8,6,8,22
11361748745 *1,TORNILLO DE ENGRANE DE VANOS CUERDA IZQ. BMW MOTOR M52-M54 6CIL 2.5L FREY,1427,9,2,3,14
11361748745 *5,TORNILLO ENGRANE SISTEMA VANOS CUERDA IZQUIERA BMW M52 M54 (GENUINO) SSF,1673,2,1,4,7
11367500032 *1,ENGRANE ARBOL LEVAS ADMISION AIRE MOTOR VVT BMW E46 E60 E81-E88 E90-E93 (FREY),1757,5,6,3,14
11367506178 *1,O RING LIGA VALVULA SOLENOIDE VVT BMW N46N (FREY),1749,9,1,0,10
11367506178-100,JUNTA VALVULA SOLENOIDE E81/N46N ELRING INACTIVO,1592,6,6,6,18
11367506775 *1,Derecho de entrada de ajuste de sincronizaciï¿½n del ï¿½rbol de levas FREY,1300,8,4,9,21
11367524498,SOLENOIDE (SISTEMA VALVETRONIC) E90 /E60/ E70 /E81 /E84,1901,0,5,3,8
11367524498 *1,SOLENOIDE (SISTEMA VALVETRONIC) E90 /E60/ E70 /E81 /E84 FREY,1457,3,7,8,18
11367536085 *1,ENGRANE VARIADOR VVT ARBOL LEVAS ESCAPE BMW N13 MINI N12 N16 N18 (FREY),1748,8,9,3,20
11367536085 *2,ENGRANE VARIADOR VVT ARBOL LEVAS ESCAPE BMW N13 MINI N12 N16 N18 (EMBLER) HPS,1974,9,2,1,12
11367540347,ENGRANE DE ARBOL DE LEVAS DE ADMISION BMW E90-N54 GENUINO,1503,5,2,9,16
11367540347 *1,ENGRANE DE ARBOL DE LEVAS DE ADMISION BMW E90-N54 FREY,1823,2,9,3,14
11367540348,ENGRANE DE ARBOL DE LEVAS DE ESCAPE SEMINUEVO BMW E90-N54 GENUINO,1677,5,3,5,13
11367540348 *1,ENGRANE ARBOL LEVAS ESCAPE  BMW N54 (FREY),1319,6,4,6,16
11367545862 *1,ENGRANE VARIADOR VVT ARBOL LEVAS ADMISION BMW N13 MINI N12 N14 N16 N18 (FREY),1760,3,9,5,17
11367545862 *2,ENGRANE VARIADOR VVT ARBOL LEVAS ADMISION BMW N13 MINI N12 N14 N16 N18 (EMBLER) HPS,1489,0,8,1,9
11367545862 *3,KIT 9 PZ GUIAS TENSOR CADENA DISTRIBUCION 2 ENGRANES CABEZA MINI N12 N14 N16 N18 (EMBLER) HPS,1577,5,7,2,14
11367545862 *K11,KIT DE CADENAS DE DISTRIBUCION CON ENGRANES MINI R56-N12-N14-N16-N18 DORMAN PRECISION,1246,4,1,3,8
11367546379,JUNTA SONELOIDE BMW E81/N46N ELRING,1989,2,2,0,4
11367548459,JUEGO DE JUNTAS DE VALVULA SOLENOIDE SISTEMA VANOS BMW E90-N52 GENUINA,1355,1,3,0,4
11367548459 *1,JUEGO DE JUNTAS DE VALVULA SOLENOIDE SISTEMA VANOS BMW E90-N52 (FREY),1588,6,9,7,22
11367548459 *5,JUNTAS VALVULA SOLENOIDE VANOS BMW N52 N52N N54 N55 S55 N63 S63 (VICTOR REINZ) SSF,1874,0,8,2,10
11367548459 *6,JUNTAS VALVULA SOLENOIDE VANOS BMW N52 N52N N54 N55 S55 N63 S63 (TRW) SSF,1984,5,5,2,12
11367548459-2,JUEGO DE JUNTAS DE VALVULA SOLENOIDE SISTEMA VANOS BMW E90-N52 BMTR,1666,0,0,3,3
11367560462,VALVULA SOLENOIDE DE SISTEMA VALVETRONIC BMW E87  N46  BMTR,1896,3,5,5,13
11367560462 *1,VALVULA SOLENOIDE VVT VALVETRONIC BMW N46N N62N (FREY),1559,3,2,7,12
11367560462-2,VALVULA SOLENOIDE DE SISTEMA VALVETRONIC BMW MOTOR N46  BEMWQ,1410,3,2,3,8
11367560462-3,VALVULA SOLENOIDE DE SISTEMA VALVETRONIC BMW E87  N46  OSSCA,1511,4,8,5,17
11367578877,CAPTADOR DE ENGRANE DE ESCAPE Y ADMISION ARBOL DE LEVAS BMW MOTOR N52N-N52-N55 ORIGINAL,1596,7,6,7,20
11367578877 *1,CAPTADOR DE ENGRANE DE ESCAPE Y ADMISION ARBOL DE LEVAS BMW MOTOR N52N-N52-N55 FREY,1298,5,7,8,20
11367583207 *1,ENGRANE DE ARBOL DE LEVAS ADMISION BMW MOTOR N52 N52N (FREY),1942,9,9,4,22
11367583207 *2,ENGRANE ARBOL LEVAS ADMISION BMW MOTOR N52 N52N (EMBLER) HPS,1955,1,9,7,17
11367583207-3,ENGRANE DE ARBOL DE LEVAS ADMISION BMW MOTOR N52-N52N ( DORMAN ALEMAN ),1214,0,6,1,7
11367583207-4,ENGRANE DE ARBOL DE LEVAS ADMISION BMW MOTOR N52-N52N ( OSSCA ),1644,8,0,0,8
11367583207-9,ENGRANE DE ARBOL DE LEVAS ADMISION BMW MOTOR N52-N52N ( GENUINO ),1758,5,1,1,7
11367583208 *1,ENGRANE ARBOL LEVAS ESCAPE BMW N52 N52N (FREY),1405,9,3,6,18
11367583208 *2,ENGRANE ARBOL LEVAS ESCAPE BMW MOTOR N52 N52N (EMBLER) HPS,1894,4,8,6,18
11367583208-1,ENGRANE DE ARBOL DE LEVAS DE ESCAPE SEMINUEVO BMW N52-N52N 6CIL 2.5L GENUINO,1438,0,5,3,8
11367583818 *1,ENGRANE VARIADOR VVT ARBOL LEVAS ADMISION BMW N20 N26 (FREY),1921,6,0,9,15
11367583818 *2,ENGRANE VARIADOR VVT ARBOL LEVAS ADMISION BMW N20 N26 (EMBLER) HP,1744,9,8,8,25
11367583819 *1,ENGRANE VARIADOR VVT ARBOL LEVAS ESCAPE BMW N20 N26 (FREY),1720,5,7,8,20
11367583820 *1,VALVULA SOLENOIDES SISTEMA VANOS VVT BMW N20 N26 (FREY),1916,7,9,8,24
11367585425 *1,VALVULA SOLENOIDE VVT VALVETRONIC BMW N52 N52N N54 (FREY),1826,6,2,9,17
11367585425-1,VALVULA SOLENOIDE DE SISTEMA VALVETRONIC BMW E90-N52 ( EMBLER ),1520,6,9,4,19
11367585425-2,VALVULA SOLENOIDE DE SISTEMA VALVETRONIC BMW E90-N52  OSCCA,1489,2,1,4,7
11367593719 *1,SOLENOIDE ACTUADOR SISTEMA VANOS VVT BMW N20 N26 (FREY),1313,2,0,1,3
11367598001 *1,ENGRANE ARBOL LEVAS ADMISION AIRE MOTOR VVT BMW E70-E72 F01-F07 F10-F13 G12 (FREY),1872,4,5,3,12
11367598002 *1,ENGRANE ARBOL LEVAS ESCAPE GASES MOTOR VVT BMW E70-E72 F01-F07 F10-F13 G12 (FREY),1508,9,6,3,18
11367608789 *2,ENGRANE ARBOL LEVAS ESCAPE GASES MOTOR VVT (L/R) BMW F39 F45 F46 F48 MINI F54 F55 F56 F57 F60 (EMBLER),1819,4,8,4,16
11367614288 *1,SOLENOIDE ACTUADOR SISTEMA VANOS VVT BMW B38 B48 B58 (FREY),1621,2,9,6,17
11367620689 *2,VALVULA CONTROL ARBOL LEVAS MOTOR BMW F45 F46 F48 MINI F54 F55 F56 F57 F60 (EMBLER),1836,6,2,9,17
11368605123,VALVULA SELENOIDE DE SISTEMA DE VANOS BMW F30 - N55   BMTR,1578,8,9,5,22
11368605123 *1,VALVULA SELENOIDE DE SISTEMA DE VANOS BMW F30 - N55   FREY,1740,2,3,6,11
11368610388 *1,VALVULA SOLENOIDE VVT VALVETRONIC MINI BMW N12 N13 N14 N16 N18 (FREY),1638,0,0,3,3
11368610388-1,VALVULA SOLENOIDE DE SISTEMA VANOS MINI-BMW N12-N13-N14-N16-N18 TOPRAN,1953,6,6,7,19
11368610388-3,VALVULA SOLENOIDE DE SISTEMA VANOS MINI-BMW N12-N13-N14-N16-N18 OSSCA,1266,3,9,6,18
11368617692 *2,ENGRANE ARBOL LEVAS ADMISION AIRE MOTOR VVT BMW F20-F23 F30-F39 G11 G12 G30 G31 (EMBLER),1983,0,4,9,13
11368617694 *1,VALVULA CONTROL ARBOL LEVAS MOTOR BMW F45 F46 F48 MINI F54 F55 F56 F57 F60 (FREY),1240,3,8,0,11
1137328116,MOTOVENTILADOR DE MOTOR  BMW E60/MERCEDES W211 VOLVO S60 BOSCH,1546,8,7,7,22
1137328116 *3,MOTOVENTILADOR DE MOTOR(MOTOR) BMW E60/MERCEDES W211 VOLVO S60 BOSCH,1511,0,3,7,10
11377502022,JUNTA DE SENSOR VALVETRONIC BMW E87-N46 GOETZE,1719,6,6,8,20
11377502022 *1,JUNTA SENSOR ARBOL AUXIALR SISTEMA VALVETRONIC BMW N46 N46N (FREY),1930,3,1,1,5
11377502022-1,JUNTA DE SENSOR VALVETRONIC BMW E87-N46 ELRING,1526,6,0,9,15
11377508254,RESORTE DE ARBOL AUXILIAR BMW E87 (SEMINUEVO ORIGINAL),1237,6,2,8,16
11377508254 *1,RESORTE DE ARBOL AUXILIAR BMW E87 FREY,1640,9,6,1,16
11377509295 *5,SERVOMOTOR SISTEMA VALVETRONIC VVT BMW N46 N46N (ORIGINAL VDO),1413,2,0,0,2
11377509627 *1,TUBO PROTECTOR CALOR BOBINA IGNICION BMW N46 N46N (FREY),1247,6,1,7,14
11377509627-100,TUBO PARA BUJIA BMW MOTOR N46-N46N INACTIVO,1323,2,3,2,7
11377516299,RESORTE DE SENSOR DE VALVETRONIC DE AROL AUXILIAR BMW E90 / N52 ( ORIGINAL BMW ),1349,8,5,5,18
11377516299 *1,RESORTE DE SENSOR DE VALVETRONIC DE AROL AUXILIAR BMW E90 / N52 FREY,1374,6,9,8,23
11377516302,EMPAQUE DEL VELVELVETRONIC E90 ELRING,1769,1,1,0,2
11377516302 *1,JUNTA EMPAQUE SERVOMOTOR VALVETRONIC BMW N52 (FREY),1875,9,5,1,15
11377516302-1,EMPAQUE DEL VELVETRONIC E90 MEISTERSATZ,1802,1,5,0,6
11377524879,SENSOR DE ARBOL EXCENTRICO VALVETRONIC BMW E90-N52 SIEMENS VDO,1508,9,2,9,20
11377524879 *1,SENSOR DE ARBOL EXCENTRICO VALVETRONIC BMW E90-N52 FREY,1321,4,9,7,20
11377524879-2,SENSOR DE ARBOL EXCENTRICO VALVETRONIC BMW E90-N52 GENUINO SEMINUEVO,1907,4,7,9,20
11377527016,SENSOR DE ARBOL EXENTRICO VALVETRONIC BMW E87 N46N ( GENUINO ),1360,4,9,5,18
11377527016 *1,SENSOR DE ARBOL EXENTRICO VALVETRONIC BMW E87 N46N FREY,1272,3,6,1,10
11377527017 *1,SENSOR POSICION ARBOL EXCENTRICO AUXILIAR SISTEMA VVT BMW N62N (FREY),1328,7,1,8,16
11377532878,MODULO CONTROL VALVETRONIC BMW X5 545 550 645 650 SEMINUEVO GENUINO,1834,1,8,5,14
11377533904,RESORTE DE RETENCION DE ARBOL DE LEVAS BMW F20 / F30 / MINI R56 ( GENUINO ),1407,6,7,3,16
11377533904 *1,RESORTE RETENCION ARBOL LEVAS BMW N13  MINI N12 N16 N18 (FREY),1441,3,3,5,11
11377533905 *1,SERVOMOTOR SISTEMA VALVETRONIC MINI N12 N16 (FREY),1914,9,9,7,25
11377533905 *2,SERVOMOTOR SISTEMA VALVETRONIC MINI N12 N16 (EMBLER) HPS,1622,2,3,1,6
11377533905 *5,SERVOMOTOR SISTEMA VALVETRONIC MINI N12 N16 (CONTINENTAL) SSF,1739,4,7,8,19
11377541677 *1,SENSOR VALVETRONIC ARBOL EXCENTRICO SISTEMA VANOS MINI N12 N16 (FREY),1628,0,0,6,6
11377548387 *1,SERVOMOTOR SISTEMA VALVETRONIC VVT BMW N46 N46N (FREY),1837,4,0,1,5
11377548387 *2,SERVOMOTOR SISTEMA VALVETRONIC VVT BMW N46 N46N (EMBLER) HPS,1342,5,6,4,15
11377548388 *1,SERVOMOTOR SISTEMA VALVETRONIC VVT BMW MOTOR N52 N52N (FREY),1957,6,0,8,14
11377548388 *2,SERVOMOTOR SISTEMA VALVETRONIC VVT BMW N52 N52N (EMBLER) HP,1826,7,7,7,21
11377548388 *5,SERVOMOTOR SISTEMA VALVETRONIC VVT BMW N52 N52N (VDO) SSF,1950,2,3,8,13
11377548389,SERVOMOTOR VALVETRONIC SEMINUEVO BMW E53-N62 MOTOR V8 GENUINO,1376,6,5,3,14
11377548389 *1,SERVOMOTOR VALVETRONIC  BMW E53-N62 MOTOR V8 FREY,1977,8,2,1,11
11377548390,SERVOMOTOR VALVETRONIC SEMINUEVO BMW E66 GENUINO,1341,5,1,5,11
11377548390 *1,SERVOMOTOR VALVETRONIC  BMW E66 FREY,1387,1,5,9,15
11377603979 *1,SERVOMOTOR SISTEMA VALVETRONIC VTT BMW N20 N26 N55 (FREY),1271,0,0,0,0
11377603979 *5,SERVOMOTOR SISTEMA VALVETRONIC VTT BMW N20 N26 N55 (CONTINENTAL VDO) SSF,1724,1,9,3,13
11377603979-100,SERVOMOTOR SISTEMA VALVETRONIC VTT BMW N20 N26 N55 INACTIVO,1852,0,0,1,1
11377615379 *1,BALERO ARBOL ARBOL AUXILIAR SISTEMA VALVETRONIC N20 N26 N46N N52 N52N N55 N62N (FREY),1467,3,3,4,10
11377615379 *5,BALERO ARBOL ARBOL AUXILIAR SISTEMA VALVETRONIC N20 N26 N46N N52 N52N N55 N62N (GENUINO) SSF,1348,4,2,9,15
11377628303,BALANCIN (USADO) E90,1912,0,8,6,14
11377628303 *1,BALANCIN (USADO) E90 FREY,1908,9,9,5,23
11378662525 *1,JUNTA SERVOMOTOR SISTEMA VALVETRONIC VVT BMW B38 B46 B48 B58 (FREY),1974,7,6,7,20
11411706809,RESORTE DEL TENSOR DE CADENA BMW E46 / M54 ( GENUINO ),1711,9,6,7,22
11411706809-4,RESORTE DEL TENSOR DE CADENA BMW E46 / M54 FREY,1636,8,4,4,16
11411740154,BOMBA DE ACEITE BMW MOTOR M50-M52 LASO,1305,1,2,8,11
11411740154 *1,BOMBA DE ACEITE BMW E36-M50 LASO FREY,1774,6,7,5,18
11417501568,BOMBA DE ACEITE DE MOTOR BMW MOTOR M52-M54 (BAPMIC),1799,4,2,6,12
11417501568 *1,BOMBA DE ACEITE DE MOTOR BMW MOTOR M52-M54 FREY,1749,6,0,9,15
11417501568-2,BOMBA DE ACEITE DE MOTOR BMW MOTOR M52-M54 KOLB,1597,2,7,1,10
11417505842,TENSOR DE CADENA INFERIOR BMW E87 / N46 ( GENUINO ),1406,9,5,3,17
11417505842 *1,TENSOR HIDRAULICO GUIA CADENA BOMBA ACEITE MOTOR BMW N46 N46N (FREY),1838,6,3,4,13
11417508642,FILTRO ACEITE MOTOR,1262,2,6,0,8
11417545939,BOMBA DE ACEITE DE MOTOR SEMINUEVA BMW MOTOR N52-N52N GENUINA,1680,6,0,2,8
11417545939 *1,BOMBA DE ACEITE DE MOTOR BMW MOTOR N52-N52N FREY,1286,1,2,7,10
11417545939 *2,BOMBA DE ACEITE DE MOTOR BMW MOTOR N52-N52N (EMBLER) GOG,1618,2,7,4,13
11417548800 *1,RIEL GUIA CADENA BOMBA ACEITE BMW N46 N46N (FREY),1842,1,3,8,12
11417548800B,KIT DE CADENA DE BOMBA DE ACEITE BMW E87-N46 (FREY),1663,3,6,6,15
11417559947,BALANCEADORES DE BOMBA ACEITE DE MOTOR N46N,1824,2,5,5,12
11417584991 *3,VALVULA SOLENOIDE BMW X1 X3 Z4 E83 E60 (OSSCA),1750,9,7,3,19
11417605366 *1,KIT 5 PZ ENGRANES CADENA GUIA TENSOR DE BOMBA ACEITE BMW N20 N26 (FREY),1917,5,6,2,13
11417605366B,GUIA CADENA BOMBA ACEITE BMW N20 N26 (FREY),1341,4,5,7,16
11417622768 *1,VALVULA SOLENOIDE MOTOR BMW F20 F22 E90 F32 F07 F01 (FREY),1752,7,0,4,11
11417624135 *2,BOMBA ACEITE MOTOR BMW B32 B38 B38X B46 B48 B48X (EMBLER),1704,8,6,4,18
11417624135 *3,BOMBA ACEITE MOTOR BMW B32 B38 B38X B46 B48 B48X (VERMO),1759,3,3,6,12
11417639993 *1,VALVULA SOLENOIDE MOTOR BMW F20 F22 F30 F32 F10 F48 F39 F16 (FREY),1214,2,4,7,13
11417647376 *1,BOMBA ACEITE MOTOR MINI N16 N18 (FREY),1646,6,5,3,14
11420026787 *3,FILTRO ACEITE MOTOR 27 X 82 MM MINI W10 W11 (MAHLE) DGO,1222,8,3,1,12
11420026787 *5,FILTRO ACEITE MOTOR 27 X 82 MM MINI W10 W11 (MANN) SSF,1952,6,1,2,9
11420305202 *5,FILTRO ACEITE MOTOR BMW E60 E63 E70 N62N (HENGST) SSF,1312,5,7,2,14
11421709513,ORING DE BASE DE FILTRO ACEITE MOTOR BMW Z3-E36 M44 VICTOR REINZ,1588,0,6,4,10
11421709800,JUNTA DE BASE DE FILTRO ACEITE MOTOR BMW Z3-E36 M44 VICTOR REINZ,1729,1,8,5,14
11421709800 *1,JUNTA DE BASE DE FILTRO ACEITE MOTOR BMW Z3-E36 M44 FREY,1511,1,5,2,8
11421716192 *5,FILTRO ACEITE MOTOR BMW Z3 E36 M43 M44 (MAHLE) SSF,1762,8,6,7,21
11421719855 *1,JUNTA BASE FILTRO ACEITE MOTOR BMW M52 M54 (FREY),1889,7,0,5,12
11421719855 *2,JUNTA BASE FILTRO ACEITE MOTOR BMW M52 M54 (EMBLER),1577,2,0,6,8
11421730389 *5,FILTRO ACEITE MOTOR BMW M50 M52 (MANN) SSF,1451,8,0,8,16
11421744000,TAPA DE BASE DE FILTRO ACEITE MOTOR BMW E46-M54 GENUINO,1415,3,8,7,18
11421744000 *1,TAPA FILTRO ACEITE MOTOR BMW M52 M54 (FREY),1781,4,6,2,12
11422236320 *1,FILTRO ACEITE MOTOR BMW E38 M62 E39 M62 E53 M62 (FREY),1609,8,2,1,11
11422236320 *3,FILTRO ACEITE MOTOR BMW E38 M62 E39 M62 E53 M52 (MAHLE OX152/1D),1355,5,2,6,13
11422236320-1,FILTRO ACEITE MOTOR BMW E53 MANN HU938/4X,1789,3,0,7,10
11427508966 *1 ,ENFRIADOR CON TOMA FILTRO ACEITE MOTOR BMW N46 N46N (FREY),1460,2,0,9,11
11427508967,ENFRIADOR DE ACEITE DE MOTOR BMW MOTOR N46-N46N BMTR,1318,2,0,3,5
11427508967 *1,ENFRIADOR ACEITE MOTOR BMW N46 N46N (FREY),1941,4,0,7,11
11427508968 *1,TAPA CARCASA FILTRO ACEITE MOTOR BMW N46 N46N (FREY),1334,7,9,2,18
11427508969 *1,FILTRO ACEITE MOTOR BMW N46 N46N (FREY),1226,5,5,3,13
11427508969 *3,FILTRO ACEITE MOTOR BMW N13 N46 N46N (MANN HU815/2X),1854,5,8,8,21
11427508970,JUNTA DE ENFRIADOR DE ACEITE DE MOTOR BMW MOTOR N46-N46N BMTR,1903,6,4,4,14
11427508970 *1,JUNTA ENFRIADOR ACEITE MOTOR BMW N46 N46N (FREY),1471,0,9,9,18
11427508970-1,JUNTA DE ENFRIADOR DE ACEITE DE MOTOR BMW MOTOR N46-N46N ELRING,1332,9,2,6,17
11427508970-3,JUNTA DE ENFRIADOR DE ACEITE DE MOTOR BMW MOTOR N46-N46N TOPRAN,1829,7,9,9,25
11427508971,JUNTA DE BASE DE FILTRO ACEITE MOTOR BMW N46-N46N BMTR,1762,1,0,1,2
11427508971 *1,JUNTA BASE FILTRO ACEITE MOTOR BMW N46 N46N (FREY),1200,2,7,1,10
11427508971-1,JUNTA DE BASE DE FILTRO ACEITE MOTOR BMW N46-N46N ELRING,1761,6,0,5,11
11427508971-3,JUNTA DE BASE DE FILTRO ACEITE MOTOR BMW N46-N46N VIKA,1692,3,0,8,11
11427509211 *5,1 PZ.JUNTA TOMA FILTRO ACEITE MOTOR MINI W10 W11 (VICTOR REINZ) SSF,1576,6,1,8,15
11427509212 *1,ENFRIADOR ACEITE MOTOR MINI W11 SUPERCARGADO (FREY),1351,6,7,3,16
11427511161 *3,FILTRO ACEITE MOTOR BMW N62 4.4 4.8 (MAHLE OX367D),1224,4,5,9,18
11427511161-1,FILTRO ACEITE MOTOR BMW E53-M62 MANN HU715/5X,1925,4,6,2,12
11427511161-3,FILTRO ACEITE MOTOR BMW E53-M62 PERFORMACE,1342,3,6,8,17
11427512300 *1 ,FILTRO ACEITE MOTOR BMW M52 M54 (FREY),1861,9,4,4,17
11427512300 *3,FILTRO ACEITE MOTOR BMW E36-M52 (MAHLE OX68D),1703,7,9,6,22
11427512300 *6,FILTRO ACEITE MOTOR BMW M52-M54 (BOSCH) SSF,1645,7,2,9,18
11427512300 *7,FILTRO ACEITE MOTOR BMW M52-M54 (HENGST) SSF,1643,6,1,6,13
11427512300-100 ,FILTRO DE ACEITE DE MOTOR BMW MOTOR M54 INACTIVO,1279,3,2,2,7
11427525333 *1,ENFRIADOR ACEITE MOTOR BMW N52 N52N (FREY),1607,9,6,7,22
11427525333 *2,ENFRIADOR ACEITE MOTOR BMW N52 N52N (EMBLER) GOG,1784,4,9,3,16
11427525333 *5,ENFRIADOR DE ACEITE DE MOTOR BMW E90-N52 ( FEBI) SSF,1785,8,9,7,24
11427525333-100,ENFRIADOR DE ACEITE DE MOTOR BMW E90-N52 INACTIVO,1769,1,7,5,13
11427525334,TAPA DE CARCASA DE FILTRO ACEITE MOTOR BMW N55 TOPRAN,1851,9,8,6,23
11427525334 *1,TAPA FILTRO ACEITE MOTOR BMW N20 N52 N54 N55 (FREY),1476,7,1,2,10
11427542021 *1,FILTRO ACEITE MOTOR BMW E60 E63 E70 N62N (FREY),1281,0,8,3,11
11427542021 *3,FILTRO ACEITE MOTOR BMW E60 E63 E70 N62N (MAHLE OX636D),1844,2,2,7,11
11427552687,ENFRIADOR DE ACEITE DE MOTOR MINI R56-N14 NISSENS,1429,0,9,3,12
11427552687 *1,ENFRIADOR ACEITE MOTOR MINI TURBO N14 N18 (FREY),1800,8,6,7,21
11427571-100,KIT JUNTAS DE BASE DE FILTRO ACEITE BMW MOTOR INACTIVO,1837,1,9,7,17
11427583220 *1,FILTRO ACEITE MOTOR BMW F10 G30 N63 F06 N63 E70 71 F15 F16 N63 G07 N63 (FREY),1742,3,1,2,6
11427583220 *3,FILTRO ACEITE MOTOR BMW E70 (MAHLE OX353/7D),1309,6,9,9,24
11427583220 *5 ,FILTRO ACEITE MOTOR BMW F10 G30 N63 F06 N63 E70 71 F15 F16 N63 G07 N63 (HENGST) SSF,1795,6,8,1,15
11427615389 *1,TAPA FILTRO ACEITE MOTOR BMW N63 N63N (FREY),1769,1,8,5,14
11427617537 *1,TUBO ALIMENTACION ACEITE TURBO BMW F20 F22 F30 F32 F48 F39 (FREY),1757,0,3,3,6
11427619319 *3,FILTRO ACEITE MOTOR BMW N13-N46-N46N (MAHLE OX166/1D),1771,2,8,7,17
11427622446 *1,FILTRO ACEITE MOTOR 65 X69 MM MINI N12 N14 N16 N18 (FREY),1543,7,4,2,13
11427622446 *3,FILTRO ACEITE MOTOR 65 X 69 MM MINI N12 N14 N16 N18 (MAHLE) DGO,1214,9,2,3,14
11427622446 *5,FILTRO ACEITE MOTOR 65 X 69 MM MINI N12 N14 N16 N18 (MANN) SSF,1770,3,1,5,9
11427625484,JUNTA DE FILTRO ACEITE MOTOR BMW F20-N13 ELRING,1384,9,2,6,17
11427625484 *1,JUNTA EMPAQUE BASE FILTRO ACIETE MOTOR BMW N13 (FREY),1552,2,6,5,13
11427625485 *1,JUNTA EMPAQUE BASE FILTRO ACEITE MOTOR BMW N13 (FREY),1993,0,2,5,7
11427625486,MONTAJE DE MOTOR N13,1666,9,1,0,10
11427625487 *1,JUNTAS ENFRIADOR ACEITE MOTOR BMW BMW N13 (FREY),1246,2,2,8,12
11427625489 *1,ENFRIADOR ACEITE MOTOR BMW N13 (FREY),1516,8,2,0,10
11427634291 *1,FILTRO ACEITE MOTOR 78X75X41 MM BMW N20 N26 N55 (FREY),1903,0,2,1,3
11427635557 *1,FILTRO ACEITE MOTOR BMW N13 (FREY),1825,8,7,8,23
11427635557 *3,FILTRO ACEITE MOTOR BMW N13 (MAHLE OX825D),1777,3,8,8,19
1142764086-100,FILTRO DE ACEITE DE MOTOR BMW MOTOR N20 INACTIVO,1279,6,0,2,8
11427640862 *5,FILTRO ACEITE MOTOR 78X75X41 MM BMW N20 N26 N55 (HENGST) SSF,1988,1,7,0,8
11427640862 *6,FILTRO ACEITE MOTOR 78X75X41 MM BMW N20 N26 N55 (MANN) SSF,1453,5,7,9,21
11427719357-100,FILTRO ACEITE MOTOR BMW MOTOCICLETA K70 K71 K72 INACTIVO,1855,4,7,5,16
11427788460 *3,FILTRO ACEITE MOTOR MINI COOPER E60-M57N2 (MAHLE OX177/3D),1965,5,3,8,16
11427805977 *1,ENFRIADOR ACEITE MOTOR DIESEL MINI W16 (FREY),1265,9,8,0,17
11427826799 *5,FILTRO ACEITE MOTOR BMW F20 F30 F32 G14 G29 G30 B58 (FEBI ALEMAN) SSF,1571,6,2,9,17
11427826799 *6,FILTRO ACEITE MOTOR BMW F20 F30 F32 G14 G29 G30 B58 (MANN ALEMAN) SSF,1373,1,3,9,13
11427833769 *3,FILTRO ACEITE MOTOR BMW E84 (MAHLE OX187D),1804,3,3,8,14
11427840594 *3,FILTRO ACEITE MOTOR BMW E60-N52 (MAHLE OX254D4),1458,9,8,9,26
11427953125 *3,FILTRO ACEITE MOTOR 78X75X41 MM BMW N20 N26 N55 (MAHLE) DGO,1889,8,1,3,12
11427953129 *1,FILTRO ACEITE MOTOR 79X74X41 MM BMW N20 N26 N52 N52N N54 N55 (FREY),1242,9,5,9,23
11427953129 *3,FILTRO ACEITE MOTOR 79X74X41 MM BMW N20 N26 N52 N52N N54 N55 (MAHLE) DGO,1248,7,8,7,22
11427953129 *5,FILTRO ACEITE MOTOR 79X74X41 MM BMW N20 N26 N52 N52N N54 N55  (MANN HU816X) SSF,1676,6,9,8,23
11427953129 *6,FILTRO ACEITE MOTOR 79X74X41 MM BMW N20 N26 N52 N52N N54 N55 (BOSCH) SSF,1685,9,6,6,21
11428516396 *1,JUNTA ENFRIADOR ACEITE MOTOR DIESEL BMW N47N (FREY),1948,8,2,1,11
11428570590 *1,FILTRO ACEITE MOTOR BMW B36 B38 B42 B46 B48 MINI B36 B38 B46 B48 (FREY),1304,1,9,2,12
11428570590 *3,FILTRO ACEITE MOTOR BMW B36 B38 B42 B46 B48 MINI B36 B38 B46 B48 (MAHLE) DGO,1373,9,2,2,13
11428570590 *5,FILTRO ACEITE MOTOR BMW B36 B38 B42 B46 B48 MINI B36 B38 B46 B48 (MANN) SSF,1484,3,7,8,18
11428575211 *1,FILTRO ACEITE MOTOR BMW B38 B46 B48 (FREY),1947,7,8,0,15
11428575211 *3,FILTRO ACEITE MOTOR BMW B38 B46 B48 (MAHLE OX813/2D),1641,7,1,8,16
11428575211 *5,FILTRO ACEITE MOTOR BMW B38 B46 B48 (MANN HU6014/1Z) SSF,1877,3,5,5,13
11428575899 *1,KIT 3 PZ EMPAQUES LIGA BASE FILTRO ACEITE MOTOR BMW B38 (FREY),1481,4,5,4,13
11428580414 *1,ENFRIADOR CON TOMA ACEITE MOTOR BMW G01 G02 G05 G06 G11 G12 G20 G21 G29 G30 G31 (FREY),1571,2,9,8,19
11428583898 *1,FILTRO ACEITE MOTOR BMW F20 F30 F32 G14 G29 G30 B58 (FREY TEGNOLOGIA ALEMANA),1531,0,9,2,11
11428585235,TOMA ACEITE MOTOR CON ENFRIADOR BMW F39 F45 F46 F56 B32 B38 B36 B42 B46 B48 (EMBLER),1684,9,5,6,20
11428585235 *1,TOMA ACEITE MOTOR CON ENFRIADOR BMW F39 F45 F46 F56 B32 B38 B36 B42 B46 B48 (FREY),1776,6,5,8,19
11428585235 *2,CAJA DE FILTRO DE ACEITE BMW F46 F48 I12 I15 MOTOR B48 EMBLER,1778,0,0,5,5
11428585236 *1,ENFRIADOR ACEITE MOTOR BMW B32 B36 B42 B46 B48 MINI B36 B38 B46 B48 (FREY),1844,1,3,7,11
11428585236 *3,ENFRIADOR ACEITE MOTOR BMW B32 B36 B42 B46 B48 MINI B36 B38 B46 B48 (GENUINO),1748,2,1,3,6
11428585624 *1 ,ENFRIADOR ACEITE MOTOR BMW F20 F22 F30 G20 F32 G30 G32 G11 G07 G02 B38 B46 B48 (FREY),1407,4,2,7,13
11428591460,LIGAS DE BASE DE FILTRO MINI COOPER F56-B38 ELRING,1730,1,5,3,9
11428591460-1,LIGAS DE BASE DE FILTRO MINI COOPER F56-B38 EMBLER,1215,6,5,5,16
11428591461 *1,KIT 4 PZ JUNTAS ENFRIADOR TOMA FILTRO ACEITE MOTOR MINI F54 A F57 BMW F39 F45 F48 B42 B46 B48 (FREY),1425,3,2,1,6
11428593186 *1,FILTRO ACEITE MOTOR BMW B38C B48C B46D B48D B48E MINI B36C B46C B38C B48C (FREY),1465,7,7,2,16
11428593186 *6,FILTRO ACEITE MOTOR BMW B38C B48C B46D B48D B48E MINI B36C B46C B38C B48C (FEBI) SSF,1701,6,2,7,15
11428596283 *1,BASE FILTRO ACEITE MOTOR CON ENFRIADOR MINI B38 BMW B38 B46 B48 (FREY),1855,2,5,8,15
11428596283B,BASE FILTRO ACEITE MOTOR CON ENFRIADOR BMW F20 G38 F25 F10 (FREY),1675,8,0,5,13
11428637812,BASE DE FILTRO DE ACEITE DE MOTOR BMW F30-N20 GENUINO,1447,0,0,9,9
11428637812 *1,BASE FILTRO ACEITE MOTOR BMW E84 E89 F25 F30 F10 N20 F06 F25 F26 N55 (FREY),1994,9,2,3,14
11428637820 *1,JUNTA ENFRIADOR ACEITE MOTOR BMW N20 N52 N52N N54 N55 (FREY),1223,3,3,6,12
11428637820 *5,JUNTA ENFRIADOR ACEITE MOTOR BMW N20 N52 N52N N54 N55 (VICTOR REINZ) SSF,1657,8,4,5,17
11428637820-9,JUNTA DE ENFRIADOR ACEITE MOTOR BMW MOTOR N52N-N52-N55-N54-N20 BMTRS,1862,1,7,9,17
11428637821 *1,JUNTA TOMA ACEITE MOTOR BMW N52 N52N N54 (FREY),1287,2,6,2,10
11428637821-1,JUNTA DE TOMA DE ACEITE DE MOTOR BMW MOTOR N52-N52N-N54 VICTOR REINZ,1396,8,1,4,13
11428637821-3,JUNTA DE TOMA DE ACEITE DE MOTOR BMW MOTOR N52-N52N-N54 AJUSA,1682,2,9,6,17
11428637821-4,JUNTA DE TOMA DE ACEITE DE MOTOR BMW MOTOR N52-N52N-N54 ( EMBLER ),1536,5,3,3,11
11428637821-9,JUNTA DE TOMA DE ACEITE DE MOTOR BMW MOTOR N52-N52N-N54 BMTRS,1532,5,7,4,16
11428643747 *1,KIT JUNTAS ENFRIADOR ACEITE MOTOR MINI N14 N18 (FREY),1251,3,1,0,4
11428643747 *5,KIT 4 PZ. JUNTAS ENFRIADOR ACEITE MOTOR MINI N14 N18 (ELRING) SSF,1700,9,1,0,10
11428643757 *1,BASE FILTRO ACEITE MOTOR MINI R55 R56 R57 R58 R59 R60 R61 (FREY),1485,4,1,1,6
11428643758 *1,KIT 2 PZ JUNTAS TOMA FILTRO ACEITE MOTOR MINI N12 N14 N16 N18 (FREY),1320,9,4,3,16
11428643758 *5,KIT 2 PZ JUNTAS TOMA FILTRO ACEITE MOTOR MINI N12 N14 N16 N18 (AJUSA) SSF,1414,2,1,7,10
11428643758 *6,KIT 2 PZ JUNTAS TOMA FILTRO ACEITE MOTOR MINI N12 N14 N16 N18 (ELRING KLINGER) SSF,1776,6,0,3,9
11428643758-1,JUEGO DE JUNTAS DE BASE DE FILTRO DE ACEITE MINI MOTOR N12-N14-N16 4CIL ELRING,1990,2,1,9,12
11428643762 *1,BASE FILTRO ACEITE MOTOR MINI R56 R57 (FREY),1600,3,5,0,8
11428649177 *1,ENFRIADOR CON TOMA ACEITE MOTOR BMW B36C B38B B38C B46C B46D B48C B48D (FREY),1736,1,3,4,8
11428649177 *3,ENFRIADOR CON TOMA ACEITE MOTOR BMW B36C B38B B38C B46C B46D B48C B48D (OEM),1992,6,2,5,13
11428678840 *1,MANGUERA ENFRIAMIENTO TURBO COMPRESOR BMW F07 F10 F18 F25 F35 (FREY),1340,4,2,0,6
11428683206 *1,TOMA FILTRO ACEITE MOTOR CON ENFRIADOR BMW N20 N26 N52N N54 N55 (FREY),1753,0,6,2,8
11429063138 *3,FILTRO ACEITE MOTOR BMW MOTOR M30 (MAHLE OX41D),1484,6,4,0,10
11437509784 *5,BARRILLA BALLONETA DE ACEITE MOTOR MINI W11 (URO) SSF,1960,1,3,3,7
11437527133 *1,TUBO DE ACEITE RETORNO DEL CARTER BMW E90-N52 FREY,1468,0,7,0,7
11437527133 *5,TUBO DE ACEITE RETORNO DEL CARTER BMW E90-N52 (GENUINO) SSF,1438,5,7,2,14
11437600470 *3,BAYONETA NIVEL ACEITE MOTOR BMW F20 F21 F30 F31 (VERMO),1647,3,1,4,8
11510007043 *1,BOMBA AGUA ENFRIAMIENTO MOTOR BMW E38 M60 (FREY),1584,1,3,7,11
11510007043 *2,BOMBA ENFRIAMIENTO MOTOR BMW E38 M60 (BMTSR),1560,8,3,9,20
11510392553,JUEGO DE TORNILLOS DE BOMBA DE AGUA BMW E90,1992,7,6,8,21
11510392553 *1,JUEGO TORNILLOS BOMBA AGUA ENFRIAMIENTO MOTOR BMW N52N (FREY),1421,0,4,2,6
11510393340 *1,BOMBA AGUA MECANICA ENFRIAMIENTO MOTOR BMW M62 8 CIL (FREY),1358,2,6,9,17
11511436590 *1,POLEA BOMBA AGUA MECANICA BMW M52 M54 (FREY),1714,5,9,0,14
11511436590-1,POLEA DE BOMBA DE AGUA MECANICA BMW M52 M54 ( FEBI ),1558,9,2,5,16
11511436590-4,POLEA DE BOMBA DE AGUA MECANICA BMW M52 M54 ( URO ),1973,3,6,0,9
11511439976,TUBO DE AGUA RECTO BMW E60-E65-E70 FEBI,1559,3,6,0,9
11511439976 *1,TUBO DE AGUA RECTO BMW E60-E65-E70 FREY,1899,3,3,3,9
11511490591 *1,BOMBA AGUA MECANICA ENFRIAMIENTO MOTOR MINI R53-W11 (FREY),1719,3,3,7,13
11511490591 *3,BOMBA AGUA MECANICA ENFRIAMIENTO MOTOR MINI R53-W11 (ISU ITALY),1921,1,1,1,3
11511721872 *1,BOMBA AGUA ENFRIAMIENTO MOTOR BMW M44 (FREY),1806,5,4,3,12
11511739527,POLEA DE BOMBA DE AGUA BMW N44 ( URO ),1464,6,7,4,17
11511739527 *1,POLEA DE BOMBA DE AGUA 123 MM BMW M43  ( FREY ),1411,0,5,7,12
11511739527-2,POLEA DE BOMBA DE AGUA BMW N44 ( DORMAN ),1537,9,6,8,23
11511742045,POLEA DE BOMBA AGUA MECANICA 112 MM BMW M62 ( FEBI ),1221,8,0,7,15
11511742045 *1,POLEA DE BOMBA AGUA MECANICA 112 MM BMW M62 ( FREY ),1709,2,6,1,9
11511742045-1,POLEA DE BOMBA AGUA MECANICA 112 MM BMW M62 ( URO ),1836,0,8,8,16
11517504077 *1,POLEA BOMBA AGUA ENFRIAMIENTO MOTOR BMW N62 N62N (FREY),1758,3,4,7,14
11517504077-2,POLEA DE BOMBA DE AGUA MECANICA BMW N62 N62N ( EMBLER ),1721,1,6,7,14
11517509170 *5,COPLE BOMBA AGUA ENFRIAMIENTO MOTOR MONOBLOCK COOPER R52 R53 W11 (URO) SSF,1426,8,3,4,15
11517511221 *1,BOMBA AGUA ENFRIAMIENTO MOTOR BMW N46 N46N (FREY),1535,1,6,2,9
11517513062 *1,COMPLETA BOMBA AGUA ENFRIAMIENTO CON POLEA MINI R50 R52 W10 (FREY),1832,0,6,0,6
11517515778-1,BOMBA AGUA MECANICA ENFRIAMIENTO MOTOR BMW E87 N46N (GRAF),1494,3,5,3,11
11517524552,BOMBA AGUA ENFRIAMIENTO MOTOR BMW N62 N62N (BMTR),1746,3,7,6,16
11517527799 *1,BOMBA AGUA ENFRIAMIENTO MOTOR BMW M52 M54 (FREY),1929,8,6,0,14
11517527910 *5,BOMBA AGUA ENFRIAMIENTO MOTOR BMW M52 M54 (SALERI),1717,8,8,0,16
11517548263 *1,BOMBA AGUA ENFRIAMIENTO MOTOR BMW N63 N63N (FREY),1504,2,2,1,5
11517548263 *2,BOMBA AGUA MECANICA ENFRIAMiENTO MOTOR BMW N63 N63N S63 (EMBLER),1927,4,6,6,16
11517550484 *1,BOMBA AGUA MECANICA ENFRIAMIENTO MOTOR MINI N12 N14 N16 N18 (FREY),1717,4,5,1,10
11517550484 *2,BOMBA AGUA MECANICA ENFRIAMIENTO MOTOR MINI N12 N14 N16 N18 (EMBLER) HT,1223,5,3,9,17
11517566335 *1,BOMBA AGUA AUXILIAR ELECTRICA ENFRIAMIENTO MOTOR BMW E70 S63 (FREY),1584,1,2,8,11
11517566335 *5,BOMBA AGUA AUXILIAR ELECTRICA ENFRIAMIENTO MOTOR BMW E70 S63 (PIERBURG) SSF,1608,3,8,6,17
11517566335-100,BOMBA AGUA AUXILIAR ELECTRICA ENFRIAMIENTO MOTOR BMW E70 S63 INACTIVO,1819,8,5,5,18
11517572859 *1,TOMA DE AGUA CAJA TERMOSTATO BMW E87 N46N ( FREY ),1204,8,0,6,14
11517572859 *5,TOMA DE AGUA CAJA TERMOSTATO BMW E87 N46N ( TOPRAN ),1458,7,0,0,7
11517583836 *1,BOMBA AGUA ELECTRICA ENFRIAMIENTO MOTOR BMW F10 F01 F25 N52N (FREY),1500,4,4,0,8
11517583836 *2,BOMBA AGUA ELECTRICA ENFRIAMIENTO MOTOR BMW F10 F01 F25 N52N (EMBLER) HT,1213,4,4,9,17
11517586780 *1,BOMBA AGUA ENFRIAMIENTO MOTOR BMW N62 N62N (FREY),1841,9,0,0,9
11517586925 *1,BOMBA AGUA ELECTRICA ENFRIAMIENTO MOTOR BMW N52 N52N (FREY),1506,6,9,8,23
11517586925 *2,BOMBA AGUA ELECTRICA ENFRIAMIENTO MOTOR BMW N52 N52N (EMBLER) HT,1601,2,2,3,7
11517586925 *5,BOMBA AGUA ELECTRICA ENFRIAMIENTO MOTOR BMW N52 N52N (PIERBURG) SSF,1373,7,2,4,13
11517588885-100,BOMBA AGUA ELECTRICA ENFRIAMIENTO MOTOR BMW N54 N55 INACTIVO,1917,9,9,8,26
11517588885-3,BOMBA AGUA ELECTRICA ENFRIAMIENTO MOTOR BMW N54 N55 BMTRS ALEMANA,1693,5,5,5,15
11517597715 *1,BOMBA AGUA ELECTRICA ENFRIAMIENTO MOTOR MODELO SALERI BMW N20 (FREY),1769,1,1,2,4
11517597715 *2,BOMBA AGUA ELECTRICA ENFRIAMIENTO MOTOR MODELO SALERI BMW N20 (EMBLER) HT,1876,2,2,6,10
11517597715 *5,BOMBA AGUA ELECTRICA ENFRIAMIENTO MOTOR BMW N20 (ORIGINAL SALERI) SSF,1375,6,3,5,14
11517604027 *2,BOMBA AGUA ELECTRICA ENFRIAMIENTO MOTOR MODELO PIERBURG CONTECTOR CUADRADO BMW N20 (EMBLER) HT,1252,5,8,1,14
11517604027-100,BOMBA DE AGUA ELECTRICA SEMINUEVA BMW F30-N20 PIERBURG INACTIVO,1976,4,7,8,19
11517619020 *1,POLEA VULCANIZADA BOMBA AGUA PEUGEOT 208 MINI N12 N13 N14 N16 N18 (FREY),1815,6,5,0,11
11517619020 *2,POLEA DE BOMBA AGUA MINI BMW N12 N13 N14 N16 N18 (EMBLER),1306,1,4,4,9
11517619020-100,POLEA DE BOMBA AGUA MINI BMW N12 N13 N14 N16 N18 ( HAMBURG TECHNIC ) INACTIVO,1830,5,4,7,16
11517629916,BOMBA AGUA AUXILIAR ELECTRICA ENFRIAMIENTO MOTOR TURBOCARGADOR BMW E70-F15 N63 (PIERBURG),1771,0,9,5,14
11517629916 *1,BOMBA AGUA AUXILIAR ELECTRICA ENFIRAMIENTO MOTOR TURBOCARGADOR BMW E70-E71 N62N-N63 (FREY),1918,8,6,3,17
11517629916-2,BOMBA AGUA AUXILIAR ELECTRICA ENFRIAMIENTO MOTOR TURBOCARGADOR BMW E70-E71 N62N-N63 (KOLBENSCHMIDT),1319,2,6,3,11
11517632426 *1,BOMBA AGUA ELECTRICA ENFRIAMIENTO MOTOR BMW N54 N55 TURBO (FREY),1652,9,5,5,19
11517632426 *2,BOMBA AGUA ELECTRICA ENFRIAMIENTO MOTOR BMW N54 N55 TURBO (EMBLER) HT,1563,0,9,5,14
11517632426 *5,BOMBA AGUA ELECTRICA ENFRIAMIENTO MOTOR BMW N54 N55 (ORIGINAL PIERBURG) SSF,1528,0,8,3,11
11517648827-100,BOMBA AGUA MECANICA ENFRIAMIENTO MOTOR MINI R56-N14 INACTIVO,1958,3,2,3,8
11517829913 *5 ,MANGUERA DOBLE MEDIDA ENFRIAMIENTO BOMBA AGUA A MONOBLOCK 85MM MIMI R50 R52 W10 (REIN) SSF,1200,1,9,6,16
11517850568,BOMBA AUXILIAR BMW F82 S55 BOSCH,1308,4,9,4,17
11518482250 *1,BOMBA AGUA ENFRIAMIENTO MOTOR BMW G20 G30 G11 G01 G02 G05 G29 (FREY),1825,2,6,9,17
11518482251 *1,BOMBA AGUA ENFRIAMIENTO MOTOR BMW G01 G02 G05-G07 G11-G16 G20 G21 G29-G32 (FREY),1452,6,0,0,6
11518601366B,KIT 3 PZ EMPAQUES LIGAS BOMBA AGUA TOMA MONOBLOCK MINI B38 B48 BMW B38 B48 (FREY),1244,1,6,6,13
11518616992 *1,BOMBA AGUA AUXILIAR ELECTRICA ENFRIAMIENTO MOTOR BMW F20 F30 N13 (FREY),1781,0,1,7,8
11518623574 *1,BOMBA AGUA ENFRIAMIENTO MOTOR BMW MINI B32 B36 B38 B46 B48 (FREY),1419,3,7,0,10
11518623574-1,BOMBA AGUA MECANICA ENFRIAMIENTO MOTOR BMW F20 X3 (HELLA),1527,0,8,7,15
11518623576 *1,TERMOSTATO ENRIAMIENTO MOTOR BMW F39 F45 F46 F48 MINI F54-F57 F60 (FREY),1700,7,8,8,23
11518631692 *1,BOMBA AGUA ENFRIAMIENTO MOTOR BMW B38 (FREY),1910,9,4,0,13
11518631692B,JUNTAS BOMBA AGUA ENFRIAMIENTO MOTOR BMW B38 (FREY),1486,9,9,6,24
11518632585 *1 ,BOMBA AGUA ENFRIAMIENTO MOTOR BMW B58 (FREY),1462,9,9,1,19
11518635089 *1,BOMBA AGUA ELECTRICA ENFRIAMIENTO MOTOR MODELO PIERBURG CONECTOR CUADRADO BMW N20 (FREY),1204,7,7,0,14
11518635090 *1,BOMBA AGUA ELECTRICA ENFRIAMIENTO MOTOR MODELO PIERBURG CONECTOR CUANDRADO BMW F30 N55 (FREY),1774,3,2,2,7
11518635090 *2,BOMBA AGUA ELECTRICA ENFRIAMIENTO MOTOR MODELO PIERBURG CONECTOR CUANDRADO BMW F30 N55 (EMBLER) HT,1328,7,6,3,16
11518635090 *5,BOMBA AGUA ELECTRICA ENFRIAMIENTO MOTOR MODELO PIERBURG CONECTOR CUANDRADO BMW F30 N55 (PIERBURG) SSF,1205,2,6,2,10
11518638026 *1,COMPLETA BOMBA AGUA ENFRIAMIENTO MOTOR BMW B48 (FREY),1659,4,4,7,15
11518638026B,REPUESTO BOMBA AGUA ENFRIAMIENTO MOTOR BMW B48 (FREY),1631,9,0,9,18
11518678905 *1,BOMBA AGUA ENFRIAMIENTO MOTOR BMW MINI B36 B38 B46 B48 (FREY),1922,8,7,0,15
11521466000 *1,FAN CLUTCH ENFRIAMIENTO MOTOR 4 TORNILLOS BMW M42 (FREY),1541,2,8,9,19
11521466000-100,FAN CLUTCH ENFRIAMIENTO MOTOR 4 TORNILLOS BMW M42 (BEHR) INACTIVO,1215,6,9,6,21
11521712058,ASPAS DE VENTILADOR MECANICO BMW E46-M54 FEBI,1208,2,7,0,9
11521712058 *1,ASPAS VENTILADOR MECANICO ENFRIAMIENTO MOTOR BMW E46 M54 (FREY),1887,6,7,9,22
11521712058-100,ASPAS DE VENTILADOR MECANICO BMW E46-M54 BEMQW INACTIVO,1309,1,5,4,10
11521723363 *1,ASPAS VENTILADOR 4 TORNILLOS ENFRIAMIENTO MOTOR 410 MM BMW M43 M52 (FREY),1923,2,0,8,10
11521740962 *1,FAN CLUTCH ENFRIAMIENTO MOTOR 4 TORNILLOS BMW M43 M44 M50 M52 (FREY),1239,2,7,9,18
11527505302 *1,FAN CLUTCH ENFRIAMIENTO MOTOR 3 TORNILLOS BMW MOTOR M54 (FREY),1294,4,7,4,15
11527505302-1,FAN CLUTCH DE 3 TORNILLOS BMW E46-M54 BEHR,1470,9,5,1,15
11527505302-100,FAN CLUTCH DE 3 TORNILLOS BMW E46-M54 BMTR INACTIVO,1977,4,5,0,9
11531265084,ORING DE TERMOSTATO BMW E36 / M52 ( DPH ),1760,0,1,7,8
11531436386 *1,TERMOSTATO ENFRIAMIENTO MOTOR 4 TORNILLOS BMW M62 8 CIL (FREY),1840,6,6,0,12
11531436407,MANGUERA DE RADIDOR M43  FREY,1638,9,9,3,21
11531436408,MANGUERA INFERIOR DE RADIADOR BMW E46 MEISTERSATZ,1673,3,5,7,15
11531436408 *1,MANGUERA INFERIOR DE RADIADOR BMW E36 FREY,1554,3,3,7,13
11531436408-1,MANGUERA INFERIOR DE RADIADOR BMW E36 EMBLER,1594,1,4,2,7
11531436409 *1,MANGUERA SUPERIOR (R) RADIADOR ENFRIAMIENTO MOTOR BMW E46 M43 (FREY),1280,7,3,1,11
11531436410,MANGUERA FLEXIBLE DE RETORNO DE CALEFACCION BMW E46-M54 REIN,1399,8,6,3,17
11531436410 *1,MANGUERA FLEXIBLE DE RETORNO DE CALEFACCION BMW E46-M54 FREY,1717,5,7,0,12
11531436410-2,MANGUERA FLEXIBLE DE RETORNO DE CALEFACCION BMW E46-M54 EMBLER,1513,2,3,6,11
11531436988,MANGUERA DE RADIADOR INFERIOR BMW Z3-E36 GATES,1780,3,1,9,13
11531436988 *1,MANGUERA DE RADIADOR INFERIOR BMW Z3-E36 FREY,1457,1,6,8,15
11531437040 *1,TERMOSTATO ENFRIAMIENTO MOTOR BMW M52 M54 (FREY),1889,6,3,6,15
11531437526,TERMOSTATO DE MOTOR BMW E53 / M62 ( MAHLE 1205 ),1751,8,8,8,24
11531437526-100,TERMOSTATO DE MOTOR BMW E53 / M62 INACTIVO,1828,4,5,8,17
11531486703 *5,TAPON ANTICONGELANTE RADIADOR ENFRIAMIENTO MOTOR 1.1 BARES MINI R50 R52 W10 (FEBI) SSF,1269,5,3,1,9
11531486703 *6,TAPON ANTICONGELANTE RADIADOR ENFRIAMIENTO MOTOR 1.1 BARES MINI R50 R52 W10 (URO) SSF,1329,2,6,6,14
11531705210 *1,TUBO AGUA RECTO ENFRIAMIENTO MONOBLOCK A CALEFACCION BMW E36 E38 E39 E46 E85 M52 M54 (FREY),1374,1,0,9,10
11531705210 *2,TUBO AGUA RECTO ENFRIAMIENTO MONOBLOCK A CALEFACCION BMW E36 E38 E39 E46 E85 M52 M54 (EMBLER) GOG,1378,0,6,2,8
11531705210-1,TUBO DE AGUA CALEFACCION RECTO BMW M52 M54 ( FEBI ),1388,4,8,0,12
11531705210-3,TUBO DE AGUA CALEFACCION RECTO BMW M52 M54 ( TOPRAN ),1827,3,4,6,13
11531705210-5,TUBO DE AGUA CALEFACCION RECTO BMW M52 M54 ( MEISTERSATZ ),1366,7,6,7,20
11531705223,MANGUERA SUPERIOR RADIADOR BMW E39-M52 BMTR,1647,0,8,3,11
11531705223 *1,MANGUERA SUPERIOR RADIADOR DE BMW E39 / M52 FREY,1967,2,3,4,9
11531705223-1,MANGUERA SUPERIOR RADIADOR DE BMW E39 / M52 ( FEBI ),1334,9,6,5,20
11531705224,MANGUERA INFERIOR DE RADIADOR BMW E39-M54 FEBI,1931,9,6,4,19
11531705224 *1,MANGUERA INFERIOR DE RADIADOR BMW E39-M54 FREY,1527,9,2,4,15
11531705224 *2,MANGUERA INFERIOR DE RADIADOR BMW E39-M54 (EMBLER),1827,9,1,1,11
11531708499,MANGUERA SUPERIOR DE RADIADOR BMW E36-Z3 FEBI,1935,2,6,3,11
11531708499 *1,MANGUERA SUPERIOR DE RADIADOR BMW E36-Z3 FREY,1854,1,6,5,12
11531711381 *1,TUBO FLEXIBLE DE AGUA BMW M62,1368,1,9,9,19
11531711384 *1,MANGUERA DE RADIADOR M62 (FREY),1526,8,8,4,20
11531714738 *1,TUBO DE AGUA RECTO MONOBLOCK-CALEFACCION BMW E36 FREY,1524,6,3,2,11
11531714738 *5,TOMA AGUA ENFRIAMIENTO MONOBLOCK A CALEFACCION BMW E36 Z3 M43 M44 (FEBI) SSF,1539,2,6,6,14
11531714738-2,TUBO DE AGUA RECTO MONOBLOCK-CALEFACCION BMW E36 URO,1787,6,8,2,16
11531722531,TOMA DE AGUA SIN TERMOSTATO E36-Z3 FEBI,1902,9,4,5,18
11531722531 *1,TOMA DE AGUA SIN TERMOSTATO BMW E36 FREY,1580,5,8,3,16
11531722531-1,TOMA DE AGUA SIN TERMOSTATO BMW E36 BMTR,1471,4,9,7,20
11531726344,MANGUERA INFERIOR DE RADIADORBMW E36-M52,1230,6,4,1,11
11531726344-1,MANGUERA INFERIOR DE RADIADOR BMW E36-M52 FREY,1528,1,9,2,12
11531727448,MANGUERA SUPERIOR DE RADIADOR BMW E36 BMTR,1826,1,3,8,12
11531727448 *1,MANGUERA SUPERIOR DE RADIADOR BMW E36 (FREY),1264,8,3,2,13
11531730928,MANGUERA INFERIOR DE RADIADOR BME E36-M52 BMTR,1756,0,7,4,11
11531730928 *1,MANGUERA INFERIOR DE RADIADOR BME E36-M52 FREY,1935,3,6,8,17
11531739208 *1,TUBO Y GRIEGA DE AGUA BMW E36-Z3 FREY,1436,5,9,8,22
11531739755,TERMOSTATO DE MOTOR BMW Z3-E36 1.6L BMTR,1689,6,4,7,17
11531739755 *1,TERMOSTATO DE MOTOR BMW Z3-E36 1.6L FREY,1938,6,0,9,15
11531740437,JUNTA DE CAJA DE TERMOSTATO BMW E36-M52,1412,0,6,7,13
11531740437 *1,JUNTA DE CAJA DE TERMOSTATO BMW E36-M52 FREY,1596,5,4,5,14
11531740478,TOMA DE AGUA DE BMW E39 / M52 ( BMTR ),1882,1,6,8,15
11531740478 *1,TOMA DE AGUA DE BMW E39 / M52 ( FREY ),1688,9,4,9,22
11531740481,MANGUERA INFERIOR DE RADIADOR BMW E39-M52 URO,1882,2,7,3,12
11531740481 *1,MANGUERA INFERIOR DE RADIADOR BMW E39-M52 FREY,1640,8,7,9,24
11531740832,MANGUERA SUPERIOR DE RADIADOR BMW E39-M52 URO,1651,2,4,1,7
11531740832 *1,MANGUERA SUPERIOR DE RADIADOR BMW E39-M52 FREY,1926,4,8,7,19
11531743017 *1,TERMOSTATO DE MOTOR BMW E36-Z3 M44 FREY,1409,5,4,4,13
11531743679,TUBO Y GRIEGA DE AGUA BMW E36-Z3 FEBI,1414,0,4,8,12
11532394968,TERMOSTATO DE MOTOR BMW MOTOR N55 GENUINO,1529,9,1,4,14
11533400205 *1,MANGUERA DEPOSITO ANTICONGELANTE A TUBO CALEFACCION BMW E83 M54 (FREY),1468,2,6,1,9
11533400207,MANGUERA SUPERIOR DE RADIADOR BMW E83-M54 REIN,1574,9,8,9,26
11533400207 *1,MANGUERA SUPERIOR RADIADOR BMW E83 M54 (FREY),1585,1,3,6,10
11533400207-1,MANGUERA SUPERIOR DE RADIADOR BMW E83-M54 MEISTERSATZ,1644,4,9,5,18
11533400207-3,MANGUERA SUPERIOR DE RADIADOR BMW E83-M54 OSCCA,1465,3,2,0,5
11533400207-4,MANGUERA SUPERIOR DE RADIADOR BMW E83-M54 KZR,1279,3,9,8,20
11537500733,MANGUERA SUPERIOR DE RADIADOR BMW E53-M54 FEBI,1492,2,1,1,4
11537500733 *1,MANGUERA SUPERIOR DE RADIADOR BMW E53-M54 FREY,1798,1,3,0,4
11537500733-1,MANGUERA SUPERIOR DE RADIADOR BMW E53-M54 BMTR,1949,8,0,6,14
11537500733-3,MANGUERA SUPERIOR DE RADIADOR BMW E53-M54 MEISTERSATZ,1254,8,6,0,14
11537500735,MANGUERA DE AGUA DEPOSITO/BOMBA DE AGUA BMW E53-M54 REIN,1277,1,9,9,19
11537500735 *1,MANGUERA DE AGUA DEPOSITO/BOMBA DE AGUA BMW E53-M54 FREY,1681,3,8,3,14
11537500735-2,MANGUERA DE AGUA DEPOSITO/ BOMBA DE AGUA BMW E53-M54 BMTSR,1979,0,0,8,8
11537500746 *1,MANGUERA SUPERIOR RADIADOR ENFRIAMIENTO MOTOR BMW E53 M62 (FREY),1232,5,6,8,19
11537500750 *1,MANGUERA INFERIOR RADIADOR ENFRIAMIENTO MOTOR BMW E53 M62 (FREY),1482,9,4,9,22
11537500752,MANGUERA DE RADIADOR M62,1781,1,5,3,9
11537502525,TUBO DE AGUA CURVO MONOBLOCK-CALEFACCION BMW E46  FEBI,1329,7,9,9,25
11537502525 *1,TUBO AGUA CURVO ENFRIAMIENTO MONOBLOCK A CALEFACCION BMW E36 E38 E39 E46 E85 M52 M54 (FREY),1805,7,4,1,12
11537502525 *2,TUBO AGUA CURVO ENFRIAMIENTO MONOBLOCK A CALEFACCION BMW E36 E38 E39 E46 E85 M52 M54 (EMBLER),1519,1,9,1,11
11537502525-100,MANGUERA DE RADIADOR 000  FREY INACTIVO,1270,5,9,5,19
11537502779 *1,TERMOSTATO DE MOTOR BMW E53-N62 E60-N62 E70-N62N F10-N63 FREY,1595,0,4,3,7
11537505228,MANGUERA SUPERIOR DE RADIADOR E39 540I,1254,0,1,0,1
11537508688,MANGUERA INFERIOR DE RADIADOR BMW E53-M54 BMTR,1990,2,0,9,11
11537508688 *1,MANGUERA INFERIOR DE RADIADOR BMW E53-M54 FREY,1332,8,6,7,21
11537508688 *2,MANGUERA INFERIOR DE RADIADOR BMW E53-M54 (EMBLER),1871,7,9,2,18
11537509227 *5,TERMOSTATO ENFRIAMIENTO MOTOR BMW M52 M54 (MAHLE) SSF,1640,3,8,2,13
11537510959,TERMOSTATO DE MOTOR BMW E87 N46N BMTR,2000,3,5,2,10
11537510959 *1,TERMOSTATO ENFRIAMIENTO MOTOR BMW N46 N46N (FREY),1903,4,2,2,8
11537510959-1,TERMOSTATO DE MOTOR BMW E87 N46N ( MAHLE ),1994,6,1,2,9
11537511083,TERMOSTATO DE MOTOR SIN TOMA DE AGUA BMW E36 / M52 ( BMTR ),1781,3,7,2,12
11537511083 *1,TERMOSTATO ENFRIAMIENTO MOTOR SIN TOMA AGUA BMW M50 M52 (FREY),1311,6,0,0,6
11537511083-1,TERMOSTATO DE MOTOR SIN TOMA DE AGUA BMW E36 Z3 / M52 ( VERNET ),1871,5,6,0,11
11537511083-2,TERMOSTATO DE MOTOR SIN TOMA DE AGUA BMW E36 Z3 / M52 ( VAICO ),1763,3,9,2,14
11537511083-4,TERMOSTATO DE MOTOR SIN TOMA DE AGUA BMW E36 / M52 ( OSSCA ),1436,1,3,7,11
11537511207 *1,MANGUERA DE RADIADOR FREY),1586,7,1,0,8
11537512733 *1,TERMOSTATO ENFRIAMIENTO MOTOR CON TOMA AGUA MINI W11 (FREY),1913,4,8,2,14
11537512733 *5,TERMOSTATO ENFRIAMIENTO MOTOR CON TOMA AGUA MINI W11 (URO PARTS) SSF,1532,2,8,1,11
11537516414,TUBO RIGIDO DE TERMOSTATO A MONOBLOCK BMW N52 N52N GENUINA,1364,3,3,6,12
11537516414B,MANGUERA CODO BOMBA AGUA A TUBO MONOBLOK MOTOR BMW N52 N52N (FREY),1828,2,0,8,10
11537519494,MANGUERA DE AGUA ENFRIADOR DE ACEITE DEL MOTOR BMW E90-N52 EMBLER,1897,2,3,3,8
11537519494 *1,MANGUERA DE AGUA ENFRIADOR DE ACEITE DEL MOTOR BMW E90-N52 FREY,1991,9,9,1,19
11537519710 *1,TUBO CURVO ENFRIAMIENTO MOTOR BMW E60 M54 E65 M54 (FREY),1584,3,0,5,8
11537519733 *1,TAPON CIEGO CABEZA MOTOR BMW E60 E65 M54 (FREY),1461,3,7,5,15
11537521049 *1,MANGUERA CODO BOMBA AGUA BOMBA A TERMOSTATO BMW N52 N52N (FREY),1320,9,2,3,14
11537521049 *5,MANGUERA DE AGUA BOMBA DE AGUA / TERMOSTATO BMW E90-N52 (FEBI) SSF,1470,6,3,0,9
11537526941,MANGUERA DE AGUA TERMOSTATO A ENFRIADOR BMW MOTOR N525N (CALIDAD ORIGINAL),1420,2,9,0,11
11537526941 *1,MANGUERA DE AGUA TERMOSTATO A ENFRIADOR BMW MOTOR N525N FREY,1684,1,1,2,4
11537534521 *1,TERMOSTATO MOTOR SENSOR CAFE 4 PINES MINI N12 N14 N16 N18 (FREY),1305,1,0,4,5
11537534521 *2,TERMOSTATO MOTOR SENSOR CAFE 4 PINES MINI N12 N14 N16 N18 (EMBLER) GOG,1758,3,6,9,18
11537534880 *1,JUNTA TUBO AGUA ENFRIAMIENTO MOTOR MONOBLOCK BMW N52 N52N (FREY),1707,9,2,0,11
11537541992,MANGUERA DE AGUA CABEZA TERMOSTATO BMW E90-N54 BMTR,1916,6,9,3,18
11537541992 *1,MANGUERA ENFRIAMIENTO MOTOR CABEZA TERMOSTATO BMW E90 N54 (FREY),1370,1,8,9,18
11537541992-1,MANGUERA DE AGUA CABEZA TERMOSTATO BMW E90-N54 GENUINA,1270,1,5,5,11
11537541992-3,MANGUERA DE AGUA CABEZA TERMOSTATO BMW E90-N54 MEISTER,1801,7,1,8,16
11537544638 *1,MANGUERA AGUA CABEZA TERMOSTATO BMW E60 E63 E65 N52 N52N N53 (FREY),1984,5,2,7,14
11537544788-100,TERMOSTATO DE MOTOR BMW E90-N52  ( FREY ) INACTIVO,1473,6,2,9,17
11537545665 *1,MANGUERA DE AGUA BOMBA CON TERMOSTATO BMW E83 FREY,1787,9,9,8,26
11537545665 *5,MANGUERA CODO ENFRIAMIENTO MOTOR TERMOSTATO A BOMBA AGUA BMW E60 E71 E82 E89 E90 N54 N55 (FEBI) SSF,1966,6,3,7,16
11537545665 *6,MANGUERA CODO ENFRIAMIENTO MOTOR TERMOSTATO A BOMBA AGUA BMW E60 E71 E82 E89 E90 N54 N55 (REIN) SSF,1310,1,0,6,7
11537545890 *1,MANGUERA ANTICONGELANTE CABEZA TERMOSTATO ENFRIAMIENTO MOTOR BMW N52 N52N N53 (FREY),1695,5,3,1,9
11537545890-100,MANGUERA ANTICONGELANTE CABEZA TERMOSTATO ENFRIAMIENTO MOTOR BMW N52 N52N (URO) INACTIVO,1705,2,0,4,6
11537545890-101,MANGUERA DE AGUA CABEZA TERMOSTATO BMW E90-N52 EMBLER INACTIVO,1516,6,7,6,19
115375489713-4,TUBO DE BOMBA DE AGUA MINI COOPER MOTOR N12-N14-N16-N18 TOPRAN,1999,1,0,6,7
11537549476 *1,TERMOSTATO ENFRIAMIENTO MOTOR BMW N52 N52N N54 (FREY),1833,4,9,4,17
11537549476 *3,TERMOSTATO ENFRIAMIENTO MOTOR BMW N52 N52N N54 (MAHLE),1904,0,6,0,6
11537549476 *5,TERMOSTATO ENFRIAMIENTO MOTOR BMW N52 N52N (ORIGINAL WAHLER) SSF,1213,0,9,2,11
11537550062 *1,MANGUERA ENFRIAMIENTO MOTOR CABEZA TERMOSTATO BMW E70 N52N (FREY),1523,8,6,0,14
11537550172 *1,TERMOSTATO ENFRIAMIENTO MOTOR BMW E70 E81 E90 N52N N54 N55 (FREY),1471,3,0,0,3
11537550172 *4,TERMOSTATO MOTOR BMW E70 E81 E90 N52N N54 N55 (MAHLE TM3097),1560,9,2,3,14
11537550172-100,TERMOSTATO DE MOTOR N55 INACTIVO,1745,7,6,2,15
11537550172-101,TERMOSTATO MOTOR BMW E70 E81 E90 N52 N52N N54 N55 (OSSCA) INACTIVO,1790,9,0,5,14
11537556924 *1,MANGUERA ENFRIADOR A MONOBLOCK A RADIADOR ENFRIAMIENTO MOTOR E83 N52N (FREY),1798,9,8,6,23
11537558899 *2,MANGUERA DE DEPOSITO DE ANTICONGELANTE BMW E60 E61 E82 E88 E89 E90-E93 F01 F02 (FREY),1567,4,7,5,16
11537560130,TOMA DE AGUA DE CABEZA DE MOTOR BMW E87 N46N GENUINO,1390,4,7,0,11
11537560130 *1,TOMA AGUA CABEZA MOTOR A MAGUERA SUPERIOR BMW E87 N46N (FREY),1536,3,8,6,17
11537560130-1,TOMA DE AGUA DE CABEZA DE MOTOR BMW E87 N46N TOPRAN,1679,7,5,1,13
11537560130-3,TOMA DE AGUA DE CABEZA DE MOTOR BMW E87 N46N OSSCA,1307,0,6,9,15
11537560363,MANGUERA DE AGUA CABEZA TERMOSTATO BMW E71 - N54 (EMBLER),1831,2,6,9,17
11537565-100,MANGUERA DE AGUA BOMBA CON TERMOSTATO BMW E83 INACTIVO,1938,1,0,6,7
11537565433 *1,MANGUERA BOMBA AGUA AUXILIAR ENFRIAMIENTO TURBO COOPER N14 N18 (FREY),1649,6,3,0,9
11537565433 *5,MANGUERA BOMBA AGUA AUXILIAR ENFRIAMIENTO TURBO COOPER N14 N18 (REIN) SSF,1876,5,2,9,16
115375721-100,MANGUERA DE CABEZA A TERMOSTATO INACTIVO,1796,4,4,9,17
11537572159 *1,MANGUERA AGUA ENFRIAMIENTO CABEZA A TERMOSTATO BMW N46 N46N (FREY),1364,6,5,1,12
11537577012 *1,MANGUERA ENFRIAMIENTO TURBO COMPRESOR BMW E70 F15 E71 F16 (FREY),1463,1,5,0,6
11537580627 *1,TERMOSTATO ENFRIAMIENTO MOTOR BMW F01 N52N N54 F10 N52N (FREY),1782,1,5,4,10
11537580969,MANGUERA DE AGUA CABEZA TERMOSTATO BMW F10-N52N BMTR,1544,5,1,5,11
11537580969 *1,MANGUERA DE AGUA CABEZA TERMOSTATO BMW F10-N52N FREY,1642,9,8,1,18
11537581063 *1,MANGUERA AGUA CABEZA TERMOSTATO BMW F10 F01 N52N (FREY),1822,1,1,3,5
11537581872 *1,MANGUERA AGUA ENFRIADOR ACEITE MOTOR A TUBO MONOBLOCK BMW F01 F10 N52N (FREY),1649,5,5,1,11
11537583666 *1,TAPA ARBOL LEVAS BMW E87 FREY,1416,4,9,6,19
11537583902 *1,Tubo de flujo del refrigerante FREY,1612,7,1,7,15
11537584543 *1,MANGUERA BOMBA AGUA A TERMOSTATO ENFRIAMIENTO MOTOR BMW E70 E71 N55 (FREY),1768,6,6,3,15
11537584549,TUBERIA DE RADIADOR BMW E90 OSSCA,1379,9,3,8,20
11537584549 *1,MANGUERA ENFRIAMIENTO MOTOR CABEZA TERMOSTATO BMW E84 E88 E90 N55 (FREY),1289,7,3,4,14
11537584630B,CODO MANGUERA DE AGUA RADIADOR BMW E70 E71 (FREY),1822,9,4,0,13
11537585023 *1,MANGUERA DE AGUA CABEZA TERMOSTATO BMW E70-N55 FREY,1743,2,6,2,10
11537586784,TERMOSTATO BMW X3 F25 X4 F26 EMBLER,1327,7,8,6,21
11537586784 *1 ,TERMOSTATO DE MOTOR BMW F25 (FREY),1262,8,5,3,16
11537586885,TERMOSTATO DE MOTOR BMW E53-N62 E60-N62 E70-N62N F10-N63 MAHLE TM27105,1528,2,7,0,9
11537586885-1,TERMOSTATO DE MOTOR BMW E53-N62 E60-N62 E70-N62N F10-N63 AFTERMARKET,1685,7,4,8,19
11537586885-5,TERMOSTATO DE MOTOR BMW E53-N62 E60-N62 E70-N62N F10-N63 BMTR,1794,3,3,5,11
11537589713 *1,TUBO BOMBA AGUA MOTOR MINI N12 N14 N16 N18 (FREY),1901,5,4,6,15
11537589713 *2,TUBO BOMBA AGUA MOTOR MINI N12 N14 N16 N18 (ISU),1402,6,8,6,20
11537589713 *3,TUBO BOMBA AGUA MOTOR MINI N12 N14 N16 N18 (TRICLO),1208,0,8,4,12
11537589949 *2,MANGUERA TERMOSTATO RADIADOR ENFRIAMIENTO MOTOR BMW E70 E71 (EMBLER),1297,4,4,2,10
11537596787,TERMOSTATO DE MOTOR MINI R53-W11 VERNET TH684391,1364,0,8,1,9
11537596787 *5,TERMOSTATO ENFRIAMIENTO MOTOR 91ï¿½ MINI R50 52 R53 W10 W11 (VERNET CALORSTAT) SSF,1896,0,7,9,16
11537596787 *6,TERMOSTATO ENFRIAMIENTO MOTOR 91ï¿½ MINI R50 52 R53 W10 W11 (REIN) SSF,1227,4,2,3,9
11537596787 -4,TERMOSTATO DE MOTOR MINI R53-W11 WAHLER,1493,7,2,3,12
11537596787-2,TERMOSTATO DE MOTOR MINI R53-W11 NORDIC,1253,1,5,4,10
11537598234 *5,MANGUERA AGUA ENFRIAMIENTO MONOBLOCK TERMOSTATO BMW F20 F30 F32 N55 (URO) SSF,1638,2,9,4,15
11537598234 *6,MANGUERA AGUA ENFRIAMIENTO MONOBLOCK TERMOSTATO BMW F20 F30 F32 N55 (REIN) SSF,1933,6,4,3,13
11537598865 *1,TERMOSTATO ENFRIAMIENTO MOTOR BMW F15 F16 F20 F22 F30 F32 N55 (FREY),1394,7,5,8,20
11537600584 *1,TERMOSTATO DE MOTOR BMW B48 N13 N20 (FREY),1866,8,5,2,15
11537600584 *9,TERMOSTATO DE MOTOR BMW B48 N13 N20 (OSSCA),1871,8,2,1,11
11537600586 ,MANGUERA DE RADIADOR F20 F21 (EMBLER),1717,7,2,6,15
11537600586 *1,MANGUERA DE RADIADOR F20 F21 (FREY),1825,1,6,0,7
11537601159 *3,TERMOSTATO DE MOTOR BMW F10 N55 (MAHLE TM21103) DGO,1245,1,0,5,6
11537603511,MANGUERA DE AGUA FEBI,1214,5,3,3,11
11537603511 *1,MANGUERA BOMBA DE AGUA TERMOSTATO BMW N20 (FREY),1205,7,1,0,8
11537603514,MANGUERA DE AGUA CABEZA TERMOSTATO BMW F30-N20 BMTR,1599,6,0,3,9
11537603514 *1,MANGUERA ENFRIAMIENTO MOTOR CABEZA TERMOSTATO BMW E84 E89 F10 F15 F16 F20 F25 F26 F30 F32 N20 N26 (FREY),1792,6,4,0,10
11537603514-2,MANGUERA DE AGUA CABEZA TERMOSTATO BMW F30-N20 EMBLER,1624,3,0,0,3
11537630368 *1,BOMBA AGUA AUXILIAR ELECTRICA ENFRIAMIENTO MOTOR TURBOCARGADOR MINI N14 N18 (FREY),1952,4,3,6,13
11537630368 *2,BOMBA AGUA AUXILIAR ELECTRICA ENFRIAMIENTO MOTOR TURBOCARGADOR MINI N14 N18 (EMBLER) GOG,1732,3,8,6,17
11537639997 *1,MANGUERA AGUA ENFRIAMIENTO MOTOR CABEZA TERMOSTATO BMW E84 E89 F10 F20-F23 F30-F36 (FREY),1674,9,7,5,21
11537639998 *2,MANGUERA INFERIOR RADIADOR ENFRIAMIENTO MOTOR BMW F10 F11 F15 F16 F20-F23 F25 F30-F36 (EMBLER),1271,2,5,0,7
11537642854 *1,TERMOSTATO ENFRIAMIENTO MOTOR BMW F20-F23 F30-F36 G01 G02 G11 G12 G30-G32 (FREY),1486,6,8,8,22
11537643226 *1,MANGUERA ENFRIAMIENTO TURBO COMPRESOR MOTOR BMW F20-F23 F30-F36 G01 G02 G11 G12 G20 G30-G32 (FREY),1262,7,4,4,15
11537644811 *1,TERMOSTATO ELECTRONICO ENFRIAMIENTO MOTOR BMW B38 B46 B48 (FREY),1374,0,1,2,3
11537645832 *2,MANGUERA DE REFRIGERANTE DEL TURBOCOMPRESOR MINI R56-N18 (GENUINA),1646,9,0,5,14
11537649409 *1,MANGUERA AGUA ENFRIAMIENTO MOTOR CABEZA TERMOSTATO BMW F15 F16 N55 (FREY),1695,1,6,4,11
11537829959-1,CAJA DEL TERMOSTATO MINI R50 (BAMPIC),1321,3,7,5,15
11537829960 *5,CAJA TERMOSTATO CON TAPON ANTICONGELANTE ENFRIAMIENTO MOTOR MINI R50 R52 W10 (TOPACIO) SSF,1939,3,2,7,12
11537829960 *6,CAJA TERMOSTATO CON TAPON ANTICONGELANTE ENFRIAMIENTO MOTOR MINI R50 R52 W10 (FEBI) SSF,1588,7,9,3,19
11538631943 *3,TERMOSTATO CON BOMBA DE AGUA ENFRIAMIENTO MOTOR F39 F40 F44-F46 F48 F54 F55 F57 F60 (INA),1443,8,7,6,21
11538635689 *1,TERMOSTATO ENFRIAMIENTO MOTOR BMW N20 (FREY),1204,4,3,7,14
11538635689 *3,TERMOSTATO ENFRIAMIENTO MOTOR BMW N20 (MAHLE TM25108) DGO,1326,6,4,9,19
11538648791-100,TERMOSTATO DE MOTOR BMW F30 / N20 INACTIVO,1557,5,7,6,18
11538674895 *1,TERMOSTATO MOTOR SENSOR NEGRO 2 PINES MINI R56 N14 N16 N18 (FREY),1459,1,8,0,9
11538674895 *3 ,TERMOSTATO MOTOR SENSOR NEGRO 2 PINES MINI R56 N14 N16 N18 (MAHLE TM46105) DGO,1262,4,4,8,16
11539845352 *1,MANGUERA ENFRIAMIENTO MOTOR TURBO A TERMOSTATO MINI N18 (FREY),1502,0,5,9,14
11572 *5,TERMINAL DIRECCION SIN BIELETA SUSPENSION DELANTERA (L) LAND ROVER LR2 2008 a 2015 (KARLYN) SSF,1253,6,8,6,20
11573 *5,TERMINAL DIRECCION SIN BIELETA SUSPENSION DELANTERA (R) LAND ROVER LR2 2008 a 2015 (KARLYN) SSF,1644,7,7,1,15
1160102606,JUEGO DE JUNTAS DE MOTOR MERCEDES W126 M116-M117 VICTOR REINZ,1572,9,3,8,20
1160102606 *1,JUEGO DE JUNTAS DE MOTOR MERCEDES W126 M116-M117 FREY,1534,9,4,0,13
11605330-100,PUNTERIA HIDRAULICA BUZO BMW MOTOR N52-N52N INACTIVO,1790,4,8,0,12
11611173671,JUNTA DE MULTIPLE DE ADMISION DE MINI R53 ELRING,1230,4,6,5,15
11611432559,MANGUERA 16 MM EN L VALVULA PCV BMW M52 M54 ( EMBLER ),1792,8,3,7,18
11611432559 *1,"MANGUERA 3/4"" VENTILACION MOTOR SISTEMA PCV BMW M54 (FREY)",1454,2,9,4,15
11611432559-1,MANGUERA VENTILACION DE CARTER PCV BMW E46-M54 URO,1749,3,4,0,7
11611432559-2,KIT DE MANGUERAS Y VALVULA PCV BMW M52 M54 ( KZR GERMANY ),1503,3,6,5,14
11611432559-4,MANGUERA VENTILACION DE CARTER PCV BMW E46-M54 OSSCA,1801,9,2,1,12
11611433328,KIT DE JUNTAS DE ADMISION DE CUERPO DE ACELERACION  BMW E34-M60 BMTR,1645,2,2,4,8
11611433328 *1,KIT DE JUNTAS DE ADMISION DE CUERPO DE ACELERACION  BMW E34-M60 FREY,1460,0,5,4,9
11611436631 *1,JUNTA MULTIPLE ADMISION BMW MOTOR M52 M54 (FREY),1336,1,2,7,10
11611436631-100 ,JUNTA DE MULTIPLE DE ADMISION BMW INACTIVO,1730,6,4,4,14
11611717259,JUNTA DE MULTIPLE DE ADMISION BMW E36-M50 VICTOR REINZ,1358,2,0,1,3
11611717259 *1,JUNTA DE MULTIPLE DE ADMISION BMW E36-M50 FREY,1538,5,4,5,14
11611717259-2,JUNTA DE MULTIPLE DE ADMISION BMW E36-M50 BGA,1539,2,9,3,14
11611740069,JUNTA DE MULTIPLE DE ADMISION BMW E36-M52 VICTOR REINZ,1479,4,4,3,11
11611740069 *1,JUNTA DE MULTIPLE DE ADMISION BMW E36-M52 FREY,1907,5,4,5,14
11612297462 *1,JUNTA LIGA MULTIPLE ADMISION AIRE MOTOR BMW N20 N26 (FREY),1599,2,1,4,7
11612297462-9,JUNTA DE MULTIPLE DE ADMISION BMW MOTOR N20 ELRING,1884,4,6,4,14
11612380943,TAPA EMBELLESEDORA DE MOTOR BMW E53,1980,5,4,6,15
11612380943 *1,TAPA EMBELLESEDORA DE MOTOR BMW E53 FREY,1817,8,5,0,13
11617501563 *1,VALVULA VENTILACION CARTER MOTOR PCV BMW E31 E38  E39 M62 (FREY),1933,4,0,8,12
11617501563-2,SEPARADOR DE ACEITE PCV BMW MOTOR M62 (EMBLER),1763,7,2,8,17
11617501566 *1,SEPARADOR ACEITE MOTOR VALVULA PCV BMW M52 M54 (FREY),1594,0,4,7,11
11617501566 *D,DIAFRACMA DE VALVULA PCV BMW M52 M54 ( EMBLER ),1851,7,5,0,12
11617501566 *K,KIT DE MANGUERAS Y VALVULA PCV BMW M52 M54 ( EMBLER ),1598,2,9,8,19
11617501566 *S,SEPARADOR DE ACEITE PCV BMW M52 M54 (EMBLER) GOG,1247,5,2,1,8
11617503520 *1,SEPARADOR DE ACEITE PCV BMW MOTOR N46 ( FREY ),1432,8,1,0,9
11617503520 *2,SEPARADOR DE ACEITE PCV BMW MOTOR N46 (EMBLER),1929,8,2,4,14
11617503520 *3,KIT DE MANGUERAS Y VALVULA PCV BMW N46 (CRS PREMIUM),1359,4,3,9,16
11617503520-1,VALVULA PCV REPUESTO BMW E87-N46 BMTR,1392,4,0,2,6
11617503520-2,DIAFRAGMA DE VALVULA PCV BMW MOTOR N46 (EMBLER),1250,7,8,5,20
11617503520-3,KIT DE MANGUERAS Y VALVULA PCV BMW N46 (EMBLER),1889,6,5,8,19
11617503520-6,VALVULA PCV COMPLETA BMW E87 - N46 VAICO,1349,9,0,3,12
11617504535,MANGUERA CORRUGADA CURBA PARA VALVULA PCV BMW E60 REIN,1482,0,2,9,11
11617504535 *1,MANGUERA CORRUGADA CURBA PARA VALVULA PCV BMW E60 FREY,1327,7,9,8,24
11617504535-3,MANGUERA REGIDA DE 3 VIAS PCV BMW M52 M54 ( KZR GERMANY ),1293,0,0,9,9
11617504536 *1,MANGUERA TERMOSTATO MONOBLOCK BMW E90-M54 FREY,1842,3,9,2,14
11617504536 *3,MANGUERATERMOSTATO MONOBLOCK BMW E36 E38 E39 E46 E53 E60 E61 E65 E66 E83 E85 (OSSCA),1249,5,7,2,14
11617504536-100,MANGUERA TERMOSTATO MONOBLOCK BMW E90-M54 INACTIVO,1795,4,0,7,11
11617508541 *1,RECUPERADOR ACEITE MOTOR VALVULA PCV BMW E52 E53 M62 (FREY),1218,1,7,7,15
11617522933,MANGUERA DE VENTILACION DE CARTER PCV BMW E90-N52 ( EMBLER ),1248,9,3,9,21
11617522933 *1,MANGUERA MOTOR VENTILACION PCV 3 VIAS BMW N52 (FREY),1755,5,3,9,17
11617522933 *6,MANGUERA DE VENTILACION DE CARTER PCV BMW E90-N52 (REIN) SSF,1912,5,2,3,10
11617522933-2,MANGUERA DE VENTILACION DE CARTER PCV BMW E90-N52 FREY,1495,8,2,6,16
11617528173,JUNTA DE MULTIPLE DE ADMISION MINI R56-N12 ( ELRING),1653,4,9,0,13
11617528174,JUNTA DE MULTIPLE DE ADMISION MINI R56-N12 ELRING,1268,5,5,0,10
11617528340 *5,1 PZ. JUNTA MULTIPLE ADMISIï¿½N MINI N13 N14 N18 (VICTOR REINZ) SSF,1305,1,2,0,3
11617528584 *1,KIT 4 JUNTAS MULTIPLE ADMISION BMW N46 N46N (FREY),1235,2,6,5,13
11617528584 *5,KIT 4 JUNTAS DE MULTIPLE ADMISION BMW E87 (ELRING),1758,0,5,1,6
11617531423 *1,1 PZ RECUPERADOR SEPARADOR ACEITE MOTOR VALVULA PCV BMW N52 (FREY),1234,7,1,2,10
11617531423 *5,1 PZ RECUPERADOR SEPARADOR ACEITE MOTOR VALVULA PCV BMW N52 (FEBI) SSF,1621,9,4,3,16
11617531423-100,SEPARADDOR DE ACEITE BMW E90 N52 INACTIVO,1205,3,5,1,9
11617533400,SEPARADORA DE ACEITE PCV BMW E60 ( URO ),1962,8,1,7,16
11617544805 *1,VALVULA CONTROL AIRE MULTIPLE ADMISION DISA BMW M54 3.0 L (FREY),1509,0,6,2,8
11617544806 *1,VALVULA CONTROL ENTRADA AIRE MOTOR DISA BMW M54 2.2 / 2.5 / 2.8 (FREY),1303,9,9,1,19
11617544806 *3,VALVULA CONTROL ENTRADA AIRE MOTOR DISA BMW M54 2.2 / 2.5 / 2.8 (URO),1761,6,0,3,9
11617545382,VALVULA DE VACIO DEL BOOSTER BMW E46  BMTR,1428,7,8,2,17
11617545382 *1,VALVULA DE VACIO DEL BOOSTER BMW E46  FREY,1560,7,7,8,22
11617547185,MANGUERA DE VENTILACION DE TAPA DE PUNTERIAS R BMW E53 REIN,1284,1,1,1,3
11617547185 *1,MANGUERA DE VENTILACION DE TAPA DE PUNTERIAS R BMW E53 FREY,1346,7,2,9,18
11617547186,MANGUERA DE VENTILACION DE TAPA DE PUNTERIAS L BMW E53 VAICO,1435,3,1,9,13
11617547186 *1,MANGUERA DE VENTILACION DE TAPA DE PUNTERIAS L BMW E53 FREY,1464,4,8,2,14
11617547242,JUNTA DE MULTIPLE DE ADMISION 6 PZ BMW E90-N52 VICTOR REINZ,1588,4,8,6,18
11617547242 *1,1 PZ JUNTA LIGA MULTIPLE ADMISION BMW N52N (FREY),1418,5,8,3,16
11617547242 *8,KIT JUNTA DE MULTIPLE DE ADMISION 6 PZ BMW N52 (ELRING),1958,9,3,4,16
11617559525,MULTIPLE DE ADMSION BMW E90 (SEMINUEVO ORIGINAL),1962,7,4,7,18
11617559525 *1,MULTIPLE DE ADMSION BMW E90 FREY,1586,5,7,4,16
11617559530,MANGUERA DE VENTILACION PCV 3 VIAS BMW E90-N52 REIN,1422,2,6,7,15
11617559530-2,MANGUERA DE VENTILACION PCV 3 VIAS BMW N52 ( EMBLER ),1468,6,9,2,17
11617560538,VALVULA DISA SECUNDARIA SEMINUEVA BMW E90 - N52  GENUINA,1462,6,7,9,22
11617560538 *1,VALVULA DISA SECUNDARIA  BMW E90 - N52  FREY,1249,3,4,9,16
11617561408,SENSOR DE TEMPERATURA ADMISION BMW E90 TOPRAN,1862,7,1,4,12
11617579114,VALVULA DISA PRIMARIA BMW E90 - N52  GENUINA,1714,5,6,1,12
11617579114 *1,VALVULA CONTROL AIRE ADMISION DISA PRIMARIA BMW N52N (FREY),1439,9,7,8,24
11617579114-2,VALVULA DISA PRIMARIA BMW E90 - N52  BEMQW,1985,0,2,7,9
11617588624,JUNTA DEL COLECTOR DE ADMISION ELRING,1681,6,5,8,19
11617633493 *1,KIT 4 PZ JUNTA MULTIPLE ADMISION BMW B32 B36 B38 B42 B46 B48 MINI B36 B38 B46 B48 (FREY),1575,6,2,3,11
11618511338 *3,MANGUERA ENTRADA AIRE MOTOR BMW F39 F40 F44-F48 F54-F57 F60 (VERMO),1366,0,1,4,5
11618638014 *1,SENSOR TEMPERATURA ADMISION AIRE MOTOR BMW N52 N52N (FREY),1388,4,2,7,13
11621174968 *5,JUNTA MULTIPLE GASES ESCAPE MOTOR MINI R50 R53 (VICTOR REINZ) SSF,1524,5,1,2,8
11621728984,JUNTA DE MULTIPLE DE ESCAPE BMW E36-M44 VICTOR REINZ,1709,2,4,6,12
11621728984 *1,JUNTA DE MULTIPLE DE ESCAPE BMW E36-M44 FREY,1507,8,6,5,19
11621732969,JUNTA DE MULTIPLE DE ESCAPE BMW E46 VICTOR REINZ,1770,3,6,6,15
11621732969 *1,JUNTA DE MULTIPLE DE ESCAPE BMW E46 FREY,1571,5,0,8,13
11621744252,JUNTA DE MULTIPLE DE ESCAPE BMW E36-M52 ELRING,1772,1,2,4,7
11621744252 *1,JUNTA DE MULTIPLE DE ESCAPE BMW E36-M52 FREY,1428,7,4,3,14
11627509677,JUNTA DE COLECTOR DE ESCAPE BMW  VICTOR REINZ,1586,8,9,9,26
11627558906 *1,JUNTA MULTIPLE GASES ESCAPE MOTOR 49 MM BMW N54 (FREY),1318,9,2,0,11
11627558906 *5,JUNTA MULTIPLE GASES ESCAPE MOTOR 49 MM BMW N54 (ELRING) SSF,1931,5,2,2,9
11627558906 *6,JUNTA MULTIPLE GASES ESCAPE MOTOR 49 MM BMW N54 (VICTOR REINZ) SSF,1595,8,2,9,19
11627617523 *3,JUNTA DE ESCAPE MOTOR BMW F20-F23 F30-F36 F39 F45-F48 G01 G02 G11 G12 G20 G30-G32 (ELRING),1308,3,6,7,16
11627626106,EMPAQUE MULTIPLE DE ESCAPE R56 ELRING,1790,4,4,4,12
11651515368,ENFRIADOR DE AIRE SEMINUEVO MINI R52-R53 GENUINO,1376,9,8,2,19
11657534454 *5,TUBO LUBRICACION ACEITE TURBO COMPRESOR MINI R56 N14 N18 (URO) SSF,1314,2,3,6,11
11657534454 *6,TUBO LUBRICACION ACEITE TURBO COMPRESOR MINI R56 N14 N18 (REIN) SSF,1870,5,5,2,12
11657556981,SUPER CARGADOR MINI R53 / W11 GENUINO,1296,1,1,2,4
11657588995 *2 ,TURBOCARGADOR COMPLETO BMW N55 (EMBLER) GOG,1386,5,3,4,12
11657588995 *C,CARTUCHO TURBOCARGADOR MOTOR BMW E84 E88 E90 F21 F22 F30 N55 (EMBLER),1513,3,9,8,20
11657593273 *1,VALVULA LIBERACION PRESION TURBO MINI N14 N18 (FREY),1688,7,4,7,18
11657593273 *2,VALVULA LIBERACION PRESION TURBO MINI N14 N18 (EMBLER) GOG,1966,2,6,6,14
11657593273 *5,VALVULA LIBERACION PRESION TURBO MINI N14 N18 (PIERBUG) SSF,1239,3,4,6,13
11657593303,JUNTA DE ESCAPE DE MOTOR BMW MOTOR N55 ELRING,1515,1,6,3,10
11657599547 *1,SOLENOIDE CONTROL SOBRE PRESION TURBO COOPER N14 N18 BMW N13 (FREY),1792,7,6,1,14
11657599547 *5,SOLENOIDE CONTROL SOBRE PRESION TURBO COOPER N14 N18 BMW N13 (FEBI) SSF,1913,2,5,6,13
11657599547 *6,SOLENOIDE CONTROL SOBRE PRESION TURBO COOPER N14 N18 BMW N13 (OEM) DSC,1308,8,7,9,24
11657602293 *1,VALVULA SOLENOIDE ACTUADOR BMW E53 E70 E71 F16 (FREY),1552,3,6,3,12
11657609210,VALVULA LIBERACIï¿½N DE TURBO BMW F30,1991,7,6,5,18
11657609210-2,VALVULA LIBERACIï¿½N DE TURBO BMW F30 PIERBURG,1632,5,8,5,18
11657618035 *3,JUNTA MULTIPLE DE ESCAPE BMW F20-F23 F30-F32 F36 F39 F45 F46 MINI F54-F56 F57 F60 (ELRING),1476,8,5,7,20
11657633795 *2,TURBOCARGADOR COMPLETO BMW F20 F30 F32 B38 (EMBLER) GOG,1579,9,2,1,12
11657638783 *1,ACTUADOR VALVULA TURBO COMPRESOR F20 F22 F30 F32 F07 X84 F25 F26 (FREY),1430,4,3,7,14
11657649289,TURBO CARTUCHO BANCO 1 SEMINUEVO BMW MOTOR N54 BI TURBO GENUINO,1743,0,1,8,9
11657649289 *2,TURBO CARTUCHO BANCO 1 BMW MOTOR N54 BI TURBO (EMBLER) GOG,1271,6,9,4,19
11657649291 *2,TURBO CARTUCHO BANCO 2 BMW MOTOR N54 BI TURBO (EMBLER) GOG,1301,9,6,4,19
11657850453 *3,ACTUADOR VALVULA TURBO COMPRESOR F39 F45 F46 F48 F54 F55 F56 F57 F60 F80 F82 F83 F87 (METZGER),1733,8,2,7,17
11658485115 *3,ACTUADOR VALVULA TURBO COMPRESOR F39 F45 F46 F48 F54 F55 F56 F57 F60 (EMBLER),1858,2,0,9,11
11658617069 *5,MANGUERA TUBO RETORNO ACEITE TURBO CARGADOR MINI N14 N18 (REIN) SSF,1381,9,3,2,14
11658660987 *1,ACTUADOR VALVULA TURBO COMPRESOR F39 F45 F46 F48 F54 F55 F56 F57 F60 F80 F82 F83 F87 (FREY),1513,0,8,8,16
11667509080,JUNTA TORICA DE LA BOMBA DE VACIO VICTOR REINZ,1896,9,5,7,21
11667556919,BOMBA DE VACIO MINI R56-N14 PIERBURG,1728,6,7,0,13
11667558344 *1,BOMBA REFORZADORA VACIO FRENOS BMW N52N (FREY),1567,0,1,5,6
11667570813,BOMBA DE VACIO MINI MOTOR N12 PIERBURG,1914,0,6,3,9
11667622380 *1,BOMBA REFORZADORA VACIO FRENOS BMW F20 F25 F26 F30 F10 F15 F16 N20 N26 (FREY),1552,5,4,3,12
11667625260 *1,BOMBA VACIO REFORZADORA FRENOS BMW F20 F30 N13 (FREY),1750,5,6,6,17
11667625260 *5,BOMBA REFORZADORA VACIO FRENOS BMW F20 F30 N13 (PIERBURG),1838,7,5,0,12
11667635656 *1,BOMBA REFORZADORA VACIO FRENOS BMW N46 N46N (FREY),1774,8,8,4,20
11667635657 *1,BOMBA REFORZADORA VACIO FRENOS BMW N62 N62N (FREY),1972,1,1,2,4
1172003301,BOMBA AGUA MECANICA ENFRIAMIENTO MOTOR MERCEDES W126 M117 (GRAF),1681,5,2,1,8
1172003301 *1,BOMBA AGUA MECANICA ENFRIAMIENTO MOTOR MERCEDES W126 M117 (FREY),1410,2,9,2,13
11727508270 *1,MANGUERA VENTILACION VALVULA SOLENOIDE SISTEMA EGR BMW N62 (FREY),1219,0,4,4,8
11727557907,MANGUERA SECUNDARIA DE BOMBA PARA FILTRO ENTRADA AIRE MOTOR BMW E90 ORIGINAL SEMINUEVO,1692,4,8,4,16
11727557907 *1,MANGUERA SECUNDARIA DE BOMBA PARA FILTRO ENTRADA AIRE MOTOR BMW E90 FREY,1362,4,5,6,15
1173201031,AMORTIGUADOR TRASERO W176 SACHS,1846,6,0,3,9
1173201131 *5,AMORTIGUADOR SUSPENSION TRASERA (L/R) MERCEDES W176 W246 (BILSTEIN) SSF,1603,6,8,0,14
11747626350,VALVULA SOLENOIDE CONTROL DE PRESION DE TURBO BMW E90 - N54 PIERBUG,1272,8,5,7,20
11747626350 *1,VALVULA SOLENOIDE CONTROL DE PRESION DE TURBO BMW E90 - N54 FREY,1686,5,8,0,13
11747626351,VALVULA SOLENOIDE SOBRE ALIMENTACION DE TURBO BMW MOTOR-N55  PIERBURG,1599,9,3,4,16
11747626351 *1,VALVULA SOLENOIDE SOBRE ALIMENTACION DE TURBO BMW N55 (FREY),1823,0,9,4,13
11747626351 *3,VALVULA SOLENOIDE SOBRE ALIMENTACION DE TURBO BMW N55 (METZGER),1528,2,9,0,11
11747628987 *3,VALVULA SOLENOIDE CONVERTIDOR TURBOCOMPRESOR BMW E71 F01 F02 (KOLBEN),1293,9,7,3,19
11780872674,SENSOR DE OXIGENO MINI R53-W11 ORIGINAL,1933,7,9,0,16
11781427884 *2,SENSOR OXIGENO DELANTERO 990 MM BMW E36 E38 E39 (EMBLER),1657,6,2,2,10
11781433940 *1,SENSOR OXIGENO DESPUES DE CATALIZADOR BANCO 1 Y 2 990 MM BMW M52 M54 (FREY),1657,6,5,2,13
11781433940 *5,SENSOR OXIGENO DESPUES DE CATALIZADOR BANCO 1 Y 2 990 MM BMW M52 M54 (BOSCH) SSF,1782,3,7,0,10
11781433940-100,SENSOR DE OXIGENO TRASERO BMW E46-M54 990 MM BMTR INACTIVO,1594,5,6,9,20
11781742050 *1,SENSOR OXIGENO ANTES DE CATALIZADOR BANCO 1 Y 2 320 MM BMW M52 M54 (FREY),1841,5,1,3,9
11781742050 *5,SENSOR OXIGENO ANTES DE CATALIZADOR BANCO 1 Y 2 320 MM BMW M52 M54 (BOSCH) SSF,1256,7,2,8,17
11781742050 *9,SENSOR OXIGENO DELANTERO CABLE 320 MM BMW E39 E46 E53 E60 E83 E85 M54 (WALKER),1957,0,3,4,7
11781742050-100 ,SENSOR DE OXIGENO DELANTERO  BMW E46-M54 320 MM BMTR INACTIVO,1325,3,9,1,13
11787512976,SENSOR OXIGENO 360 MM LARGO CILINDROS 2 Y 3 BMW N46 N46N (FREY),1671,5,0,2,7
11787513963,SENSOR DE OXIGENO TRASERO BMW E60-E83-E85 / 990MM FREY,1442,9,3,9,21
11787518495,SENSOR DE OXIGENO TRASERO  BMW E60-M54 500 MM BMTR,1651,0,4,3,7
11787518495 *1,SENSOR DE OXIGENO TRASERO  BMW E60-M54 500 MM FREY,1995,4,9,8,21
11787535269 *1,SENSOR DE OXIGENO DELANTERO BMW E81-E84-E90-E87-E64 / 650MM FREY,1934,7,0,7,14
11787537984 *1,SENSOR OXIGENO DELANTERO 340 MM BMW E60 E63 E65 E87 E90 N52 (FREY),1346,0,8,1,9
11787537984 *2,SENSOR DE OXIGENO DELANTERO BMW E87-E90-E60-E63-E65 / 340MM (BOSCH) SSF,1986,9,4,9,22
11787537984-5,SENSOR DE OXIGENO DELANTERO BMW E87-E90-E60-E63-E65 / 340MM FAE,1535,2,2,6,10
11787537993 *1,SENSOR OXIGENO DELANTERO 1440 MM  BMW E60 E65 E70 E81 E83 E84 E90 N52N (FREY),1738,5,8,5,18
11787539124 *1,SENSOR DE OXIGENO DELANTERO BMW E60-E61-E63-E64-E65-E66 / 620MM FREY,1938,0,9,8,17
11787539125 *1,SENSOR OXIGENO TRASERO 325MM BMW E60 E63 E65 N52N E70 E71 N52N (FREY),1570,1,2,3,6
11787539126 *1,SENSOR OXIGENO TRASERO 480 MM BMW N46N N52N (FREY),1552,7,9,9,25
11787544654,SENSOR DE OXIGENO TRASERO BMW E60-E61-E64 / 430MM FREY,1501,2,2,4,8
11787544655 *1,SENSOR OXIGENO TRASERO 380 MM BMW E60 E65 N52 N52N (FREY),1707,0,6,7,13
11787544655-100,SENSOR DE OXIGENO BMW E60-N52 380 MM FAE INACTIVO,1434,3,3,9,15
11787545074 *1,SENSOR DE OXIGENO DELANTERO BMW E90 560 MM FREY,1574,0,3,9,12
11787545074 *4,SENSOR DE OXIGENO DELANTERO BMW E90 560 MM BOSCH,1868,7,6,0,13
11787545074-100,SENSOR DE OXIGENO DELANTERO BMW E90 560 MM BMTR INACTIVO,1619,4,6,9,19
11787545075,SENSOR DE OXIGENO TRASERO 490 MM BMW MOTOR N52-53-54 BMTRS,1418,8,9,8,25
11787545075 *1,SENSOR DE OXIGENO TRASERO 490 MM BMW MOTOR N52N-54 FREY,1960,0,0,0,0
11787545075-1,SENSOR DE OXIGENO TRASERO 490 MM BMW MOTOR N52-53-54 BOSCH,1960,3,1,9,13
11787545075-2,SENSOR DE OXIGENO TRASERO 490 MM BMW MOTOR N52-53-54 WALKER,1612,5,1,8,14
11787545243,SENSOR DE OXIGENO TRASERO BMW E90-N52 470 MM BMTR,1990,7,1,2,10
11787545243-1,SENSOR DE OXIGENO TRASERO BMW E90-N52 470 MM BOSCH,1483,4,6,2,12
11787545243-2,SENSOR DE OXIGENO TRASERO BMW E90-N52 / 470MM FREY,1497,3,0,3,6
11787548961 *5,SENSOR OXIGENO TRASERO DESPUES DE CATALIZADOR 475 MM MINI N12 N14 N16 N18 (NTK) SSF,1541,3,0,8,11
11787557223 *1,SENSOR OXIGENO ANTES DE CATALIZADOS 950 MM BMW E70 N62N 4.8 (FREY),1896,0,5,6,11
11787557756,SENSOR DE OXIGENO DELANTERO BMW E70 / 1540MM FREY,1692,7,7,9,23
11787557758,SENSOR DE OXIGENO BMW E60 / 1100MM ( BOSCH ),1917,0,5,4,9
11787557758 *1,SENSOR DE OXIGENO BMW E60 / 1100MM FREY,1439,8,5,3,16
11787558055,SENSOR DE OXIGENO DELANTERO  BMW E90 / 1400 MM  ( BOSCH ),1335,7,5,7,19
11787558055 *1,SENSOR OXIGENO 1400 MM BMW E90 E60 E84 (FREY),1455,5,3,9,17
11787558055-1,SENSOR DE OXIGENO DELANTERO BMW E90-N52 140 MM FAE,1935,3,6,0,9
11787558073,SENSOR DE OXIGENO TRASERO BMW E90 340 MM SEMINUEVO,1458,2,1,8,11
11787558073 *3,SENSOR DE OXIGENO TRASERO BMW E90 340 MM FREY,1807,7,3,6,16
11787558087,SENSOR DE OXIGENO TRASERO BMW E90-N52 120 MM WALKER,1391,4,0,3,7
11787558087 *1,SENSOR DE OXIGENO TRASERO BMW E90-N52 120 MM FREY,1882,0,8,7,15
11787560957 *1,SENSOR DE OXIGENO DELANTERO MINI R56 / 320MM FREY,1732,3,2,7,12
11787561410 *1,SENSOR DE OXIGENO DELENTERO BMW E81-E87-E90-E60-E63-E65-E70 / 680MM FREY,1563,2,5,9,16
11787569968,SENSOR DE OXIGENO BMW E81-E90-E84 / 480MM FREY,1695,1,5,0,6
11787570104,SENSOR DE OXIGENO DELANTERO BMW  E87-N46N 550 MM BMTR,1752,6,9,4,19
11787570104 *1,SENSOR DE OXIGENO DELANTERO BMW  E87-N46N 550 MM FREY,1587,4,5,5,14
11787570480,SENSOR DE OXIGENO TRASERO BMW E90-E84-E81-E87 / 325MM FREY,1451,9,8,5,22
11787573319,SENSOR DE OXIGENO DELANTERO BMW E60-E61 / 890MM FREY,1277,0,0,7,7
11787576673 *1,SENSOR OXIGENO ANTES CATALIZADOR BMW F10 N63 MINI R56-N16 BMW E71 / 320MM (FREY),1404,3,5,8,16
11787577666,SENSOR DE OXIGENO TRASERO BMW F01-F02-E71 / 600MM FREY,1673,6,9,4,19
11787577667 *1,SENSOR OXIGENO TRASERO 560 MM (L/R) BMW E71 F01 F02 N54 (FREY),1700,5,9,4,18
11787586692 *1,SENSOR DE OXIGENO DELANTERO BMW E60-E61-E71 / 1300MM FREY,1642,9,9,8,26
11787589121 *1,SENSOR DE OXIGENO BMW E84 E89 F07 F10 F11 F15 F16 F20-F26 F30-F36 (FREY),1734,7,7,3,17
11787589121-3,SENSOR DE OXIGENO BMW MOTOR N20 WALKER,1704,5,6,8,19
11787589122 *1,SENSOR OXIGENO TRASERO 540 MM BMW E84 F16 F16 F20 F22 F25 F26 F30 F32 N20 N26 (FREY),1719,9,2,4,15
11787589122-9,SENSOR DE OXIGENO TRASERO BMW F10-F20 N20 GENUINO,1770,3,3,9,15
11787589139,SENSOR DE OXIGENO DELANTERO BMW F10-F11-F01-F02-F25 / 850MM FREY,1332,7,4,8,19
11787589146 *1,SENSOR DE OXIGENO TRASERO BMW F10-F11-F01-F02 / 575MM FREY,1822,3,6,1,10
11787589147 *1,SENSOR OXIGENO DESPUES CATALIZADOR BMW F01 F02 F10 F11 N52N 410MM (FREY),1541,6,4,1,11
11787589475 *1,SENSOR OXIGENO DESPUES CATALIZADOR BANCO (2) 370 MM BMW F01 F10 F25 N52N (FREY),1762,6,1,2,9
11787589475 *5,SENSOR OXIGENO DESPUES CATALIZADOR BANCO (2) 690 MM BMW E70 E71 E82 E88 E90-E93 F01 F02 F10-F13 F20-F26 F30-F34 F36 N20 N55 (BOSCH) SSF,1641,6,8,1,15
11787590713,SENSOR DE OXIGENO DELANTERO MINI R56 / 320MM ( BOSCH ),1706,2,3,4,9
11787590713 *2,SENSOR DE OXIGENO DELANTERO MINI R56 / 320MM (EMBLER),1562,9,6,1,16
11787595353 *1,SENSOR DE OXIGENO MINI R56-N16 BMW E71 / 320MM (FREY),1205,4,3,5,12
11787595353 *5,SENSOR OXIGENO ANTES CATALIZADOR 320 MM BMW F20 F30 N13 MINI R55 A R61 N16 BMW (BOSCH) SSF,1407,5,3,4,12
11787596908,SENSOR DE OXIGENO BMW E70 WALKER,1597,5,2,8,15
11787596908 *1,SENSOR DE OXIGENO BMW E70 (FREY),1651,7,3,5,15
11787596909,SENSOR DE OXIGENO TRASERO BMW F25 / N52N / 650 MM ( BMTR ),1802,0,3,1,4
11787596909 *1,SENSOR DE OXIGENO TRASERO BMW F25 / N52N / 650 MM FREY,1395,9,8,6,23
11787596909-1,SENSOR DE OXIGENO TRASERO BMW F25 / N52N / 650 MM ( BOSCH ),1538,5,8,2,15
11787599942,SENSOR DE OXIGENO TRASERO BMW F20-F21-F30-F31 / 710MM FREY,1742,5,3,4,12
11787599942 *2,SENSOR DE OXIGENO TRASERO BMW F20-F21-F30-F31 / 710MM (EMBLER),1371,2,3,2,7
11787603023,SENSOR DE OXIGENO TRASERO BMW F25-N52N 370 MM BMTR,1554,2,2,2,6
11787603023 *5,SENSOR OXIGENO DESPUES CATALIZADOR BANCO (2) 370 MM BMW F01 F10 F25 N52N (BOSCH) SSF,1844,0,4,5,9
11787614322,SENSOR DE OXIGENO BMW E70-N63 560 MM BMTR,1544,3,7,4,14
11787614322-1,SENSOR DE OXIGENO BMW E70-N63 560 MM BOSCH,1845,8,1,9,18
11787614322-2,SENSOR DE OXIGENO BMW E70-N63 560 MM FREY,1427,9,0,4,13
11788600992 *1,SENSOR OXIGENO MINI MOTOR F56 B38 F45 F48 F39 B48 (FREY),1701,5,7,9,21
11788600992 *2,SENSOR DE OXIGENO MINI MOTOR F56 B38 F45 F48 F39 B48 (EMBLER),1448,3,1,5,9
11788604889,SENSOR DE OXIGENO MINI MOTOR B38-B48 METZGER,1808,7,6,2,15
11788604889 *2,SENSOR DE OXIGENO MINI MOTOR B38-B48 (EMBLER),1629,3,8,2,13
11811092583 *5,SOPORTE MOTOR (L/R) BMW E46 M52 M54 E85 Z4 M54 N52 E86 Z4 N52 (FEBI) SSF,1835,5,9,7,21
11811140985 *1,SOPORTE MOTOR (L/R) BMW E46 M52 M54 E85 Z4 M54 N52 E86 Z4 N52 (FREY),1944,0,4,5,9
11812283798,SOPORTE DE MOTOR L / R BMW E46 (FEBI),1915,0,5,3,8
1183230400 *1,AMORTIGUADOR AIRE SUSPENSION DELANTERA (R) MERCEDES W117 (FREY),1383,4,0,4,8
1183230400 *5,AMORTIGUADOR AIRE SUSPENSION DELANTERA (R) MERCEDES W117 (GENUINO),1387,5,5,6,16
1183230400 *6,AMORTIGUADOR AIRE SUSPENSION DELANTERA (R) MERCEDES W117 (BILSTEIN) SSF,1280,1,8,2,11
1191800009 *3,FILTRO ACEITE MOTOR MERCEDES W210 (MAHLE OX92D),1404,4,4,2,10
1192001470,POLEA DE TENSOR DE SUPERCARGADOR MERCEDES W202 / M111 ( TRUCKTEC ),1532,5,6,9,20
1192001470 *1,POLEA DE TENSOR DE SUPERCARGADOR MERCEDES W202 / M111 FREY,1736,8,8,4,20
1192001470-1,POLEA DE TENSOR DE SUPERCARGADOR MERCEDES W202 / M111 ( URO ),1226,3,6,0,9
119970647,RETEN DE CIGUEï¿½AL TRASERO MERCEDES W202 ( DPH ),1779,9,7,3,19
119979792,BANDA ACCESORIOS MOTOR MEDIDA 6PK 2390 MM MERCEDES C208 W163 W202 W210 M112 M113 DAYCO,1887,0,0,7,7
12,RENTA HERRAMIENTA DE SICRONIZACION DE MOTOR E90 / N52 / N54 / N55,1510,4,1,1,6
1201800009 *3,FILTRO ACEITE MOTOR MERCEDES BENZ 600SL (MAHLE OX147D),1517,3,2,2,7
1209970346,RETEN DE CIGUEï¿½AL DELANTERO MERCEDES W202 / M111 ( ELRING ),1590,2,9,5,16
1209970346-1,RETEN DE CIGUEï¿½AL DELANTERO MERCEDES W202 / M111 FREY,1875,0,5,0,5
12120032134 *1,BUJIA IGNICION IRIDIUM HIGH POWER BMW N46 N46N N62 N62N (FREY TEGNOLOGIA ALEMANA),1399,8,1,2,11
12120032273 *5,BUJIA IGNICION PLATINO DOBLE ELECTRODO HIGH POWER BMW M3 S85 (NGK) SSF,1933,3,1,4,8
12120037244 *1,BUJIA IGNICION 3 ELECTRODOS HIGH POWER BMW N54 (FREY TEGNOLOGIA ALEMANA),1628,9,2,5,16
12120037244 *5,BUJIA IGNICION 3 ELECTRODOS HIGH POWER BMW N54 (BOSCH) SSF,1370,1,8,1,10
12120037244-100,BUJIA IGNICION 3 ELECTRODOS HIGH POWER BMW N54 INACTIVO,1858,4,6,4,14
12120037580-9,BUJIA DE IGNICION DOBLE HIGH POWER PLATINO BMW MOTOR N14-N16-N18-N20-N63 GENUINA,1913,6,7,5,18
12120037582 *3,BUJIA DOBLE PLATINO BMW N14 N16 N18 N20 N55 N63 (GENUINA),1917,2,1,2,5
12120037607 *1,BUJIA INGNICION 4 ELECTRODOS + PLATINO BMW M54 M62 MINI W10 W11 (FREY TECNOLOGIA ALEMANA),1913,3,6,6,15
12120037607 *5,BUJIA INGNICION 4 ELECTRODOS + PLATINO BMW M54 M62 MINI W10 W11 (BOSCH) SSF,1498,3,5,5,13
12120037607 *9,BUJIA INGNICION 4 ELECTRODOS + PLATINO BMW M54 M62 MINI W10 W11 (NGK),1530,5,6,3,14
12120037607-100,BUJIA DE IGNICION 4 ELECTRODOS + PLATINO HIGH POWER BMW INACTIVO,1814,3,6,9,18
12120037663 *1,BUJIA IGNICION DOBLE PLATINO HIGH POWER BMW N52 N52N (FREY TEGNOLOGIA ALEMANA),1325,1,8,0,9
12120039664 *1,BUJIA INGNICION HIGH POWER BMW N20 N26 N55 MINI N12 N14 N16 N18 (FREY TEGNOLOGIA ALEMANA),1219,4,2,3,9
12120039664 *3,BUJIA INGNICION HIGH POWER BMW N20 N26 N55 MINI N12 N14 N16 N18 (NGK) DGO,1814,5,6,6,17
12120039664 *5,BUJIA INGNICION HIGH POWER BMW N20 N26 N55 MINI N12 N14 N16 N18 (BOSCH) SSF,1960,4,9,3,16
12120040551 *1,BUJIA IGNICION HIGH POWER BMW B38 B42 B46 B48 B58 MINI B36 B38 B38 B46 (FREY TEGNOLOGIA ALEMANA),1219,6,4,5,15
12120040551 *2,BUJIA IGNICION LASER IRIDIUM MINI BMW B38 B48 B58 (GENUINA ),1375,4,9,8,21
12120041666 *3,BUJIA IGNICION HIGH POWER BMW B38 B42 B46 B48 B58 MINI B36 B38 B38 B46 (NGK) DGO,1613,4,3,4,11
12120041666 *5,BUJIA IGNICION HIGH POWER BMW B38 B42 B46 B48 B58 MINI B36 B38 B38 B46 (BOSCH) SSF,1724,2,4,6,12
12121212,CLIENTE EN MOSTRADOR,1612,6,1,0,7
12122158252 *5,BUJIA IGNICION IRIDIUM HIGH POWER BMW N46 N46N N62 N62N (BOSCH) SSF,1432,7,3,9,19
12122158252 *6,BUJIA IGNICION IRIDIUM HIGH POWER BMW N46 N46N N62 N62N (NGK) SSF,1701,9,9,3,21
12122158252-100,BUJIA DE IGNICION IRIDIUM HIGH POWER BMW MOTOR N46N-N46-N62N (GENUINA) INACTIVO,1902,0,9,6,15
12122158252-101,BUJIA DE IGNICION PLATINO BMW MOTOR N46N-N46-N62N BERU INACTIVO,1429,6,8,8,22
12122158253 *5,BUJIA IGNICION DOBLE PLATINO HIGH POWER BMW N52 N52N (BOSCH) SSF,1682,2,3,4,9
12122158253 *9,BUJIA IGNICION DOBLE PLATINO HIGH POWER BMW N52 N52N (NGK),1377,6,7,1,14
12127513032 *5,KIT 4 PZ CABLES IGNICION BUJIAS REFORZADOS A 7MM MINI R50 R52 R53 W10 W11 (BERU) SSF,1950,0,9,3,12
12129063428,BUJIA BOSCH FR7LDC 2 ELECTRODOS MAS PLATINO,1819,6,3,8,17
12131402440,BOBINA DE IGNICION 4 TORNILLOS BMW E36 BMTR,1681,1,6,7,14
12131402440 *1,BOBINA DE IGNICION 4 TORNILLOS BMW E36 FREY,1462,5,4,1,10
12131703228-4,BOBINA DE IGNICION 2 TORNILLOS  BMW E46 M54 WALKER,1988,3,8,8,19
12131712219 *2,BOBINA ENCENDIDO IGNICION BMW M54 S64 (FREY),1341,3,7,8,18
12131730412 *5,CAPUCHON BOBINA IGNICION MOTOR BMW M50 M52 M54 M62 S54 S62 (BREMI) SSF,1982,2,4,7,13
12131730412-1,CAPUCHON DE BOBINA BMW MOTOR M50-M52-M54-M62 BMTR,1325,8,6,7,21
12131748017 *1,BOBINA ENCENDIDO IGNICION BMW M50 M52 M54 M62 (FREY TECNOLOGIA ALEMANA),1923,0,3,0,3
12131748017 *2,BOBINA ENCENDIDO IGNICION BMW M50 M52 M54 M62 (BMTSR),1419,7,4,1,12
12131748018-1,BOBINA DE IGNICION 2 TORNILLOS SEMINUEVA BMW E46 - M54 BOSCH,1681,5,0,0,5
12131748018-2,BOBINA DE IGNICION 2 TORNILLOS  BMW E46 M54 BREMI,1835,4,3,5,12
12137510738 *5,PAQUETE BOBINA INGNICION MINI R50 R52 R53 W10 W11 (BREMI) SSF,1702,5,0,3,8
12138616153 *1,BOBINA ENCENDIDO IGNICION BMW N13 N20 N26 N46N N52N N54 N55 N63 S54 S55 S63 MINI N14 N16 N18 (FREY),1557,0,6,4,10
12138616153 *5,BOBINA IGNICION BMW N13 N20 N26 N46N N52N N54 N55 N63 S54 S55 S63 MINI N14 N16 N18 (BOSCH) SSF,1674,0,8,2,10
12138616153 *6,BOBINA IGNICION BMW MOTOR N52 N52N N46N N54 N55 (DELPHI) SSF,1314,4,3,2,9
12138616153 -100,BOBINA DE IGNICION BMW MOTOR N52-N52N-N46-N46N-N55-N54 INACTIVO,1275,1,3,1,5
12138616153- 100,BOBINA DE IGNICION BMW MOTOR N52-N52N-N46-N46N-N55-N54 BMTR INACTIVO,1508,5,2,6,13
12138616153-100,BOBINA DE INGNICION BMW MOTOR N52 N52N N46 N46N N55 N54 INACTIVO,1242,1,3,4,8
12138643360 *5,BOBINA IGNICION BMW B38 B48 B58 MINI B36 B38 B46 B48 (BOSCH) SSF,1671,0,9,0,9
12138643360 *6,BOBINA IGNICION BMW B38 B48 B58 MINI B36 B38 B46 B48 (BREMI) SSF,1512,1,9,3,13
12138647463 *1,BOBINA IGNICION BMW B38 B48 B58 MINI B36 B38 B46 B48 (FREY),1625,6,0,3,9
12139067831 *1,CAPUCHON BOBINA IGNICION MOTOR BMW M50 M52 M54 M62 S54 S62 (FREY),1799,9,2,4,15
12140872679,SENSOR DE PRESION DE ACEITE MINI R52-R53 FAE,1500,0,2,5,7
12141247622,SENSOR DE CIGUEï¿½AL BMW E36 VAICO,1754,8,8,4,20
12141247622 *1,SENSOR DE CIGUEï¿½AL BMW E36 FREY,1386,5,0,9,14
12141433264,SENSOR DE CIGUEï¿½AL BMW E53-M62 GENUINO,1886,9,9,1,19
12141433264 *1,SENSOR DE CIGUEï¿½AL BMW E53-M62 FREY,1209,8,8,4,20
12141485844,SENSOR DE CIGUEï¿½AL MINI R50 / R53 ( CONTINENTAL ),1482,2,5,1,8
12141485844 *1,SENSOR DE CIGUEï¿½AL MINI R50 R52 R53 (FREY),1584,9,0,8,17
12141485845 *5,SENSOR DE POSICION DE ARBOL DE LEVAS MINI R50 ( BREMI ) SSF,1600,4,1,8,13
12141485845-1,SENSOR DE POSICION DE ARBOL DE LEVAS MINI R50 ( TOPRAN ),1435,9,5,2,16
12141703277 *1,SENSOR CIGUEï¿½AL CON CABLE BRIDA ALINEADA AL CABLE BMW M50 M52 (FREY),1580,5,7,3,15
12141703277-2,SENSOR DE CIGUEï¿½AL BMW E36-M52 TOPRAN,1489,9,2,3,14
12141709616,SENSOR DE CIGUEï¿½AL BMW E46-M54 CONTINENTAL VDO,1954,8,8,3,19
12141709616 *1,SENSOR CIGUEï¿½AL SIN CABLE BMW M43 M52 M54 (FREY),1609,2,0,6,8
12141730028 *1,SENSOR ARBOL LEVAS ESCAPE CON CABLE BRIDA EN ESCUADRA AL CABLE BMW M50 M52 (FREY),1471,8,6,4,18
12141748398,ORING DE SENSOR DE ARBOL DE LEVAS E46-M54 DHP,1290,7,4,8,19
12147518628 *1,SENSOR ARBOL LEVAS ESCAPE SIN CABLE BMW M52 M54 N62 (FREY),1330,0,1,3,4
12147518628 *2,SENSOR DE ARBOL DE LEVAS ESCAPE BMW E46 M54 (BREMY),1680,2,1,6,9
12147539165 *1,SENSOR ARBOL LEVAS ADMISION CON CABLE BMW M52 M54 (FREY),1550,5,6,7,18
12147539165 *2,SENSOR ARBOL LEVAS ADMISION CON CABLE BMW M52 M54 (EMBLER),1826,2,8,6,16
12147539165-100,SENSOR DE ARBOL DE LEVAS ADMISION CON CABLE BMW E46-M54 KZR INACTIVO,1782,6,1,6,13
12147539165-101,SENSOR DE ARBOL DE LEVAS ADMISION CON CABLE BMW E46-M54 TOPRAN INACTIVO,1364,2,7,4,13
12147539166,SENSOR DE ARBOL DE LEVAS ADMISION CON CABLE BMW E53-M62 BMTR,1901,8,3,8,19
12147539166 *1,SENSOR DE ARBOL DE LEVAS ADMISION CON CABLE BMW E53-M62 FREY,1442,6,4,9,19
12147586137,COMPUTADORA DE MOTOR SEMINUEVA MINI R56-R55 CLUBMAN GENUINA,1706,0,9,5,14
12311277229,ALTERNADOR BMW E46 REMANUFACTURADO ORIGINAL,1966,2,9,7,18
12311277229 *1,ALTERNADOR BMW E46 FREY,1805,7,0,7,14
12311432980,ALTERNADOR DE 120 AMP BOSCH BMW E46 ( SEMINUEVO ORIGINAL),1805,1,0,7,8
12311432980-1,ALTERNADOR DE 120 AMP BOSCH BMW E46 FREY,1245,9,5,8,22
12311747920,REGULADOR DE VOLTAJE DE ALTERNADOR BMW E36,1809,6,1,5,12
12311747920 *1,REGULADOR DE VOLTAJE DE ALTERNADOR BMW E36 FREY,1829,7,6,4,17
12317501597,ALTERNADOR DE 120 AMP BOSCH BMW E39 / M52 ( ORIGINAL),1819,4,0,0,4
12317501599 *1,ALTERNADOR MODELO BOSCH 120 AMP BMW Z3 E36 E39 E46 E53 M52 M54 (FREY),1557,3,8,0,11
12317501599 *100,ALTERNADOR MODELO VALEO 120 AMP BMW Z3 E36 E39 E46 E53 M54 M52 (FREY) INACTIVO,1490,6,9,1,16
12317507807,JUNTA DE SOPORTE DEL ALTERNADOR BMW E65 ORIGINAL,1524,7,9,6,22
12317507807 *1,JUNTA DE SOPORTE DEL ALTERNADOR BMW E65 FREY,1394,4,8,6,18
12317507807-2,JUNTA DE SOPORTE DEL ALTERNADOR BMW E65 EMBLER,1829,1,4,4,9
12317507807-3,JUNTA DE SOPORTE DEL ALTERNADOR BMW E65 URO,1707,6,0,5,11
12317507808,JUNTA DE SOPORTE DE ALTERNADOR BMW E70-N62N ORIGINAL,1308,8,2,6,16
12317507808 *1,JUNTA DE SOPORTE DE ALTERNADOR BMW E70-N62N FREY,1668,1,5,6,12
12317507808-1,JUNTA DE SOPORTE DE ALTERNADOR BMW E70-N62N TRUCKTEC,1694,4,7,2,13
12317507808-3,JUNTA DE SOPORTE DE ALTERNADOR BMW E70-N62N EMBLER,1569,5,8,0,13
12317507808-4,JUNTA SOPORTE DE ALTERNADOR BMW E70 N62N (BMTSR),1760,2,0,2,4
12317507996,JUNTA DE ALTERNADOR DE AGUA BMW E65 N73-N62 BOSCH,1519,2,7,0,9
12317507996 *1,JUNTA DE ALTERNADOR DE AGUA BMW E65 N73-N62 FREY,1295,2,5,6,13
12317508054,ALTERNADOR BOSCH ENFRIADO POR AGUA 150 AMP BMW E53  REMANUFACTURADO,1533,0,1,6,7
12317508054 *1,ALTERNADOR BOSCH ENFRIADO POR AGUA 150 AMP BMW E53  FREY,1606,8,7,3,18
12317508607,HOUSING DE ALTERNADOR BMW E65 ( ORIGINAL SEMINUEVO ),1913,1,1,6,8
12317508607 *1,HOUSING DE ALTERNADOR BMW E65 FREY,1697,1,8,1,10
12317516099 *1,POLEA DE SOBRE GIRO DE ALTERNADOR BMW E46 E81 E87 E90 E91 (FREY),1752,6,1,7,14
12317516103 *1,POLEA SOBREGIRO 6PK ALTERNADOR BOSCH BMW N46 N46N N52 (FREY),1763,9,3,0,12
12317516105 *1,POLEA ALTERNADOR 49MM BMW E46 E60-E66 E82 E85 E87 E88 (FREY),1350,0,7,8,15
12317519620,ALTERNADOR 120 AMP.,1769,9,8,4,21
12317533270 *1,ALTERNADOR GENERADOR VOLTAKE 150 AMP BMW E46 E60 E81-E88 E90-E93 (FREY),1396,4,6,3,13
12317540992 *1,ALTERNADOR VOLTAJE 180A BMW E60 E65 E53 N62 (FREY),1627,4,6,9,19
12317541694 *1,ALTERNADOR GENERADOR 14V 155 AMP BMW E46 E60 E65 E66 E83 (FREY),1918,6,8,0,14
12317547082,REGULADOR DE VOLTAJE DE ALTERNADOR BMW E70 (VALEO),1625,7,1,2,10
12317547082 *1,REGULADOR DE VOLTAJE DE ALTERNADOR BMW E70 FREY,1404,9,8,2,19
12317550967,ALTERNADOR 150 AMP BMW MOTOR N52N BOSCH,1301,5,5,0,10
12317550967 *1,ALTERNADOR 150 AMP BMW MOTOR N52N FREY,1653,6,7,6,19
12317551153,REGULADOR DE VOLTAJE DE ALTERNADOR BMW E46 (VALEO),1348,3,9,4,16
12317551153 *1,REGULADOR DE VOLTAJE DE ALTERNADOR BMW E46 FREY,1939,6,2,4,12
12317551254,ALTERNADOR DE 180 AMP BMW E90 / N52 ( BOSCH ),1273,1,7,1,9
12317551256,ALTERNADOR DE 180 AMP BMW E83  BOSCH REMANUFACRURADO,1532,6,2,2,10
12317551256 *5,ALTERNADOR GENERADOR VOLTAJE 150 AMP BMW E60 E70 E81 E83 E84 E90  N52N (ORIGINAL OEM) SSF,1556,2,1,8,11
12317551256-1,ALTERNADOR DE 180 AMP BMW E83 FREY,1855,8,8,8,24
12317555926,ALTERNADOR BOSCH 180 AMP. BMW E90 / N52 ( VALEO ),1837,4,3,6,13
12317555926 *1,ALTERNADOR DE 180 AMP BMW E90 / N52 FREY,1509,4,9,1,14
12317555926 *5,ALTERNADOR GENERADOR VOLTAJE 180 AMP BMW E60 E70 E81 E83 E84 E90  N52N (BOSCH) SSF,1418,7,8,2,17
12317558220 *5,ALTERNADOR DE 180 AMP BMW E60 E61 E82 E88 E90 E91 E92 E93 (BOSCH) SSF,1611,8,8,7,23
12317560678,POLEA DE SOBRE GIRO DE ALTERNADOR RAYADA 7 HILOS BMW E90 / N54 ( INA ),1815,9,8,7,24
12317560678 *1,POLEA DE SOBRE GIRO DE ALTERNADOR RAYADA 7 HILOS BMW E90 / N54 FREY,1932,2,1,6,9
12317561002,ALTERNADOR DE 220 AMP BMW E70-N62N VALEO,1984,7,1,0,8
12317561002 *1,ALTERNADOR DE 220 AMP BMW E70-N62N FREY,1573,7,3,8,18
12317561939,REGULADOR DE VOLTAJE DE ALTERNADOR BMW E90 / N52 ( BOSCH ),1759,7,3,4,14
12317577245,REGULADOR DE VOLTAJE DE ALTERNADOR MINI R56 ( BOSCH ),1209,0,9,8,17
12317603778 *5,ALTERNADOR GENERADOR VOLTAJE 230 AMPERES BMW F01 F02 E71 N54 (VALEO) SSF,1764,6,9,7,22
12317603779 *1,ALTERNADOR GENERADOR VOLTAJE 230 AMP BMW E70 E71 F01 F02 F07 F10-F13 (FREY),1943,6,3,5,14
12317605478 *1,ALTERNADOR DE 170 AMP BMW E84 E89 F10 F11 F15 F16 F20-F26 F30-F36 (FREY),1298,0,0,4,4
12317605478 *A,ALTERNADOR DE 170 AMP BMW E84 E89 F10 F11 F15 F16 F20-F26 F30-F36 (EMBLER),1594,5,0,8,13
12317619254 *1,ALTERNADOR GENERADOR 120 AMP.MINI N12 N14 N16 N18 (VALEO ORIGINAL),2000,9,5,0,14
12317640875 *1,ALTERNADOR GENERADOR 14V 180 AMP BMW F20 F22 F30 F32 F10 F48 F39 F25 F26 MINI F55 (FREY),1882,1,7,1,9
12318510090 *1,REGULADOR DE VOLTAJE DE ALTERNADOR BMW E70  ( FREY ),1967,0,2,8,10
1233200030,AMORTIGUADOR DE SUSPENSION DELANTERA L-R MERCEDES W123 BILSTEIN,1340,2,1,4,7
1233200030 *1,AMORTIGUADOR DE SUSPENSION DELANTERA L-R MERCEDES W123 FREY,1571,2,2,0,4
123456789,ENVIO MOTOCICLISTA,1932,6,6,2,14
123456789 -1,ARTICULO DE PRUEBA PARA EDITAR ORDENES,1204,2,8,1,11
124100-7821,ENFRIADOR DE ACEITE DE TRANSMISION AUTOMATICA HONDA CIVIC BMTRS,1316,1,3,9,13
12411740379 *1,MARCHA MOTOR ARRANQUE 1.4 KW 9 DIENTES BMW E36 Z3 E46 E60 M44 M50 M52 M54 (FREY),1547,5,8,3,16
12412354693-100,MARCHA MOTOR ARRANQUE 1.4 KW 9 DIENTES 76 MM BMW E36 E39 E46 E60 E83 E85 M54 INACTIVO,1444,5,7,6,18
12412354701-100,MARCHA MOTOR DE ARRANQUE BMW N52-N52N-N53-N54-N55 BMTR INACTIVO,1315,9,0,8,17
12417515390,SOLENOIDE AUTOMATICO DE MOTOR DE ARRANQUE BMW E83 (SEMINUEVO),1625,2,8,6,16
12417526236 *1,MARCHA MOTOR ARRANQUE 1.2 KW 9 DIENTES BMW E70 E81 E84 E90 F30 F32 F10 N52N N54 N55 (FREY),1443,8,0,5,13
12417526238,SELENOIDE DE MARCHA SEMINUEVO ORIGINAL E90,1924,3,9,8,20
12417526238 *1,SELENOIDE DE MARCHA SEMINUEVO ORIGINAL E90 FREY,1811,8,4,9,21
12417638193 *1,MARCHA MOTOR ARRANQUE 1.7 KW 12V BMW F20 F21 F30 F31 (FREY),1261,6,7,8,21
12417649090 *5,MARCHA ARRANQUE TRANS  MANUAL 13 DIENTES BMW F45 F46 F48 F54 F55 F56 F57 F60 (OEM) SSF,1796,6,9,0,15
12418658275 *M,MARCHA MOTOR ARRANQUE BMW B36C B38B B38C B46C B48C B48D (EMBLER) TECH,1535,8,8,1,17
12418676403 *5,MARCHA ARRANQUE TRANS  MANUAL 15 DIENTES BMW F48 F55 F56 F57 F60 (OEM) SSF,1303,0,5,2,7
12427505995,MARCHA DE MOTOR DE ARRANQUE BMW E46 BMTR,1949,2,0,6,8
1244200720,BALATAS FRENO DE MANO MERCEDES W202 JURID,1832,9,0,9,18
1244230812,DISCO DE FRENOS DELANTEROS 278X24 MM MERCEDES C36 AMG MEYLE ALEMAN,1589,2,0,4,6
1244230812 *1,DISCO DE FRENOS DELANTEROS 278X24 MM MERCEDES C36 AMG FREY,1680,6,8,7,21
1244270382 *1,GOMA PEDAL FRENO MERCEDES W163 W203 W205 X204 SPRINTER W906 (FREY),1891,9,1,7,17
1244630432 ,AMORTIGUADOR PARA MERCEDES W124 MARCA STABILUS,1998,3,6,6,15
1245000406,TAPON DE DEPOSITO DE ANTICONGELANTE MERCEDES W202 / M111 ( SWAG 10990010 ),1866,0,7,9,16
1245000406 *1,TAPON DE DEPOSITO DE ANTICONGELANTE MERCEDES W202 / M111 FREY,1943,2,7,7,16
1245001549,DEPOSITO DE ANTICONGELANTE MERCEDES W124 GENUINO,1638,3,9,5,17
1245001549 *1,DEPOSITO DE ANTICONGELANTE MERCEDES W124 FREY,1558,1,8,1,10
124880000000,MANIJA DE LIBERACION DE COFRE MERCEDES W202 / W203 / W204 ( FEBI ),1582,9,1,6,16
124880032064 *1,MANIJA DE LIBERACION DE COFRE MERCEDES W202 / W203 / W204 FREY,1681,1,3,6,10
12517646145 *1,CABLE ADAPTADOR TERMOSTATO ENFRIAMIENTO MINI N14 N16 (FREY),1297,8,9,5,22
12518611289,CABLE ADAPTADOR DE TERMOSTATO MINI R56-N18 GENUINO,1540,9,8,5,22
12518638006,CABLE ADAPTADOR DE BOMBA DE ALTA PRESION BMW F20-N20 GENUINO,1896,9,7,5,21
12518638006 *1,CABLE ADAPTADOR DE BOMBA DE ALTA PRESION BMW F20-N20 FREY,1235,3,3,1,7
12521438159 *B,CABLE ARNES 4 PINES BOMBA AGUA ELECTRICA N52 N52N (FREY),1596,3,1,6,10
12521741900,SENSOR INDICADOR TEMPERATURA DE MOTOR BMW E46,1331,1,2,1,4
12521741900 *1,SENSOR INDICADOR TEMPERATURA DE MOTOR BMW E46 FREY,1271,7,2,7,16
12566029,BOMBA DE AGUA CON ASPAS MECANICAS EMBLER,1859,1,1,5,7
12610150684-5,SENSOR DE PRESION DE ACEITE DE MOTOR BMW E46-M54 FAE,1504,6,7,1,14
12611730160 *1,SENSOR DE PRESION DE ACEITE DE MOTOR BMW E46-M54 FREY,1838,4,6,8,18
12611744292,JUNTA DE SENSOR DE NIVEL DE ACEITE BMW E46-M54 ELRING,1221,8,9,0,17
12611744292 *1,JUNTA DE SENSOR DE NIVEL DE ACEITE BMW E46-M54 FREY,1964,6,4,8,18
12617501786 *1,SENSOR NIVEL ACEITE MOTOR BMW N46 N46N (FREY),1983,5,9,4,18
12617501786 *5,SENSOR NIVEL ACEITE MOTOR BMW N46 N46N (HELLA) SSF,1999,3,3,8,14
12617501786-100,SENSOR DE NIVEL DE ACEITE DE MOTOR BMW E87-N46 INACTIVO,1474,5,3,0,8
12617508003,SENSOR DE NIVEL DE ACEITE DE MOTOR BMW E46 ORIGINAL,1381,3,1,5,9
12617508003 *1,SENSOR NIVEL ACEITE MOTOR BMW E46 M54 (FREY),1705,0,1,9,10
12617508003 *5,SENSOR NIVEL ACEITE MOTOR BMW E46 M54 (HELLA) SSF,1908,1,4,9,14
12617513068 *5,SENSOR PRESION ACIETE MOTOR MINI W10 ASPIRACION NATURAL W11 SUPER CARGADO (VEMO),1213,4,1,1,6
12617549796,SENSOR DE PRESION DE ACEITE BMW E90-N52N ORIGINAL,1666,2,1,5,8
12617549796 *1,SENSOR PRESION ACEITE MOTOR BMW N52N (FREY),1378,0,6,8,14
12617568481,INTERRUPTOR DE LA PRESION DE ACIETE FAE,1792,1,5,3,9
12617592532,SENSOR DE PRESION DE ACEITE BMW E90 / N54 ( GENUINO ),1454,2,2,8,12
12617592532 *1,SENSOR DE PRESION DE ACEITE BMW E90 / N54 FREY,1606,0,3,0,3
12617592532-2,SENSOR DE PRESION DE ACEITE BMW E90-N54 URO,1592,5,5,0,10
12617607910 *1,SENSOR NIVEL ACEITE MOTOR BMW N52 N52N N54 N55 N62N (FREY),1303,4,9,7,20
12617638341,SENSOR DE NIVEL DE ACEITE DE MOTOR BMW F10/ F20/ F25/ F30 - N20 ( FEBI ),1826,4,8,6,18
12617638341 *1,SENSOR DE NIVEL DE ACEITE DE MOTOR BMW F10/ F20/ F25/ F30 - N20 FREY,1643,3,4,3,10
12618611273,SENSOR DE PRESION DE ACEITE DE MOTOR BMW E46 ORIGINAL,1700,3,8,6,17
12618611273-1,SENSOR DE PRESION DE ACEITE DE MOTOR BMW E46-M54 REIN,1771,0,1,0,1
12618611273-3,SENSOR DE PRESION DE ACEITE DE MOTOR BMW E46-M54 MEISTERSATZ,1597,7,5,2,14
12618638755 *1,SENSOR NIVEL ACEITE MOTOR BMW B37 B38 B47 B48 B58 (FREY),1646,7,6,1,14
12630084-100,BOMBA AGUA ENFRIAMIENTO MOTOR CAVALIER  MALIBU CAPTIVA G5 G6 2.2 2.4 (EMBLER) INACTIVO,1641,5,2,6,13
12637614585 *1,MODULO FUENTE ALIMENTACION INTEGRADA DE CORRIENTE ELECTRICA BMW F20 F21 (FREY),1953,7,9,6,22
12637633242 *1,MODULO DISTRIBUCION PODER CORRIENTE ICM BMW F10 F12 F20 F22 F30 F32 (FREY),1766,5,9,3,17
12639408,ENFRIADOR DE ACEITE DE MOTOR CHEVROLET HHR TAIFA,1419,8,4,7,19
12639409,ENFRIADOR DE ACEITE DE TRANSMISION AUTOMATICA CHEVROLET HHR TF-1282 BMTRS,1851,5,9,7,21
1270603,SENSOR DE CIGUEï¿½AL VOLVO S40 ( FACET ),1663,8,6,1,15
1275602 *5,BOBINA IGNICION VOLVO S40 V40 MOTOR 1.9 L 4 CIL. (BREMI) SSF,1503,3,6,9,18
1275603 *5,KIT 2 PZ. CABLES BUJIA INGNICION VOLVO S40 V40 1.9 L 4 CIL (BOUGICORD) SSF,1269,9,8,4,21
1275810 *3,FILTRO ACEITE MOTOR VOLVO S40 2a GEN (MAHLE OX149D),1678,7,4,8,19
1275810 *5,FILTRO ACEITE MOTOR VOLVO S40 2a GEN (PRO PARTS) SSF,1825,7,7,3,17
129975492,BANDA DE SUPERCARGADOR 6PK1352 MERCEDES R170 CONTINENTAL,1439,9,5,5,19
130320-100,HERRAMIENTA PARA INYECTORES BMW N20-N55 HT INACTIVO,1493,9,1,4,14
13126710,AMPLIFICADOR DE FRENO OPEL VECTRA C SEMINUEVO (ORIGINAL),1633,4,3,6,13
13131313,PICK UP,1609,6,8,4,18
1320160021 *1,JUNTA TAPA PUNTERIAS SMART FORTWO 2007 A 2015 W451 (FREY),1613,7,7,5,19
1321800110 *3,FILTRO ACEITE MOTOR SMART FOR TWO (MAHLE OC607),1347,6,2,2,10
1322000015,TERMOSTATO REFRIGERANTE SMART FORTWO METZGER,1800,6,2,5,13
1322000015 *1,TERMOSTATO REFRIGERANTE SMART FORTWO W451 (FREY),1555,1,8,1,10
1322200048,SOPORTE DE MOTOR (R) SMART CORTECO,1328,6,0,1,7
1322200048 *1,SOPORTE DE MOTOR (R) SMART (FREY),1351,2,2,8,12
1322200048 *2,SOPORTE DE MOTOR (R) SMART (EMBLER),1353,1,6,3,10
1322200148,SOPORTE DE MOTOR (L) SMART CORTECO,1842,6,3,8,17
1322200148 *1,SOPORTE DE MOTOR (L) SMART ( FREY ),1607,7,8,5,20
1322200248 *1,SOPORTE MOTOR (L/R) SMART FORTWO W451 (FREY),1681,2,1,3,6
1331370161 *3,FILTRO ENTRADA AIRE MOTOR VOLVO S60 S80 (MAHLE LX1591/9),1873,9,6,9,24
13321407299 *3,FILTRO COMBUSTIBLE GASOLINA BMW 5 E39 (MAHLE KL104),1654,7,6,5,18
13321702632 *1,FILTRO COMBUSTIBLE GASOLINA SIN REGULADOR BMW E38 E39 (FREY),1258,5,9,1,15
13321702632 *3,FILTRO COMBUSTIBLE GASOLINA SIN REGULADOR BMW E36 (MAHLE KL66),1325,4,8,2,14
13321702632-2,FILTRO COMBUSTIBLE GASOLINA SIN REGULADOR BMW E36 MANN WK516/1,1707,3,7,4,14
13321709535 *1,FILTRO COMBUSTIBLE GASOLINA LARGO REGULADOR EXPUESTO BMW E38 E39 E53 (FREY),1815,6,6,1,13
13321709535 *3,FILTRO COMBUSTIBLE GASOLINA LARGO REGULADOR EXPUESTO BMW E38 E39 E53 (MAHLE KL96),1989,8,3,9,20
13321740985 *,FILTRO COMBUSTIBLE GASOLINA SIN REGULADOR BMW E36-E39-E46 (MAHLE KL66),1518,2,6,3,11
13327512019 *1,FILTRO COMBUSTIBLE GASOLINA REGULADOR INTEGRADO BMW E36 Z3 E46 E65 (FREY),1760,3,5,3,11
13327512019 *3,FILTRO COMBUSTIBLE GASOLINA REGULADOR INTEGRADO BMW E36 Z3 E46 E65 (MAHLE KL149),1476,7,7,1,15
13327512019 *5,FILTRO COMBUSTIBLE GASOLINA REGULADOR INTEGRADO BMW E36 Z3 E46 E65 (BOSCH) SSF,1296,1,8,3,12
13411435846,VALVULA DE REGULACION DEL RALENTI BMW E36,1567,2,3,7,12
13411435846 *1,VALVULA DE REGULACION DEL RALENTI BMW E36 FREY,1323,7,1,1,9
13411744713 *2,VALVULA CONTROL AIRE RALENTI MARCHA MINIMA BMW M52 M54 (EMBLER) GOG,1342,7,2,8,17
1350900501,FILTRO ENTRADA AIRE MOTOR SMART FOR FOURT C2584,1979,4,8,7,19
13517584461 *1,BOMBA GASOLINA ALTA PRESION CONECTOR ANCHO BMW F20 F30 F32 F10 F15 F25 N20 N26 (FREY),1655,5,9,1,15
13517588879 *5,BOMBA GASOLINA ALTA PRESION MINI N14 PEUGEOT 207 2008 308 (OEM) SSF,1647,6,2,0,8
13517588879-100,BOMBA GASOLINA ALTA PRESION MINI N14 PEUGEOT 207 2008 308 INACTIVO,1476,3,7,4,14
13517592429 *5,BOMBA GASOLINA ALTA PRESION MINI N18 PEUGEOT 207CC (GENUINA BMW) SSF,1294,3,6,5,14
13517595339,BOMBA DE ALTA PRESION DE GASOLINA BMW E70-S63 GENUINA,1842,8,8,3,19
13517595339 *1,BOMBA GASOLINA ALTA PRESION BMW N63 S63 (FREY),1568,8,0,6,14
13517607159 *1,BOMBA GASOLINA MECANICA ALTA PRESION CONECTOR ANCHO 30 MM BMW F20 F30 N13 (FREY),1381,4,4,7,15
13517610761 *1,BOMBA GASOLINA MECANICA ALTA PRESION BMW N55 TWIN TURBO (FREY),1371,3,5,8,16
13517616194 *1,BOMBA GASOLINA MECANICA ALTA PRESION BMW N54 N55 (FREY),1869,2,9,6,17
13517616194 *6,BOMBA GASOLINA MECANICA ALTA PRESION BMW N54 N55 (VEMO) SSF,1700,7,9,3,19
13517616446 *5,BOMBA GASOLINA ALTA PRESION BMW N54 N55 (GENUINA BMW) SSF,1640,5,2,6,13
13517636881 *1,BOMBA GASOLINA MECANICA ALTA PRESION BMW B38 B46 B48 MINI B36 B38 B46 B48 (FREY),1271,3,5,1,9
13518604229 *1,BOMBA GASOLINA ALTA PRESION CONECTOR DELGADO BMW F20 F30 F32 F10 F15 F25 N20 N26 (FREY),1516,7,1,4,12
13518604229 *5,BOMBA GASOLINA ALTA PRESION CONECTOR DELGADO BMW F20 F30 F32 F10 F15 F25 N20 N26 (BOSCH) SSF,1789,6,9,0,15
13518604231 *5,BOMBA GASOLINA MECANICA ALTA PRESION BMW N55 TWIN TURBO (BOSCH) SSF,1285,4,5,9,18
13518605102 *5,BOMBA GASOLINA ALTA PRESION CONECTOR DELGADO 12 MM MINI R55 A R61 N18 (BOSCH) SSF,1284,7,8,7,22
13518605103 *1,BOMBA GASOLINA MECANICA ALTA PRESION CONECTOR DELGADO 12 MM BMW F20 F30 N13 (FREY),1936,1,1,7,9
13518605103 *5,BOMBA COMBUSTIBLE GASOLINA ALTA PRESION CONTECTOR DELGADO 12 MM BMW F20 F30 N13 (BOSCH),1718,4,6,3,13
13531435950,TAPA DE MOTOR BMW E38 E39 E53 E65 E66 E85 SEMINUEVA (ORIGINAL),1815,0,5,9,14
1353753134-100,INYECCTOR GASOLINA BMW E90 N52 INACTIVO,1490,3,7,7,17
13537531634 *5,INYECTOR COMBUSTIBLE GASOLINA BMW N52 N52N (GB) SSF,1810,6,4,4,14
13537536566,CONDUCTO DE ALTA PRESION BMW E90-N54,1298,7,9,2,18
13537536566 *1,CONDUCTO DE ALTA PRESION BMW E90-N54 FREY,1238,5,4,6,15
13537537318,SOPORTE PARA INYECTOR DE GASOLINA BMW E90 GENUINO,1638,8,8,5,21
13537537318 *1,SOPORTE PARA INYECTOR DE GASOLINA BMW E90 FREY,1849,8,7,8,23
13537537319 *5,SENSOR ALTA PRESION GASOLINA BMW B32 B38 B42 B46 B48 B58 N20 N26 N55 N63N (BOSCH) SSF,1344,0,4,7,11
13537537319 *6,SENSOR ALTA PRESION COMBUSTIBLE BMW N13 N18 N54 N63 S63 (GENUINO) SSF,1912,2,6,4,12
13537537319-1,SENSOR ALTA PRESION GASOLINA BMW F30 (METZGER),1636,3,1,5,9
13537546244,INYECTORES SEMINUEVOS,1887,1,8,6,15
13537546244 *2,INYECTOR COMBUSTIBLE GASOLINA ALTA PRESION BMW E36 E38 E39 E46 E60 E61 E83 E85 (EMBLER),1660,6,7,3,16
13537546245 *5,INYECTOR COMBUSTIBLE GASOLINA BMW M54 (GB) SSF,1601,9,2,3,14
13537568050,SENSOR DE ALTA PRESION DE GASOLINA MINI R56-N14 ORIGINAL,1598,1,6,4,11
13537614317 *5,SENSOR BAJA PRESION COMBUSTIBLE BMW E88 E90 E60 E63 E70 E71 F01 F10 N54 N55 (VEMO) SSF,1753,7,8,6,21
13537622231 *2,SENSOR DE PRESION DE COMBUSTIBLE BMW F30 E82 (BOSCH) SSF,1892,5,0,0,5
13537622751 *1,SENSOR BAJA PRESION COMBUSTIBLE GASOLINA BMW N54 (FREY),1720,6,3,7,16
13538616079,INYECTOR DE GASOLINA SEMINUEVO BMW E90-N54 GENUINO,1627,6,3,6,15
13538616079 *1,INYECTOR DE GASOLINA REMANUFACTURADO BMW E90-N54 FREY,1274,9,2,4,15
13538616079 *5,INYECTOR COMBUSTIBLE ALTA PRESION SEMI NUEVO BMW N54 N63 S63 (GENUINO) EBY,1522,8,7,7,22
13538616079 *6,INYECTOR DE GASOLINA REMANUFACTURADO BMW E90-N54 (VITESCO) SSF,1419,7,1,9,17
13541433414,CUERPO DE ACELERACIï¿½N BMW E46 / M54 ( SEMINUEVO ORIGINAL ),1705,2,5,6,13
13541433414 *1,CUERPO DE ACELERACIï¿½N BMW E46 / M54 FREY,1631,9,7,3,19
13541435625,TUBO MANGUERA DE SENSOR E39 TOPRAN,1974,0,3,2,5
13541435627 *1,MANGUERA PRIMARIA ENTRADA AIRE MOTOR BMW E36 Z3 E39 E46 M52 M54 2.0 2.3 2.5 2.8 L (FREY),1739,2,7,7,16
13541435627 *2,MANGUERA PRIMARIA ENTRADA AIRE MOTOR BMW  E36 Z3 E39 E46 M52 M54 2.0 2.3 2.5 2.8 L (EMBLER) GOG,1420,9,9,1,19
13541435627 *5,MANGUERA PRIMARIA ENTRADA AIRE MOTOR BMW E36 Z3 E39 E46 M52 M54 2.0 2.3 2.5 2.8 L (REIN) SSF,1891,8,6,9,23
13541435627 *6,MANGUERA PRIMARIA ENTRADA AIRE MOTOR BMW E36 Z3 E39 E46 M52 M54 2.0 2.3 2.5 2.8 L (FEBI) SSF,1599,4,8,7,19
13541438759 *1,MANGUERA PRIMARIA ENTRADA AIRE MOTOR BMW E36 Z3 M54 E46 M54 3.0 L (FREY),1279,8,9,8,25
13541438759 *5,MANGUERA PRIMARIA ENTRADA AIRE MOTOR BMW E36 Z3 M54 E46 M54 3.0 L (REIN) SSF,1354,4,2,7,13
13541438761 *1,MANGUERA SECUNDARIA ENTRADA AIRE MOTOR BMW E36 Z3 E46 M54 3.0 L (FREY ),1410,0,0,8,8
13541438761 *2,MANGUERA SECUNDARIA ENTRADA AIRE MOTOR BMW E36 Z3 E46 M54 3.0 L (EMBLER),1591,5,2,9,16
13541438761 *5,MANGUERA SECUNDARIA ENTRADA AIRE MOTOR BMW E36 Z3 E46 M54 3.0 L (FEBI) SSF,1328,2,4,0,6
13541440102 *1,MANGUERA PRIMARIA ENTRADA AIRE MOTOR BMW E53 M54 3.0 L (FREY),1713,7,7,1,15
13541440102 *2,MANGUERA PRIMARIA AIRE MOTOR BMW E53 M54 3.0 L (EMBLER) GOG,1743,5,4,4,13
13541440102 *5,MANGUERA PRIMARIA ENTRADA AIRE MOTOR BMW E53 M54 3.0 L (FEBI) SSF,1623,4,0,7,11
13541440102 *6,MANGUERA PRIMARIA ENTRADA AIRE MOTOR BMW E53 M54 3.0 L (REIN) SSF,1755,7,1,8,16
13541703588 *1,MANGUERA ENTRADA AIRE MOTOR BMW E36 M52 (FREY),1864,0,3,6,9
13541703588 *5,MANGUERA PRIMARIA ENTRADA AIRE MOTOR BMW Z3 E36 M52 (URO) SSF,1496,7,7,8,22
13541705209 *1,MANGUERA SECUNDARIA ENTRADA AIRE MOTOR BMW E36 Z3 E46 M52 M54 2.0 2.3 2.5 2.8 L (FREY),1421,6,4,5,15
13541705209 *2,MANGUERA SECUNDARIA ENTRADA AIRE MOTOR BMW E36 Z3 E46 M52 M54 2.0 2.3 2.5 2.8 L (EMBLER) GOG,1677,4,5,5,14
13541705209 *5,MANGUERA SECUNDARIA ENTRADA AIRE MOTOR BMW E36 Z3 E46 M52 M54 2.0 2.3 2.5 2.8 L (FEBI) SSF,1767,7,4,0,11
13541705209 *9,TUBO DE ASPIRACION DE CUERPO DE ACELERACION BMW E46-M54 ( REIN ),1960,1,6,4,11
13541705209-100,TUBO DE ASPIRACION DE CUERPO DE ACELERACION BMW E46-M54 INACTIVO,1687,2,2,5,9
13541740073,MANGUERA DE ENTRADA DE AIRE DE MOTOR BMW E36-M52  (URO ),1345,6,2,1,9
13541740073 *1,MANGUERA DE ENTRADA DE AIRE BMW E36-M52 DORMAN ALEMAN,1487,5,6,1,12
13541740073 *2,MANGUERA DE ENTRADA DE AIRE DE MOTOR BMW E36-M52 FREY,1553,1,6,5,12
13541740073 *3,MANGUERA DE ENTRADA DE AIRE BMW E36-M52 EMBLER,1735,4,3,9,16
13541740073 *4,MANGUERA ENTRADA AIRE MOTOR BMW E36 M52 (REIN),1451,7,9,0,16
13543412291 *1,MANGUERA ENTRADA AIRE MOTOR BMW E83 M54 2.5 L (FREY),1869,2,9,0,11
13543412291 *2,MANGUERA ENTRADA AIRE MOTOR BMW E83 M54 2.5 L (EMBLER) GOG,1981,4,1,9,14
13543412291 *5,MANGUERA PRIMARIA ENTRADA AIRE MOTOR BMW E83 M54 2.5 L (URO) SSF,1946,1,8,7,16
13543412292 *5,MANGUERA PRIMARIA ENTRADA AIRE MOTOR BMW E83 M54 3.0 L (REIN) SSF,1442,9,9,1,19
13543412292-100,MANGUERA ENTRADA AIRE MOTOR BMW E83 M54 3.0 L (REIN) INACTIVO,1258,2,4,4,10
13547505836,MANGUERA DE ENTRADA DE AIRE DE MOTOR BMW E39 DORMAN ALEMAN,1404,9,3,8,20
13547556118,CUERPO DE ACELERACIï¿½N BMW E90 ( SEMINUEVO ORIGINAL ),1907,9,5,9,23
13547556118 *1,CUERPO DE ACELERACIï¿½N BMW E90 FREY,1531,3,0,8,11
13547556118 *5,CUERPO ACELERACION BMW E60 E70 E81 E83 E84 E89 E90 F10 F25 N52N (ORIGINAL CONTINENTAL) SSF,1789,7,0,7,14
13547604918 *5,CUERPO DE ACELERACION MINI R56-N14 (CONTINENTAL) SSF,1697,7,7,8,22
13547618838 *3,CUERPO ACELERACION MINI F56 (EMBLER),1421,7,8,2,17
13548624189 *3,CUERPO DE ACELERACION MINI R55 R56 R57 R58 R59 R60 R61 (VDO CONTINENTAL),1763,7,7,9,23
13548624190,CUERPO DE ACELERACION MINI R56 / N16 ( GENUINO ),1483,8,3,6,17
1362143-100,SENSOR MASA AIRE MOTOR MAF BMW INACTIVO,1957,3,8,1,12
13621432356 *1,SENSOR MASA AIRE MOTOR MAF BMW Z3 E36 E38 E39 E46 M52 M54 2.5 L  (FREY),1825,6,5,9,20
13621432356 *5,SENSOR MASA AIRE MOTOR MAF BMW Z3 E36 E38 E39 E46 M52 M54 2.5 L (BREMI) SSF,1876,8,6,8,22
13621433076,SENSOR DE TEMPERATURA DE MOTOR BMW E46-M54 BMTR,1505,5,4,5,14
13621433076 *1,SENSOR TEMPERATURA MOTOR BMW M52 M54 (FREY),1467,2,6,7,15
13621433076-1,SENSOR DE TEMPERATURA DE MOTOR BMW E46-M54 GENUINO,1491,5,8,7,20
13621433076-3,SENSOR DE TEMPERATURA DE MOTOR BMW E46-M54 FAE,1541,8,2,0,10
13621433076-4,SENSOR DE TEMPERATURA DE MOTOR BMW E46-M54 MEISTERSATZ,1241,6,8,3,17
13621433076-5,SENSOR DE TEMPERATURA ANTICONGELANTE BMW E46-M54 OSSCA,1874,2,8,3,13
13621433077 *1,SENSOR TEMPERATURA RADIADOR ENFRIAMIENTO MOTOR BMW FREELANDER (FREY),1293,1,7,2,10
13621433077 *5,SENSOR TEMPERATURA RADIADOR ENFRIAMIENTO MOTOR BMW (FACET) SSF,1910,4,2,8,14
13621433077-100,SENSOR DE TEMPERATURA DE RADIADOR BMW E46 TOPRAN INACTIVO,1540,0,3,9,12
13621433567,SENSOR DE MASA DE AIRE MAF BMW E53 / M62 ( SIEMENS VBO ),1695,7,7,1,15
13621433567 *1,SENSOR DE MASA DE AIRE MAF BMW E53 / M62 FREY,1795,7,5,1,13
13621438871 *1,SENSOR MASA AIRE MOTOR MAF BMW Z3 E36 E39 E46 E53 M54 3.0 L (FREY),1438,5,4,7,16
13621438871-2,SENSOR DE MASA DE AIRE MAF BMW E46-E53 MOTOR M54-3.0 BMTSR,1442,5,4,7,16
13621703275,SENSOR DE MASA DE AIRE MAF BMW E36-M52 BMTR,1845,5,8,6,19
13621703275 *1,SENSOR DE MASA DE AIRE MAF BMW E36-M52 FREY,1570,1,2,9,12
13621703275 *5,SENSOR MASA AIRE MOTOR MAF BMW E36 M52 (BREMI) SSF,1206,6,2,2,10
13621703993,SENSOR DE TEMPERATURA DE MOTOR BMW E53-N62 FAE,1426,6,0,8,14
13621703993 *1,SENSOR SWICH DOBLE TEMPERATURA MOTOR BMW M44 M52 M54 M62 N62 (FREY),1509,8,9,5,22
13621747155,SENSOR DE MASA DE AIRE MAF BMW E39-M62 BMTR,1402,1,5,7,13
13621747155 *1,SENSOR DE MASA DE AIRE MAF BMW E39-M62 FREY,1498,9,1,9,19
13627520519 *1,SENSOR MASA AIRE MAF BMW E84 E85 E90 E60 E63 N52 N52N E60 M54 (FREY),1621,5,7,4,16
13627520519 *5,SENSOR MASA AIRE MAF BMW E84 E85 E90 E60 E63 N52 N52N E60 M54 (BREMI) SSF,1429,8,6,0,14
13627520519-1,SENSOR DE MASA DE AIRE MAF SEMINUEVO BMW MOTOR N52-N52N-M54-N46N SIEMENS VDO,1352,7,4,9,20
13627520519-2,SENSOR DE MASA DE AIRE MAF NUEVO BMW MOTOR N52-N52N-M54-N46N ( CONTINENTAL ),1624,6,6,2,14
1362752501-7,SENSOR DE CIGUEï¿½AL NUEVO BMW E90 - N52N BREMI,1465,3,9,9,21
13627525014 *1,SENSOR ARBOL LEVAS MOTOR (L/R) BMW B38 B48 N20 N26 N46N N52 N52 N54 N55 N62N (FREY),1858,5,0,1,6
13627525014-3,SENSOR DE ARBOL DE LEVAS BMW E90-N52 CONTINENTAL,1569,0,4,6,10
13627525015,SENSOR DE CIGUEï¿½AL SEMINUEVO BMW E90 - N52N CONTINENTAL,1629,2,0,8,10
13627525015 *1,SENSOR POSICION CIGï¿½Eï¿½AL MOTOR BMW N52 N52N N54 N63 S63 (FREY),1602,5,0,3,8
13627525015-2,SENSOR DE CIGï¿½Eï¿½AL NUEVO BMW E90 - N52N FAE,1262,4,6,9,19
13627525015-4,SENSOR DE CIGUEï¿½AL NUEVO BMW E90 - N52N CONTINENTAL,1861,3,0,5,8
13627525015-8,SENSOR DE CIGUEï¿½AL NUEVO BMW E90 - N52N BEMQW,1546,6,4,3,13
13627535068 *5,SENSOR TEMPERATURA ANTICONGELANTE ENFRIAMIENTO MOTOR COOPER N12 N14 N16 N18 (FACET) SSF,1288,3,7,4,14
13627535068-1,SENSOR DE TEMPERATURA DE MOTOR MINI R56-N12 VAICO,1702,4,2,3,9
13627535068-2,SENSOR DE TEMPERATURA DE MOTOR MINI R56-N12 VEMO,1761,5,5,6,16
13627539811,SENSOR BOSCH,1570,6,7,5,18
13627542418 *1,SENSOR MASA AIRE MOTOR MAF MINI R55 R56 R57 N12 N14 (FREY),1860,8,7,6,21
13627548103,SENSOR DE MASA DE AIRE MAF BMW E70 / N62N ( BOSCH ),1996,3,0,6,9
13627548103-1,SENSOR DE MASA DE AIRE MAF BMW E70 / N62N FREY,1979,0,9,3,12
13627548994,SENSOR DE CIGUEï¿½AL BMW E87 - N46 ( ORIGINAL ),1214,2,5,9,16
13627548994 *1,SENSOR DE CIGUEï¿½AL BMW E87-N46 FREY,1817,8,8,8,24
13627548994-1,SENSOR DE CIGUEï¿½AL BMW E87-N46 FAE,1410,8,0,0,8
13627548994-3,SENSOR DE CIGUEï¿½AL BMW E87-N46 OPTIMAL,1974,7,3,7,17
13627548995,SENSOR DE CIGUEï¿½AL BMW E70 GENUINO,1981,3,1,1,5
13627548995 *1,SENSOR DE CIGUEï¿½AL BMW E70 FREY,1747,4,8,8,20
13627548995-2,SENSOR DE CIGUEï¿½AL BMW E70 OPTIMAL,1656,6,6,1,13
13627551638 *5,SENSOR MASA AIRE MOTOR MAF BMW N52 N52N (BREMI) SSF,1264,9,5,7,21
13627561753 *1,SENSOR CIGï¿½Eï¿½AL MOTOR BMW N13 MINI N12 14 N16 N18 (FREY),1809,7,4,3,14
13627561753-1,SENSOR DE CIGï¿½Eï¿½AL MINI R56 / N12 ( TOPRAN ),1816,0,1,9,10
13627561753-2,SENSOR DE CIGï¿½Eï¿½AL MINI R56 / N12 ( BOUGICORD ),1905,8,2,6,16
13627566983 *1,SENSOR MASA AIRE MOTOR MAF BMW Z4 E85 E83 M54 3.0 L (FREY),1358,8,6,8,22
13627566983 *5,SENSOR MASA AIRE MOTOR MAF BMW Z4 E85 E83 M54 3.0 L (BREMI) SSF,1801,8,8,1,17
13627566984 *5,SENSOR MASA AIRE MOTOR MAF BMW Z4 E85 X3 E83 2.5 L (BREMI) SSF,1997,1,0,4,5
13627566988,SENSOR DE MASA DE AIRE MAF BMW E60 / N62 ( BOSCH ),1244,3,7,0,10
13627566988 *1,SENSOR DE MASA DE AIRE MAF BMW E60 / N62 FREY,1985,0,0,7,7
13627566989,SENSOR DE MASA DE AIRE MAF BMW E87 / N46 ( BMTR ),1993,8,2,6,16
13627566989 *1,SENSOR DE MASA DE AIRE MAF BMW E87 / N46 FREY,1516,1,6,3,10
13627566989 *3,SENSOR DE MASA DE AIRE MAF BMW E87 / N46 (PIERBURG),1809,5,7,4,16
13627566990,SENSOR DE MASA DE AIRE MAF BMW N62 N62N N63 ( FREY ),1379,9,6,6,21
13627566990 *5,SENSOR FLUJO MASA AIRE MAF SEMINUEVO BMW N62 N62N N63 (GENUINO) EBY,1219,4,5,2,11
13627567451 *5,SENSOR MASA AIRE MOTOR MAF BMW Z3 E36 E39 E46 E53 M54 3.0 L (BREMI) SSF,1927,2,1,0,3
13627567451-100,SENSOR DE MASA DE AIRE MAF BMW E53 - M54 INACTIVO,1571,9,6,3,18
13627568421,SENSOR DE DETONACION BMW E39 / E60 ( BOSCH ),1481,7,8,5,20
13627568421 *1,SENSOR DE DETONACION BMW E39 / E60 FREY,1680,7,6,8,21
13627580635,SENSOR DE TEMPERATURA DE NIVEL DE ACEITE BMW E90 / N55 ( GENUINO ),1512,2,6,9,17
13627580635 *1,SENSOR DE TEMPERATURA DE NIVEL DE ACEITE BMW E90 / N55 FREY,1661,2,2,2,6
13627582842 *1,SENSOR CIGUEï¿½AL MOTOR BMW N55 (FREY),1847,8,8,7,23
13627584-100,SENSOR DE MASA DE AIRE MAF BMW Z4 E83 E85 M54 2.5L INACTIVO,1760,6,2,3,11
13627585492 *1,SENSOR MULTIPLE ADMISION MAP BMW N54 N63 S63 (FREY),1449,0,1,6,7
13627585492 *2,SENSOR MULTIPLE ADMISION MAP BMW N54 N63 S63 (VDO),1225,0,4,1,5
13627585493 *1,SENSOR PRESION ABSOLUTA MULTIPLE MAP CONECTOR DELGADO  BMW N54 N55 N63 (FREY),1908,6,3,1,10
13627585493-1,SENSOR DE PRESION MULTIPLE MAP SEMINUEVO BMW MOTOR N54-N55-N63-N74 GENUINO,1836,5,1,4,10
13627585493-3,SENSOR DE PRESION MULTIPLE MAP BMW MOTOR N54-N55-N63-N74 VDO,1566,6,2,8,16
13627588095,SENSOR DE ARBOL DE LEVAS ( SIN CABLE ) MINI N13-N14-N18 ( BOSCH ),1745,0,4,8,12
13627588095 *1,SENSOR DE ARBOL DE LEVAS MINI COOPER R56 ( SIN CABLE ) FREY,1911,7,5,0,12
13627588095-1,SENSOR DE ARBOL DE LEVAS ( SIN CABLE ) MINI COOPER MOTOR N13-N14-N18 VEMO,1900,0,2,5,7
13627588095-2,SENSOR DE ARBOL DE LEVAS MINI COOPER R56 ( SIN CABLE ) TOPRAN,1818,5,8,3,16
13627593-100,SENSOR MASA AIRE MOTOR MAF BMW1 F02 F11 F25 N52N N55 INACTIVO,1496,7,2,0,9
13627593624 *1 ,SENSOR MASA AIRE MOTOR MAF BMW E70 E81 E84 E90 F10 F15 F16 F26 F26 N55 F01 F02 F11 F25 N52N N55 (FREY),1531,7,7,3,17
13627593624 *5,SENSOR MASA AIRE MOTOR MAF BMW E70 E81 E84 E90 F10 F15 F16 F26 F26 N55 F01 F02 F11 F25 N52N N55 (BREMI) SSF,1730,3,1,8,12
13627595860,SENSOR DE CIGï¿½Eï¿½AL BMW F30 / N20 ( GENUINO ),1571,5,2,0,7
13627595860 *1,SENSOR CIGï¿½Eï¿½AL BMW N20 N26 (FREY),1224,5,4,0,9
13627597085,SENSOR DE MASA DE AIRE MAF MINI R56 / N16 ( SIEMENS VBO ),1723,9,4,9,22
13627597085-1,SENSOR DE MASA DE AIRE MAF SEMINUEVO MINI R56 / N16 ( GENUINO ),1227,1,5,5,11
13627599042 *1,SENSOR PRESION ABSOLUTA MULTIPLE MAP CONECTOR ANCHO BMW N54 N55 N63 (FREY),1957,5,7,7,19
13627599907,SENSOR MAP BMW F21 FAE,1376,3,1,4,8
13627599907 *1,SENSOR MAP BMW F21 FREY,1220,9,0,4,13
13627602038 *1,SENSOR MASA AIRE MAF BMW B38 N13 N20 N26 S63N (FREY),1316,1,4,0,5
13627602038 *5,SENSOR MASA AIRE MAF SEMINUEVO BMW B36 B38 B42 B48 N13 N20 N26 (GENUINO) EBY,1270,1,9,5,15
13627639278,SENSOR DE CIGUEï¿½AL BMW E87-N46 FACET,1345,7,6,9,22
13627639278-1,SENSOR DE CIGUEï¿½AL BMW E87-N46 ( FAE ),1874,3,5,9,17
13627639278-100,SENSOR DE CIGUEï¿½AL BMW E87-N46  ( FREY ) INACTIVO,1852,2,6,1,9
13628617097-1,SENSOR MAP BMW E81 EMBLER,1282,5,6,2,13
13628637897 *2,SENSOR MULTIPLE ADMISION MAP BMW F20-F23 F30-F32 F36 F39 F40 F44-F48 G01 G02 G20 G21 G30 G31 (EMBLER),1223,7,3,2,12
13628637899 *3,SENSOR MULTIPLE ADMISION MAP BMW F39 F40 F44-F48 G01 G02 G20 G21 G30 G31 (TOPRAN),1237,9,9,1,19
13628637900 *1,SENSOR MULTIPLE ADMISION MAP BMW F20-F23 F30-F36 F97 F98 G01 G02 G05-G07 G11-G16 G20 G21 G29-G32 (FREY),1600,3,0,1,4
13628657300 *1,SENSOR PRESION DE MULTIPLE MAP BMW N46N N52 N52N (FREY),1719,7,7,1,15
13628658527,SENSOR MAF BMW F15 N63N METZGER,1509,4,3,4,11
13628658527 *2,SENSOR MAF BMW F15 N63N (BOSCH) SSF,1620,0,3,2,5
13641437486 *5,1 PZ O RING INYECTORES COMBUSTIBLE 9.2 X 2.8 MM BMW (ELRING) SSF,1518,5,0,2,7
13641437487 *5,1 PZ O RING INYECTORES COMBUSTIBLE 7.52 X 3.52 MM BMW MINI (ELRING) SSF,1411,8,3,8,19
13641707843 *5,INYECTOR COMBUSTIBLE GASOLINA BMW E39 E38 E52 E53 M62 8 CIL (GB) SSF,1411,2,5,2,9
13647525721,INYECTOR DE GASOLINA BMW E53-N62 SEMINUEVO,1729,2,9,4,15
13647525721 *1,INYECTOR DE GASOLINA BMW E53-N62 FREY,1251,0,7,3,10
13647639994,INYECTOR DE GASOLINA SEMINUEVO BMW F20-N20 GENUINO,1269,0,1,4,5
13647639994 *1,INYECTOR COMBUSTIBLE GASOLINA ALTA PRESION BMW N20 N26 N55 (FREY),1205,0,3,8,11
13647639994 *5,INYECTOR COMBUSTIBLE GASOLINA ALTA PRESION BMW N20 N26 N55 (BOSCH) SSF,1260,4,0,7,11
1366787 *5,1 PZ. JUNTA MULTIPLE ADMISION VOLVO S40 V40 1.9 L 4 CIL (ELRING) SSF,2000,0,6,7,13
1370940104,FILTRO ENTRADA AIRE MOTOR MERCEDES W220 MANN C2695/2,1687,1,1,1,3
13710151548,"FILTRO ENTRADA AIRE MOTOR BMW  E65, E66, E67 MANN C30153/1",1932,7,8,3,18
13711247031,MANGUERA DE ENTRADA DE AIRE DE MOTOR BMW Z3-M44 ( REIN ),1394,7,2,4,13
13711247031 *1,MANGUERA DE ENTRADA DE AIRE DE MOTOR BMW Z3-M44 ( FREY ),1933,5,0,7,12
13711247031-3,MANGUERA DE ENTRADA DE AIRE DE MOTOR BMW Z3-M44 (EMBLER),1923,6,2,1,9
13711285479,MANGUERA DE ENTRADA DE AIRE DE MOTOR BMW E30-M20 FEBI,1712,5,1,2,8
13711285479 *1,MANGUERA DE ENTRADA DE AIRE DE MOTOR BMW E30-M20 FREY,1786,9,9,1,19
13711285479-1,MANGUERA DE ENTRADA DE AIRE DE MOTOR BMW E30-M20 MTC,1932,4,8,6,18
13711464916 *3,FILTRO ENTRADA AIRE MOTOR BMW K SERIES (MAHLE LX1710),1613,9,1,6,16
13711734258,MANGUERA DE ENTRADA DE AIRE DE MOTOR BMW E36-M44 URO,1633,3,3,5,11
13711734258 *1,MANGUERA DE ENTRADA DE AIRE DE MOTOR BMW E36-M44 FREY,1926,4,5,3,12
13712247444 *3,FILTRO ENTRADA AIRE MOTOR BMW E90 E46 (MAHLE LX818),1763,0,1,7,8
13717501239,FILTRO ENTRADA AIRE MOTOR LAND ROVER RANGE ROVER MANN C18161,1402,7,9,8,24
13717501971,CAJA PORTA FILTRO ENTRADA AIRE MOTOR BMW E46 SEMINUEVA (ORIGINAL),1422,2,4,1,7
13717521023 *1,FILTRO ENTRADA AIRE MOTOR BMW E60 E63 N62 N62N (FREY),1923,1,5,8,14
13717521033 *1,FILTRO ENTRADA AIRE MOTOR BMW E60 M54 N52 N52N E63 N52 E84 E85 S54 (FREY),1470,4,7,4,15
13717521033 *5,FILTRO ENTRADA AIRE MOTOR BMW E60 M54 N52 N52N E63 N52 E84 E85 S54 (HENGST ALEMAN) SSF,1954,4,9,0,13
13717521037 *3,FILTRO ENTRADA AIRE MOTOR BMW E60 E63 N62 N62N (MAHLE LX982),1792,0,9,8,17
13717526008 *1,FILTRO ENTRADA AIRE MOTOR BMW E65 M55 N52N N62N (FREY),1762,7,4,0,11
13717532754 *1,FILTRO ENTRADA AIRE MOTOR BMW E81 E87 E88 N46 N46N (FREY),1292,0,6,2,8
13717532754 *3,FILTRO ENTRADA AIRE MOTOR BMW E81 E87 E88 N46 N46N (MAHLE LX1651),1745,7,0,9,16
13717534825 *1,FILTRO ENTRADA AIRE MOTOR MINI R55 R56 R57 R58 R59 R60 (FREY),1498,5,5,0,10
13717534825 *3,FILTRO ENTRADA AIRE MOTOR MINI R56 N12 (MAHLE LX1969),1212,8,2,5,15
13717534825-1,FILTRO ENTRADA AIRE MOTOR MINI R56-N12 MANN C5082,1589,5,1,9,15
13717534845 *1,FILTRO ENTRADA AIRE MOTOR 147 X 365 MM MINI R55 R56 R57 R58 R59 R60 R61 N14 N18 (FREY),1986,0,3,2,5
13717536006 *1,FILTRO ENTRADA AIRE MOTOR BMW MOTOR E81 N52N E84 N52N E90 N52 N52N (FREY),1438,8,0,8,16
13717536006 *3,FILTRO ENTRADA AIRE MOTOR BMW MOTOR N52-N52N (MAHLE LX1035),1899,9,4,1,14
1371754-100,FILTRO DE AIRE DE MOTOR INACTIVO,1550,4,0,4,8
13717542294 *1,FILTRO ENTRADA AIRE MOTOR BMW E81 N52N E90 N52 N52N (FREY),1758,8,5,0,13
13717542294 *3,FILTRO ENTRADA AIRE MOTOR BMW E81 N52N E90 N52 N52N (MAHLE LX1478),1697,2,2,7,11
13717542294 *5,FILTRO ENTRADA AIRE MOTOR BMW E81 N52N E90 N52 N52N (BOSCH) SSF,1479,6,8,1,15
13717542294 *6,FILTRO ENTRADA AIRE MOTOR BMW E81 N52N E90 N52 N52N (HENGST) SSF,1931,9,9,3,21
13717542545 *3,FILTRO ENTRADA AIRE MOTOR BMW E83-N52N (MAHLE LX1250),1276,7,4,9,20
13717548888,FILTRO ENTRADA AIRE MOTOR BMW E70-N52N MANN C36145,1747,8,9,2,19
13717548888 *1,FILTRO ENTRADA AIRE MOTOR BMW E70 N52N (FREY),1728,3,3,5,11
13717548888 *3,FILTRO ENTRADA AIRE MOTOR BMW E70 N52N (MAHLE LX2036),1566,8,2,2,12
13717548897 *1,FILTRO ENTRADA AIRE MOTOR (L) BMW E70 N62N (FREY),1466,3,2,6,11
13717548897 *3,FILTRO ENTRADA AIRE MOTOR (L) BMW E70 N62N (MAHLE LX2097),1316,8,3,4,15
13717548897 *5,FILTRO ENTRADA AIRE MOTOR (L) BMW E70 N62N (MAHLE LX2097) SSF,1937,7,9,3,19
13717548898 *1,FILTRO ENTRADA AIRE MOTOR (R) BMW E70 N62N (FREY),1700,9,0,2,11
13717548898 *3,FILTRO ENTRADA AIRE MOTOR (R) BMW E70 N62N (MAHLE LX 2098),1989,6,0,1,7
13717548898 *5,FILTRO ENTRADA AIRE MOTOR (R) BMW E70 N62N (MAHLE LX 2098) SSF,1571,7,6,0,13
13717548898 *6,FILTRO ENTRADA AIRE MOTOR (R) BMW E70 N62N (MANN) SSF,1734,9,5,9,23
13717552223 *5,MANGUERA DUCTO ENTRADA AIRE MOTOR MINI R52 R53 W11 (FEBI) SSF,1667,3,6,6,15
13717555784 *5,MANGUERA PRIMARIA ENTRADA AIRE MOTOR MINI N14 (REIN) SSF,1721,2,8,4,14
13717555784-1,TUBO DE AIRE MINI COOPERS R56 KZR,1704,1,6,4,11
13717556961 *1,FILTRO ENTRADA AIRE MOTOR BMW E88 E89 E90 N54 (FREY),1980,3,2,4,9
13717556961 *3,FILTRO ENTRADA AIRE MOTOR BMW MOTOR N54 (MAHLE LX1564),1451,2,5,9,16
13717558382 *3,FILTRO ENTRADA AIRE MOTOR MINI R52 (MAHLE LX1628),1476,2,6,9,17
13717561235 *3,FILTRO ENTRADA AIRE MOTOR MINI R55 R56 R57 R58 R59 R60 R61 N12 N16 (MAHLE) DGO,1277,6,4,0,10
13717561235 *5,FILTRO ENTRADA AIRE MOTOR MINI R55 R56 R57 R58 R59 R60 R61 N12 N16 (MANN) SSF,1995,2,4,9,15
13717568728 *3,FILTRO ENTRADA AIRE MOTOR 147 X 365 MM MINI R55 R56 R57 R58 R59 R60 R61 N14 N18 (MAHLE) DGO,1242,9,2,6,17
13717568728 *5,FILTRO ENTRADA AIRE MOTOR 147 X 365 MM MINI R55 R56 R57 R58 R59 R60 R61 N14 N18 (MANN) SSF,1382,3,4,8,15
13717571350 *2,MANGUERA ENTRADA AIRE MOTOR BMW E70 E71 F15 F16 N54 N55 (EMBLER),1463,4,1,2,7
13717571355 *1,FILTRO ENTRADA AIRE MOTOR BMW E70 E71 F01 F06 F10 F15 F16 F25 N55 (FREY),1969,4,3,1,8
13717571355 *3,FILTRO ENTRADA AIRE MOTOR BMW E70 E71 F01 F06 F10 F15 F16 F25 N55 (MAHLE LX2525),1763,5,0,3,8
13717571355 *5,FILTRO ENTRADA AIRE MOTOR BMW E70 E71 F01 F06 F10 F15 F16 F25 N55 (HENGST) SSF,1638,2,8,2,12
13717577457 *5,FILTRO ENTRADA AIRE MOTOR (R) BMW F01 F06 F10 E70 E71 E72 N63 N63N (MAHLE) SSF,1679,3,9,7,19
13717577458 *5,FILTRO ENTRADA AIRE MOTOR (L) BMW F01 F06 F10 E70 E71 E72 N63 N63N (MAHLE) SSF,1213,3,1,2,6
13717582908 *1,FILTRO ENTRADA AIRE MOTOR BMW F10 N20 E84 N20 E89 N20 N52N (FREY TEGNOLOGIA ALEMANA),1628,4,0,5,9
13717582908 *3,FILTRO ENTRADA AIRE MOTOR BMW F10 N20 E84 N20 E89 N20 N52N (MAHLE LX2787),1217,8,8,1,17
13717582908 *5,FILTRO ENTRADA AIRE MOTOR BMW F10 N20 E84 N20 E89 N20 N52N (HENGST ALEMAN) SSF,1952,7,7,7,21
13717588283 *1,MANGUERA AIRE INTERCOOLER CUERPO ACELERACION (R) E84 E89 N20 (FREY),1286,0,3,8,11
13717589641 *3,FILTRO ENTRADA AIRE MOTOR R BMW E70-S63 (MAHLE LX1824/1),1457,7,3,4,14
13717589642 *3,FILTRO ENTRADA AIRE MOTOR L BMW E70-S63 (MAHLE LX1823/1),1980,1,4,0,5
13717590597 *1,FILTRO ENTRADA AIRE MOTOR BMW F10 N52N (FREY),1215,3,4,6,13
13717590597 *3,FILTRO ENTRADA AIRE MOTOR BMW F10 N52N (MAHLE ï¿½LX1741/1),1390,2,4,5,11
13717593250 *1,FILTRO ENTRADA AIRE MOTOR BMW F01 F02 N47 (FREY),1355,2,6,5,13
13717597586 *1,MANGUERA PRIMARIA ENTRADA AIRE MOTOR BMW F20 F21 F30 F31 N13 (FREY),1940,7,0,7,14
13717597586 *2,MANGUERA PRIMARIA ENTRADA AIRE MOTOR BMW F20 F21 F30 F31 N13 (EMBLER) GOG,1569,5,1,3,9
13717599285 *1,FILTRO ENTRADA AIRE MOTOR BMW E84 E88 E90 N55 TURBO FREY),1544,6,6,7,19
13717599285 *3,FILTRO ENTRADA AIRE MOTOR BMW N55 (MAHLE LX1791),1217,1,5,0,6
13717599294 *1,MANGUERA AIRE INTERCOOLER CUERPO ACELERACION (L) BMW E84 E88 E90 N55 (FREY),1642,9,4,1,14
13717601868 *1,FILTRO ENTRADA AIRE MOTOR BMW F25 F26 N20 N52N (FREY),1633,9,4,0,13
13717601868 *3,FILTRO ENTRADA AIRE MOTOR BMW F25 N20 (MAHLE LX1991),1312,5,0,4,9
13717601868 *5,FILTRO ENTRADA AIRE MOTOR BMW F25 N20 (HENGST) SSF,1270,0,7,9,16
13717602643 *1,FILTRO ENTRADA AIRE MOTOR BMW F20 N55 F30 N55 F32 N55 (FREY),1611,5,5,0,10
13717602643 *3,FILTRO ENTRADA AIRE MOTOR BMW F20 N55 F30 N55 F32 N55 (MAHLE LX2076/1),1783,3,6,8,17
13717602643 *5,FILTRO ENTRADA AIRE MOTOR BMW F20 N55 F30 N55 F32 N55 (HENGST) SSF,1740,2,9,9,20
13717604033 *1,MANGUERA AIRE INTERCOOLER CUERPO ACELERACION (L) BMW F20 F22  F25 F26 F30 F32 N55 (FREY),1882,1,9,5,15
13717604033 *2,MANGUERA AIRE INTERCOOLER CUERPO ACELERACION (L) BMW F20 F22  F25 F26 F30 F32 N55 (EMBLER) GOG,1264,3,7,7,17
13717605436 *3,FILTRO ENTRADA AIRE MOTOR L BMW E60-S85 (MAHLE LX998),1851,2,8,5,15
13717605585 *1,MANGUERA ENTRADA AIRE BMW E70 E71 F01 F02 F06 F12 F13 F15 F16 (FREY),1765,1,4,1,6
13717605638 *1,MANGUERA PRIMARIA ENTRADA AIRE MOTOR BMW E84 E89 F10 F16 F20 F22 F25 F26 F30 F32 N20 (FREY),1230,3,0,7,10
13717605913 *1,FILTRO ENTRADA AIRE MOTOR BMW F06 F10 N55 (FREY),1472,4,7,2,13
13717609810 *1,MANGUERA AIRE INTERCOOLER CUERPO ACELERACION (L) BMW F01 F71 N54 (FREY),1519,2,1,0,3
13717609811 *1,MANGUERA AIRE INTERCOOLER CUERPO ACELERACION (L) BMW F01 F06 F10 E70 E71 N55 (FREY),1941,2,8,9,19
13717619267 *3,FILTRO ENTRADA AIRE MOTOR BMW F45 B38 B48 MINI F55 F56 F57 F60 B38 B48 F54 B36 B38 B48 (MAHLE) DGO,1256,0,8,4,12
13717619267 *5,FILTRO ENTRADA AIRE MOTOR BMW F45 B38 B48 MINI F55 F56 F57 F60 B38 B48 F54 B36 B38 B48 (MANN)ï¿½SSF,1957,3,7,1,11
13717619267 *6,FILTRO ENTRADA AIRE MOTOR BMW F45 B38 B48 MINI F55 F56 F57 F60 B38 B48 F54 B36 B38 B48 (HENGST) SSF,1541,5,9,0,14
13717638566 *5,1 PZ FILTRO ENTRADA AIRE MOTOR (L/R) BMW F15 F16 N63N (HENGST) SSF,1400,3,0,3,6
13717638566 *6,1 PZ FILTRO ENTRADA AIRE MOTOR (L/R) BMW F15 F16 N63N (MAHLE) SSF,1509,8,0,2,10
13718507320 *1,FILTRO ENTRADA AIRE MOTOR BMW F20 N13 N20 F21 B38 F22 B38 F30 N13 N20 N26 F32 B38 N20 N26 (FREY),1814,1,6,7,14
13718507320 *3,FILTRO ENTRADA AIRE MOTOR BMW F20 B38 N13 N20 F22 B38 N20 N26 F30 N13 N20 F32 38 N20 N26 (MAHLE LX2077/3),1630,7,1,3,11
13718507320 *5,FILTRO ENTRADA AIRE MOTOR BMW F20 B38 N13 N20 F22 B38 N20 N26 F30 N13 N20 F32 38 N20 N26 (HENGST) SSF,1401,4,4,8,16
13718577170 *1,FILTRO ENTRADA AIRE MOTOR 273 X 219 MM G01 G02 G05-G07 G11-G17 G30-G32 (FREY),1657,9,9,1,19
13718580428 *1,FILTRO ENTRADA AIRE MOTOR BMW G20 G29 (FREY),1297,4,9,7,20
13718605164 *1 ,FILTRO ENTRADA AIRE MOTOR BMW F20 B48 B58 F30 B46 B48 B58 F32 B48 B58 (FREY),1210,8,2,7,17
13718605164 *3,FILTRO ENTRADA AIRE MOTOR BMW F20 B48 B58 F30 B46 B48 B58 F32 B48 B58 (MAHLE LX3320),1814,2,5,8,15
13718626487 *1,MANGUERA AIRE INTERCOOLER CUERPO ACELERACION (L) F06 F15 F16 N55 (FREY),1879,0,2,9,11
13718632502 *3,FILTRO ENTRADA AIRE MOTOR BMW F20 F30 F21 (MAHLE LX3424),1404,2,3,4,9
13718692202 *1,FILTRO ENTRADA AIRE MOTOR BMW F45 B38 B48 MINI F55 F56 F57 F60 B38 B48 F54 B36 B38 B48 (FREY),1461,9,6,4,19
13721247405 *3,FILTRO ENTRADA AIRE MOTOR BMW E36 M42 (MAHLE LX500),1872,7,7,7,21
13721477840 *3,FILTRO ENTRADA AIRE MOTOR MINI COOPER R50 R52 (MAHLE LX1046),1995,3,4,6,13
13721491749,FILTRO ENTRADA AIRE MOTOR MINI COOPER R57 MANN  C2851,1504,7,8,6,21
13721491749 *3,FILTRO ENTRADA AIRE MOTOR 170 X 276 MM MINI R52 R53 W11 (MAHLE) DGO,1234,9,6,3,18
13721702908 *1,FILTRO ENTRADA AIRE MOTOR BMW E38 E53 M54 N62 (FREY),1928,3,2,4,9
13721702908 *3,FILTRO ENTRADA AIRE MOTOR BMW MOTOR M54 (MAHLE LX494),1496,4,5,0,9
13721702908 *5,FILTRO ENTRADA AIRE MOTOR BMW E38 E53 M54 N62 (BOSCH) SSF,1997,3,9,8,20
13721730449 *5,FILTRO ENTRADA AIRE MOTOR BMW E36 E38 E39 E46 E83 Z3 Z4 M43 M50 M52 M54 (HENGST ALEMAN) SSF,1757,9,2,4,15
13721730946 *1,FILTRO ENTRADA AIRE MOTOR BMW E36 E38 E39 E46 E83 Z3 Z4 M43 M50 M52 M54 (FREY TEGNOLOGIA ALEMANA),1219,1,7,4,12
13721730946 *6,FILTRO ENTRADA AIRE MOTOR BMW E36 E38 E39 E46 E83 Z3 Z4 M43 M50 M52 M54 (BOSCH ALEMAN) SSF,1527,6,9,6,21
13721730946 *7,FILTRO ENTRADA AIRE MOTOR BMW E36 E38 E39 E46 E83 Z3 Z4 M43 M50 M52 M54 (MAHLE) SSF,1542,5,8,1,14
13721736675 *1,FILTRO ENTRADA AIRE MOTOR BMW E39 M62 E53 N62 M62 (FREY),1825,1,2,8,11
13721736675 *3,FILTRO ENTRADA AIRE MOTOR BMW E53-M62 (MAHLE LX422),1401,5,8,9,22
13721736675 *5,FILTRO ENTRADA AIRE MOTOR BMW E39 M62 E53 N62 M62 (MANN C26151),1834,1,4,8,13
13727834714 *3,FILTRO ENTRADA AIRE MOTOR R BMW E60-M5 MAHLE LX987,1685,4,1,7,12
13727838804 *3,FILTRO COMBUSTIBLE GASOLINA PORSCHE 911 (MAHLE KL69),1335,2,9,4,15
13727838804 *5,FILTRO ENTRADA AIRE MOTOR BMW E90 E93 (MAHLE LX1590),1651,5,3,4,12
1376606081 *3,FILTRO ENTRADA AIRE MOTOR AUDI (MAHLE LX1211),1268,1,4,0,5
1376606156 *3,FILTRO ENTRADA AIRE MOTOR VOLVO S60 (MAHLE LX976),1275,5,6,3,14
13901433603,VALVULA DE VENTILACION DEL DEPOSITO DE COMBUSTIBLE BMW E46 FEBI,1628,2,9,9,20
13901433603 *1,VALVULA DE VENTILACION DEL DEPOSITO DE COMBUSTIBLE BMW E46 FREY,1228,4,7,9,20
13907621174 *2,VALVULA DE VENTILACION TANQUE DE COMBUSTIBLE BMW F39 F45 F46 F48 (EMBLER),1519,6,4,8,18
13907621174 *3,VALVULA DE VENTILACION TANQUE DE COMBUSTIBLE BMW F39 F45 F46 F48 (BOSCH),1943,8,7,6,21
1397381 *5,TAPA ARBOL LEVAS TRASERA (L/R) 62 MM VOLVO C30 C70 S40 S60 S70 S80 S90 V40 V50 V60 V70 V90 XC60 XC70 XC90 (PROPARTS) SSF,1417,2,8,7,17
1397525 *5,O RING SELLO TAPA PUNTERIAS CAVIDAD DE BUJIAS VOLVO C30 C70 S40 S60 S70 S80 S90 V40 V70 V90 XC 70 (VICTOR REINZ) SSF,1977,4,8,5,17
1402402017 *1,Montaje Torque Puntal Montaje del Motor ( FREY ),1540,1,8,5,14
1402710080,JUNTA DE CARTER DE MOTOR MERCEDES W203-M272 GENUINA,1394,1,9,2,12
1402710080 *1,JUNTA CARTER ACEITE TRANSMISION AUTOMATICA MERCEDES (FREY),1729,1,9,7,17
1402710080-1,JUNTA DE CARTER DE MOTOR MERCEDES W203-M272 URO,1227,9,1,4,14
1402710080-3,JUNTA DE CARTER DE MOTOR MERCEDES W203-M272 TOPRAN,1658,6,0,8,14
1402770095 *1,KIT 2 PZ JUNTA FILTRO ACEITE TRANSMISION AUTOMATICA 722.6 1996 A 2018 SPRINTER MERCEDES (FREY),1339,8,6,2,16
1402770095 *3,FILTRO ACEITE TRANSMISION AUTOMATICA 722.6 1996 A 2018 SPRINTER MERCEDES (MAHLE HX81D),1602,8,6,1,15
1403209613,AMORTIGUADOR DE SUSPENSON TRASERA L-R HIDRONEUMATICO MERCEDES S500 SACHS 102397,1749,2,3,2,7
1403209613 *1,AMORTIGUADOR DE SUSPENSON TRASERA L-R HIDRONEUMATICO MERCEDES S500 FREY,1692,0,0,8,8
140500149-100,TANQUE DE EXPANSION MERCEDES INACTIVO,1782,9,3,5,17
140589000000,VARILLA DE NIVEL DE ACEITE DE TRANS. AUTO. MERCEDES W202  ORIGINAL,1355,2,0,4,6
1405891521 *2,VARILLA VAYONETA NIVEL ACEITE TRANSMISION AUTOMATICA MERCEDES (URO) SSF,1568,8,7,9,24
140589152100-1,VARILLA DE NIVEL DE ACEITE DE TRANS. AUTO. MERCEDES W202  VAICO,1993,8,1,7,16
140589152100-3,VARILLA DE NIVEL DE ACEITE DE TRANS. AUTO. MERCEDES W202 KZR GERMANY,1686,7,8,6,21
1408RH-100,LUNA ESPEJO DERECHO SPRINTER 2012 INACTIVO,1406,3,3,5,11
1409810305,BALERO INTERIOR DE RUEDA DELANTERA L-R MERCEDES W210 BMTRS,1936,7,3,9,19
14141414,PUNTO MEDIO SUCURSAL,1356,2,4,7,13
1432705,CARTER DE MOTOR BMW E46 M54 SEMINUEVO (ORIGINAL),1363,1,2,0,3
1433817,JUNTA DE TAPA DE VANOS BMW E46-M54 VICTOR REINZ ORIGINALL,1881,5,9,0,14
1433817-100,JUNTA DE TAPA DE VANOS BMW E46-M54 VICTOR INACTIVO,1449,4,4,9,17
1438140 ,MULTIPLE DE ADMISION BMW M52 E39 SEMINUEVO (ORIGINAL),1516,8,1,5,14
14411-5X01B-100,TURBO CARGADOR CARTUCHO NISSAN NP300 DIESEL DORMAN ALEMAN INACTIVO,1668,4,0,6,10
1457433023,FILTRO ENTRADA AIRE MOTOR GOLF III 2.0L MANN C27154/1,1747,0,5,2,7
1457433575 *3,FILTRO ENTRADA AIRE MOTOR SEAT IBIZA III 1.4L (MAHLE LX709),1314,7,6,0,13
1457433575-1,FILTRO ENTRADA AIRE MOTOR SEAT IBIZA III 1.4L MANN C2295/3,1318,8,4,9,21
1457433781 *3,FILTRO ENTRADA AIRE MOTOR LAND ROVER 75 V6 2005 (MAHLE LX889),1791,4,5,5,14
149977192,BANDA ACCESORIOS MOTOR MEDIDA 6PK 2380 MM MERCEDES C215 R171 R230 W163 W220 M113 DAYCO,1325,0,6,4,10
15117559528,MANGUERA DE VENTILACION DE CARTER GENUINO,1400,8,6,1,15
15125532 *B,BOLSA AIRE SUSPENSION TRASERA (L/R) CHEVROLET TRAIBLAZER RAINIER ENVOY BRAVADA SAAB 9 (EMBLER) TECH,1767,9,9,8,26
15151515,PUNTO MEDIO DOMICILIO,1542,1,0,8,9
1521712058-3,ASPAS DE VENTILADOR MECANICO BMW E46-M54 URO,1411,5,1,0,6
15406017,SENSOR  DE OXIGENO MERCEDES W210 BMTR,1592,7,6,9,22
15407617,SENSOR DE OXIGENO TRASERO MERCEDES W211 BMTR,1293,3,2,7,12
154098075950,FILTRO ENTRADA AIRE MOTOR PEUGEOT 206 MANN C2159,1609,9,1,3,13
15456309,INTERRUPTOR DE LUZ DE FRENO MERCEDES W204-M272 FACET,1488,1,1,3,5
1560160020,JUNTA CABEZA MOTOR (R) MEDIDA STANDAR 0.75 MM MERCEDES M156 (ELRING),1479,3,0,2,5
1560160020 *1,JUNTA CABEZA MOTOR (R) MEDIDA STANDAR 0.75 MM MERCEDES M156 (FREY),1378,6,2,8,16
1560162421,JUNTA DE TAPA DE PUNTERIAS (R) MERCEDES W204 ELRING,1382,1,3,6,10
1560162521,JUNTA DE TAPA DE PUNTERIAS (L) MERCEDES W204 ELRING,1880,3,0,7,10
1560940504,FILTRO ENTRADA AIRE MOTOR 2 PIEZAS MERCEDES W164-ML63 AMG MANN C3361-2,1260,0,2,8,10
1560940504 *1,FILTRO AIRE MERCEDES W211 W164 W212 W221 (FREY),1945,9,4,2,15
1560940504 *3,FILTRO ENTRADA AIRE MOTOR 2 PIEZAS MERCEDES W164 ML63 AMG (MAHLE LX3594/S),1626,9,4,7,20
1562030475,TERMOSTATO DE MOTOR MERCEDES C63 / W204,1516,3,4,3,10
1562030475 *1,TERMOSTATO DE MOTOR MERCEDES C63 / W204 FREY,1323,4,6,3,13
1563200931 *1,AMORTIGUADOR SUSPENSION TRASERA (L/R) MERCEDES X156 (FREY),1228,7,4,5,16
1563231700 *1,AMORTIGUADOR SUSPENSION DELANTERA (L) MERCEDES X156 (FREY),1568,5,0,2,7
1563231800 *1,AMORTIGUADOR SUSPENSION DELANTERA (R) MERCEDES  X156 (FREY),1886,5,8,0,13
1563300600 *1,HORQUILLA SUSPENSION DELANTERA (R) MERCEDES W117 X156 (FREY),1712,5,1,5,11
1569064400 *1,BOBINA ENCENDIDO IGNICION MOTOR MERCEDES M156 (FREY),1446,5,6,8,19
1569064400 *5,BOBINA ENCENDIDO IGNICION MOTOR MERCEDES M156 (DELPHI) SSF,1510,8,6,1,15
1569800164 *1,AMORTIGUADOR CAJUELA 490 NEWTONS 666 MM (L/R) MERCEDES X156 (FREY),1310,7,9,0,16
1572000151 *1,MANGUERA ENFRIAMIENTO TURBOCOMPRESOR MERCEDES W166 W221 X166 (FREY),1829,7,2,4,13
1578902 *9,BARRA CENTRAL DIRECCION HIDRAULICA CON BIELETAS BMW 540i E39 (LEMFORDER) SSF,1300,5,8,4,17
1590160221,JUNTA DE TAPA DE PUNTERIAS ( R ) MERCEDES MOTOR M156 8 CIL ELRING,1923,7,6,0,13
1590160221 *1,JUNTA DE TAPA DE PUNTERIAS ( R ) MERCEDES MOTOR M156 8 CIL FREY,1223,3,1,1,5
15938306 *B,BOLSA AIRE SUSPENSION TRASERA (L/R) HUMMER H2 (EMBLER) TECH,1715,7,1,6,14
159971246,SELLO DEL EJE DE SALIDA DE TRANSMISION MERCEDES W204 ( CORTECO ),1414,3,4,3,10
15D452 *5,1 LITRO ACEITE MOTOR 100% SINTETICO 5W-30 (CASTROL EDGE) SSF,1251,0,1,9,10
15D453 *5,4.730 LITROS ACEITE MOTOR 100% SINTETICO 5W-30 (CASTROL EDGE) SSF,1267,9,6,1,16
16,IVA ( IMPUESTO AL VALOR AGREGADO,1297,7,6,9,22
1602000315 *1,TERMOSTATO TOMA AGUA ENFRIAMIENTO MOTOR SMART W450 W452 M160 (FREY),1644,2,6,6,14
1609970192 ,BANDA DE AIRE ACONDICIONADO SMART CONTITECH 3PK850,1683,9,3,4,16
1611178280,SENSOR TEMPERATURA TERMOSTATO MINI R56-N16 ORIGINAL,1562,5,6,7,18
16112755082 *1,BOMBA COMBUSTIBLE GASOLINA MINI R55 R56 R57 R58 R59 (FREY),1492,7,7,3,17
16116752626 *3,FILTRO COMBUSTIBLE GASOLINA MOTO BMW (MAHLE  KL315),1216,5,8,2,15
16116755043 *1,BOMBA DE GASOLINA ELECTRICA COMPLETA BMW E53 ( FREY ),1862,5,4,6,15
16116755043-1,BOMBA DE GASOLINA COMPLETA BMW E53-M62 DELPHI,1858,4,9,7,20
16116762044,SENSOR DE NIVEL DE GASOLINA BMW X5 URO,1274,6,2,4,12
16117159604,BOMBA DE GASOLINA BMW E83-M54 DELPHI,1597,5,2,6,13
16117159604 *1,BOMBA DE GASOLINA BMW E83-M54 FREY,1204,7,0,1,8
16117159604-1,BOMBA DE GASOLINA BMW E83-M54 BMTR,1647,3,4,7,14
16117159604-2,BOMBA DE GASOLINA BMW E83-M54 PERFORMANCE AUTO PARTS,1651,8,6,1,15
16117159604-3,BOMBA DE GASOLINA BMW E83-M54 HIGH FLOW,1514,6,2,8,16
16117163295 *1,FILTRO COMBUSTIBLE GASOLINA CON REGULADOR INTEGRADO BMW E81 E84 E90 (FREY),1835,2,0,8,10
16117163295 *5,FILTRO COMBUSTIBLE GASOLINA CON REGULADOR INTEGRADO BMW E81 E84 E90 (PIERBURG) SSF,1789,1,8,5,14
16117163295 *6,FILTRO COMBUSTIBLE GASOLINA CON REGULADOR INTEGRADO BMW E81 E84 E90 (CONTINENTAL) SSF,1376,8,8,3,19
16117170090 *1,SENSOR NIVEL COMBUSTIBLE FILTRO REGULADOR GASOLINA BMW E81 E84 E90  (FREY),1867,8,1,1,10
16117195463 *1,BOMBA GASOLINA ELECTRICA BMW E70 N52N N62N (FREY),1593,0,4,2,6
16117195464-1,BOMBA DE GASOLINA BMW E70-N62N KARL,1753,0,9,5,14
16117195464-100,BOMBA DE GASOLINA BMW E70-N62N BMTR INACTIVO,1947,5,2,9,16
16117195464-2,BOMBA DE GASOLINA BMW E70-N62N URO,1281,5,6,1,12
16117197076 *1,BOMBA GASOLINA ELECTRICA BMW E84 E87 E90 (FREY),1458,4,2,3,9
16117197076-1,BOMBA DE GASOLINA ELECTRICA BMW E87-E90 BMTRS,1552,6,6,8,20
16117197076-2,BOMBA DE GASOLINA ELECTRICA (SOLO REPUESTO) BMW E90-N52 BMTRS,1574,9,6,4,19
16117197076-3,BOMBA DE GASOLINA ELECTRICA COMPLETA BMW E90-N52 PIERBURG,1512,8,2,1,11
16117197076-8,BOMBA DE GASOLINA ELECTRICA COMPLETA BMW E90-N52 OSSCA,1992,7,6,1,14
16117198406,BOMBA REPUESTO GASOLINA BMW X3 E83 PIERBURG,1692,8,2,0,10
16117207599 *1,BOMBA COMBUSTIBLE GASOLINA BMW E70 E71 F15 F16 (FREY),1619,7,9,2,18
16117212585 *1,BOMBA COMBUSTIBLE GASOLINA BMW E70 E71 E72 F15 F16 F85 F86 (FREY),1244,5,7,5,17
16117212585 *3,BOMBA COMBUSTIBLE GASOLINA BMW E70 E71 E72 F15 F16 F85 F86 (ANAUTOMY),1215,8,3,8,19
16117222330,TAPON TANQUE DE GASOLINA BMW E46 ( FEBI ),1265,0,4,4,8
16117222330 *1,TAPON TANQUE GASOLINA MINI R50 A R61 BMW E60 E63 E70 E71 E84 E89 E90 (FREY),1961,5,8,6,19
16117222330-1,TAPON TANQUE DE GASOLINA BMW E46 MEISTERSATZ,1971,3,6,6,15
16117243974 *1,BOMBA COMBUSTIBLE GASOLINA ELECTRICA BMW F20 F30 N13 (FREY),1560,1,4,3,8
16117243975 *1,BOMBA GASOLINA ELECTRICA 5 PINES BMW F20 F22 F30 F32 N20 N26 N55 (FREY),1213,6,4,6,16
16117243975 *5,BOMBA GASOLINA ELECTRICA 5 PINES BMW F20 F22 F30 F32 N20 N26 N55 (URO) SSF,1679,2,1,0,3
16117243975 *6,BOMBA GASOLINA ELECTRICA 5 PINES BMW F20 F22 F30 F32 N20 N26 N55 (BOSCH) SSF,1676,5,1,4,10
16117243975-100,BOMBA DE GASOLINA BMW F30-N20 INACTIVO,1568,4,5,6,15
16117260644 *1,Mï¿½dulo De Fuente De Bomba De Combustible FREY,1945,6,1,3,10
16117273277,BOMBA GASOLINA ELECTRICA CON FLOTADOR BMW F20 F22 F30 F32 (BMTR),1446,8,5,2,15
16117273277 *1,BOMBA GASOLINA ELECTRICA CON FLOTADOR BMW F20 F22 F30 F32 (FREY),1834,8,4,2,14
16117285443,REPUESTO BOMBA GASOLINA ELECTRICA BMW X3 X4 F25 F26 (PIERBURG),1664,9,4,1,14
16117300475 *1,BOMBA GASOLINA ELECTRICA MINI F55 F56 F57 (FREY),1346,0,8,2,10
16117314804 *1,BOMBA GASOLINA ELECTRICA BMW X3 X4 F25 F26 (FREY),1297,1,2,7,10
16117341301,BOMBA DE GASOLINA ELECTRICA PIERBURG F10-N20,1232,4,0,8,12
16117344066 *1,BOMBA GASOLINA ELECTRICA 7 PINES BMW F20 F22 F30 F32 B38 B46 B48 B58 (FREY),1706,5,7,6,18
16117344066 *3,BOMBA GASOLINA ELECTRICA 7 PINES BMW F20 F22 F30 F32 B38 B46 B48 B58 (BOSCH),1817,2,1,5,8
16117373458,BOMBA DE GASOLINA ELECTRICA BMW E60-N62 BOSCH,1728,4,1,4,9
16117373458 * 5,BOMBA DE GASOLINA ELECTRICA BMW E60-N62 OSSCA,1294,6,2,6,14
16117373458-1,BOMBA DE GASOLINA ELECTRICA BMW E60-N62 BMTR,1211,8,0,3,11
16117373458-2,BOMBA DE GASOLINA ELECTRICA BMW E60-N62 FREY,1830,1,5,6,12
16117373458-3,BOMBA DE GASOLINA ELECTRICA BMW E60-N62 TOPRAN,1726,3,2,4,9
16117373470 *1,FILTRO BOMBA GASOLINA LADO IZQUIERDO BMW E60 M54 N62N (FREY),1290,5,7,6,18
16117373470-4,FILTRO BOMBA GASOLINA  LADO IZQUIERDO BMW E60 M54-N62N BOSCH,1474,6,9,4,19
16117373503 *1,BOMBA DE GASOLINA ELECTRICA R BMW E60-N52N FREY,1627,1,6,7,14
16117373503 *5,BOMBA DE GASOLINA ELECTRICA R BMW E60-N52N (BOSCH) SSF,1834,0,2,8,10
16117373514,BOMBA DE GASOLINA BMW E60 N52 BOSCH,1849,0,1,3,4
16117373514 *1,BOMBA DE GASOLINA BMW E60 E61 E63 E64 N52 (FREY),1232,4,8,3,15
16117414480,BOMBA DE GASOLINA BMW F20 F30 N13 (SOLO REPUESTO) PIERBUG,1965,7,4,6,17
16117414480 *5,BOMBA COMBUSTIBLE GASOLINA BMW F20 F30 N13 (BOSCH) MEX,1497,8,4,5,17
16126750475 *1,FILTRO COMBUSTIBLE GASOLINA CON REGULADOR INTEGRADO BMW E36 Z3 E46 E65 (FREY),1742,7,9,6,22
16126754016 *1,FILTRO COMBUSTIBLE GASOLINA CORTO CON REGULADOR INTERNO BMW E53 (FREY),1479,3,2,9,14
16126754016 *3,FILTRO COMBUSTIBLE GASOLINA CORTO CON REGULADOR INTERNO BMW E53 (MAHLE KL167),1208,2,1,0,3
161272-100,FILTRO DE GASOLINA SIN INACTIVO,1920,3,0,8,11
161272338-100,FILTRO DE GASOLINA SIN REG INACTIVO,1452,0,8,5,13
16127233840 *3,FILTRO COMBUSTIBLE GASOLINA BMW E82 E87 E88 E90 F01-F07 G12 (TOPRAN),1844,5,0,1,6
1613192280,BALATAS FRENOS PEUGEOT/CITROï¿½N (TRW GDB1463),1796,7,3,4,14
16141182842 *3,BOMBA GASOLINA ELECTRICA BMW E36 M52 (TOPRAN),1569,2,9,6,17
16141183176,BOMBA DE GASOLINA COMPLETA BMW E39-M54 BMTR,1627,4,8,9,21
16141183176-101,BOMBA DE GASOLINA COMPLETA BMW E39-M54 FREY INACTIVO,1704,2,7,7,16
16141183176-3,BOMBA DE GASOLINA COMPLETA BMW E39-M54 OSSCA,1865,2,1,4,7
16141183947 ,BOMBA DE COMBUSTIBLE E38 (BMTR),1834,7,3,1,11
16146752368 *1,BOMBA DE GASOLINA ELECTRICA ( REPUESTO ) BMW E39 E53 ( FREY ),1828,8,4,7,19
16146752368 *5,BOMBA DE GASOLINA ELECTRICA ( REPUESTO ) BMW E39 E53 (URO PARTS) SSF,1647,8,9,2,19
16146752368-100,BOMBA DE GASOLINA ( REPUESTO ) BMW E39 BMTR INACTIVO,1205,8,7,4,19
16146752368-9,BOMBA DE GASOLINA ( REPUESTO ) BMW E39 E53 ( BMTR ),1781,4,6,4,14
16146752499 *1,BOMBA COMBUSTIBLE GASOLINA BMW E46 (FREY),1867,0,6,8,14
16146757196,FILTRO COMBUSTIBLE GASOLINA MINI COOPER R53 TOPRAN,1949,1,0,0,1
16146757196 *3,FILTRO COMBUSTIBLE GASOLINA 74 X 100 MM MINI R50 R52 R52 W10 W11 (MAHLE) DGO,1583,5,8,3,16
16146758736,BOMBA DE GASOLINA BMW E36-M52 BMTR,1644,0,1,3,4
16146758736 *1,BOMBA GASOLINA ELECTRICA BMW E36 M52 (FREY),1888,7,2,3,12
16146758736 *5,BOMBA GASOLINA ELECTRICA BMW E36 M52 (URO) SSF,1362,6,5,3,14
16146766150,BOMBA DE GASOLINA ELECTRICA R BMW E60-N52N BMTR,1612,7,2,1,10
16146766150-1,BOMBA DE GASOLINA ELECTRICA R BMW E60-N52N (CALIDAD ORIGINAL),1978,6,3,0,9
16146766158 *1,FILTRO COMBUSTIBLE GASOLINA CON REGULADOR FREY,1604,9,7,2,18
16146766177 *1,BOMBA GASOLINA ELECTRICA MINI R50 R52 R53 (FREY),1735,4,0,3,7
16146766942 *9,BOMBA COMBUSTIBLE GASOLINA BMW E46 (OSSCA),1309,0,2,5,7
16147161387,BOMBA DE GASOLINA BMW E34 BMTR,1959,9,8,3,20
16147161387 *1,BOMBA DE GASOLINA BMW E34 FREY,1615,3,5,3,11
16147163298,BOMBA DE GASOLINA ELECTRICA COMPLETA BMW E90-N52 GENUINA,1693,2,6,1,9
16147163298 *1,BOMBA DE GASOLINA ELECTRICA COMPLETA BMW E90-N52 FREY,1679,7,7,9,23
16147229173,MODULO DE BOMBA DE GASOLINA BMW E90 / N52 ( ORIGINAL ),1715,5,1,3,9
16147229173 *1,MODULO DE BOMBA DE GASOLINA BMW E90 / N52 FREY,1773,2,0,0,2
16161616,MERCADO LIBRE,1827,8,3,8,19
1629097080,BOMBA AGUA ELECTRICA ENFRIAMIENTO MOTOR PEUGEOT 307 (GENUINA),1274,3,3,4,10
1632400217 *1,SOPORTE MOTOR MERCEDES (L/R) W163 M112 (FREY),1909,6,3,1,10
1632400217 *5,SOPORTE MOTOR MERCEDES (L/R) W163 M112 (CORTECO) SSF,1426,7,4,3,14
1632400217 *6,SOPORTE MOTOR MERCEDES (L/R) W163 M112 (REIN ) SSF,1850,8,2,6,16
1632400217 *9,SOPORTE MOTOR MERCEDES (L/R) W163 M112 (FEBI),1911,5,9,4,18
1632400317 *1,SOPORTE MOTOR (L/R) MERCEDES W163 M112 M113 (FREY),1280,6,6,2,14
1633200044,BUJES DE GOMA DE BARRA ESTABILIZADORA MERCEDES W163 TOPRAN,1884,0,0,2,2
1633200044 *1,BUJES DE GOMA DE BARRA ESTABILIZADORA MERCEDES W163 FREY,1291,2,3,7,12
1633200044-1,BUJES DE GOMA DE BARRA ESTABILIZADORA MERCEDES W163 URO,1810,0,6,4,10
1633200044-2,BUJES DE GOMA DE BARRA ESTABILIZADORA MERCEDES W163 MTC,1497,3,8,2,13
1633200373,BUJE DE GOMA DE BARRA ESTABILIZADORA MERCEDES W163 TOPRAN 401700466,1309,3,6,8,17
1633200373 *1,BUJE DE GOMA DE BARRA ESTABILIZADORA MERCEDES W163 FREY,1966,7,5,4,16
1633201813 *1,AMORTIGUADOR DE SUSPENSION TRASERA (L/R) MERCEDES W163 (FREY),1331,6,1,3,10
1633201830 *1,AMORTIGUADOR DE SUSPENSION TRASERA  L-R MERCEDES W163 FREY,1773,6,1,5,12
1633202313,AMORTIGUADOR DE SUSPENSION TRASERA  L-R MERCEDES W163 BMTR,1797,2,7,9,18
1633202313-9,AMORTIGUADOR DE SUSPENSION TRASERA  L-R MERCEDES W163 SACHS,1475,6,0,5,11
1633261100 *1,AMORTIGUADOR SUSPENSION DELANTERA (L/R) MERCEDES W163 (FREY),1937,1,1,5,7
1633261100-1,AMORTIGUADOR DE SUSPENSION DELANTERA L-R MERCEDES W163 SACHS 311367,1832,5,7,4,16
1633300051,BALERO DE RUEDA DELANTERA TRASERA L-R MERCEDES W163 OPTIMAL,1716,7,0,2,9
1633300051 *1,BALERO DE RUEDA DELANTERA TRASERA L-R MERCEDES W163 FREY,1335,2,2,7,11
1633300103,TERMINAL DIRECCION SIN BIELETA SUSPENSION DELANTERA (L) MERCEDES W163 (BMTR),1781,7,4,9,20
1633300103 *1,TERMINAL DIRECCION SIN BIELETA SUSPENSION DELANTERA (L) MERCEDES W163 (FREY),1701,0,9,9,18
1633300135 *3,ROTULA INFERIOR HORQUILLA DELANTERA MERCEDES M119 W163 (METRIX),1354,6,9,6,21
1633300203,TERMINAL DIRECCION SIN BIELETA SUSPENSION DELANTERA (R) MERCEDES W163 (BMTR),1212,3,8,1,12
1633300203-2,TERMINAL DIRECCION SIN BIELETA SUSPENSION DELANTERA (R) MERCEDES W163 (FEBI),1580,4,9,0,13
1633300403 *1,TERMINAL DIRECCION SIN BIELETA SUSPENSION DELANTERA (R) MERCEDES W163 (FREY),1814,2,0,3,5
1633300403 *3,TERMINAL DIRECCION SIN BIELETA SUSPENSION DELANTERA (R) MERCEDES W163 (FRAP),1297,9,9,9,27
1633330001 *1,HORQUILLA SUPERIOR SUSPENSION DELANTERA (L) MERCEDES W163 (FREY),1437,0,6,4,10
1633330101 *1,HORQUILLA SUPERIOR SUSPENSION DELANTERA (R) MERCEDES W163 (FREY),1412,3,3,1,7
1633380215,BIELETA DIRECCION SIN TERMINAL SUSPENSION DELANTERA (L/R) MERCEDES W163 (BMTR),1651,1,3,7,11
1633380215 *1,BIELETA DIRECCION SIN TERMINAL SUSPENSION DELANTERA (L/R) MERCEDES W163 (FREY),1609,2,4,7,13
1633380215-1,BIELETA DIRECCION SIN TERMINAL SUSPENSION DELANTERA (L/R) MERCEDES W163 (DELPHI),1597,5,8,9,22
1633500113,ROTULA HORQILLA INFERIOR TRASERAS MERCEDES W163 ML320 ML350 ML430 ML500 ( BMTR ),1827,7,3,6,16
1633500113 *1,ROTULA HORQUILLA INFERIOR TRASERAS MERCEDES W163 (FREY),1868,0,7,4,11
1633500553 *1,BRAZO SUSPENSION TRASERA INFERIOR (L) MERCEDES W163 (FREY),1409,4,9,4,17
1633500653 *1,BRAZO SUSPENSION TRASERA INFERIOR (R ) MERCEDES W163 (FREY),1205,0,1,6,7
1633500653 *3,BRAZO SUSPENSION TRASERA INFERIOR (R ) MERCEDES W163 (BMTR),1708,8,8,5,21
1633520401 *1,HORQUILLA SUPERIOR DE SUSPENSION TRASERA (L) MERCEDES W163 (FREY),1969,3,5,6,14
1633520501,HORQUILLA SUPERIOR DE SUSPENSION TRASERA R MERCEDES W163 BMTR,1986,1,6,0,7
1633520501 *1,HORQUILLA SUPERIOR DE SUSPENSION TRASERA R MERCEDES W163 FREY,1356,5,5,0,10
1634200020 *3,BALATAS FRENOS DELANTEROS 188X59 MM MERCEDES W163 (TRW GDB1378),1556,0,2,0,2
1634200020 *5,BALATAS FRENOS DELANTEROS 188X59 MM MERCEDES W163 (BOSCH) SSF,1930,2,3,0,5
1634200020 *6,BALATAS FRENOS DELANTEROS 188X59 MM MERCEDES W163 (JURID) SSF,1494,8,3,6,17
1634200320 *1,BALATAS FRENOS DELANTEROS 188X59 MM MERCEDES W163 (FREY),1714,0,0,1,1
1634201420 *1,BALATAS FRENOS TRASEROS MERCEDES W163 (FREY),1602,5,2,6,13
1634201420 *3,BALATAS FRENOS TRASEROS MERCEDES W163 TRW GDB1456,1887,8,4,3,15
1634201420 *5,BALATAS FRENOS TRASEROS MERCEDES W163 (BOSCH) SSF,1487,6,4,1,11
1634201420 *6,BALATAS FRENOS TRASEROS MERCEDES W163 (JURID) SSF,1251,2,9,4,15
1634210412,DISCO DE FRENO DELANTERO MERCEDES W2163 PAGID,1830,2,1,7,10
1634230112,DISCOS DE FRENO TRASEROS MERCEDES W163 FREMAX,1317,3,4,2,9
1634600196,CUBRE POLVO DE DIRECCION MERCEDES W163 TOPRAN,1772,7,9,8,24
1634600196 *1,CUBRE POLVO DE DIRECCION MERCEDES W163 FREY,1957,2,7,9,18
1634702894 *1,BOMBA GASOLINA ELECTRICA MERCEDES W163 (FREY),1791,3,4,7,14
1634703594-1,BOMBA DE GASOLINA MERCEDES W163 BMTR,1494,9,8,4,21
1634770701,FILTRO COMBUSTIBLE GASOLINA MERCEDES W163 BMTR,1498,6,8,7,21
1634770701 *3,FILTRO COMBUSTIBLE GASOLINA MERCEDES W163 (MAHLE KL437),1337,1,4,1,6
1634770801 *3,FILTRO COMBUSTIBLE GASOLINA MERCEDES BENZ (MAHLE KL438),1252,7,8,2,17
1635000003 *1,RADIADOR DE MOTOR MERCEDES W163-M112 FREY,1413,0,0,5,5
1635000006 *1,TAPON DEPOSITO ANTICONGELANTE ENDRIAMIENTO MOTOR W163 M112 M113 (FREY),1297,5,4,0,9
1635000006 *5,TAPON DE DEPOSITO DE ANTICONGELANTE W163 / M112 ( FEBI ) SSF,1432,4,8,8,20
1635000006-1,TAPON DE DEPOSITO DE ANTICONGELANTE W163 / M112 ( TOPRAN 401866755 ),1211,7,0,4,11
1635000349 *1,DEPOSITO ANTICONGELANTE ENFRIAMIENTO MOTOR MERCEDES W163 M112 M113 (FREY),1387,8,8,2,18
1635000349-4,DEPOSITO DE ANTICONGELANTE MERCEDES W163 (EMBLER),1281,2,1,1,4
1635000393,MOTOVENTILADOR CON MODULO W163 ( NUEVO ),1510,0,0,3,3
1635000393 *1,MOTOVENTILADOR CON MODULO W163 FREY,1868,0,3,7,10
1635400717,SENSOR DE FRENOS ABS DELANTERO ( L ) MERCEDES W163 / M112 ( BREMI ),1691,4,3,2,9
1635400717 *1,SENSOR ABS FRENOS DELANTERO (L) MERCEDES W163 (FREY),1996,0,1,3,4
1635400817,SENSOR DE FRENOS ABS DELANTERO ( R ) MERCEDES W163 / M112 ( BREMI ),1695,3,0,5,8
1635400817 *1,SENSOR ABS FRENOS DELANTEROS (R) MERCEDES W163 (FREY),1420,1,8,4,13
1635401017,SENSOR DE FRENOS ABS TRASERO L MERCEDES W163-M112 PEX,1293,8,0,7,15
1635401017 *1,SENSOR DE FRENOS ABS TRASERO L MERCEDES W163-M112 FREY,1656,8,7,7,22
1635401117 *1,SENSOR FRENOS ABS TRASERO (R ) MERCEDES W163 (FREY),1374,8,2,3,13
1635401317,SENSOR BALATAS FRENOS DELANTERO (L/R) MERCEDES W163 BMTR,1309,3,8,5,16
1635401317 *1,SENSOR BALATAS FRENOS DELANTERO (L/R) MERCEDES W163 (FREY),1836,1,1,4,6
1635401417,SENSOR BALATAS FRENOS TRASERO (L/R) MERCEDES W163 (BMTR),1777,1,4,7,12
1635401417 *1,SENSOR BALATAS FRENOS TRASERO (L/R) MERCEDES W163 (FREY),1392,7,2,0,9
1635401417-2,SENSOR BALATAS FRENOS TRASERO (L/R) MERCEDES W163 URO,1410,5,2,6,13
1637400045 *1,AMORTIGUADOR CAJUELA 510 NEWTONS 640 MM (L/R) MERCEDES W163 FREY,1258,5,0,5,10
1637400345,AMORTIGUADOR CAJUELA 510 NEWTONS 640 MM (L/R) MERCEDES W163 BMTR,1585,1,9,1,11
1637400345-2,AMORTIGUADOR CAJUELA 510 NEWTONS 640 MM (L/R) MERCEDES W163 VAICO,1660,9,6,5,20
1637400345-3,AMORTIGUADOR CAJUELA 510 NEWTONS 640 MM (L/R) MERCEDES W163 URO,1652,3,2,8,13
1637400345-4,AMORTIGUADOR CAJUELA 510 NEWTONS 640 MM (L/R) MERCEDES W163 TOPRAN,1376,4,9,5,18
1638206610 *1,CONTROLADOR DE VENTANA 8 BOTONES MERCEDES W163 FREY,1563,3,0,6,9
1638350147 *1,FILTRO POLEN AIRE CABINA MERCEDES W163 (FREY),1822,3,8,8,19
1638350247,FILTRO POLEN AIRE CABINA MERCEDES W163 (MAHLE LAK98),1587,5,2,8,15
1638690820 *2,DEPOSITO AGUA LIMPIAPARABISAS CHISGUETEROS MERCEDES W163 (EMBLER),1460,4,4,4,12
1638800029 *1,AMORTIGUADOR COFRE FUERZA 850 NEWTONS 235 MM (L/R) MERCEDES W163 (FREY),1500,5,2,1,8
1638800029 *5,AMORTIGUADOR COFRE FUERZA 850 NEWTONS 235 MM (L/R) MERCEDES W163 (STABILUS) SSF,1441,8,4,3,15
164204513-100,AMORTIGUADOR SIN BOLSA AIRE SUSPENSION DELANTERA (L/R) INACTIVO,1820,1,5,8,14
1643200130 *1,AMORTIGUADOR SIN ADS SUSPENSION DELANTERA (L/R) MERCEDES W164 (FREY),1943,3,7,6,16
1643200130 *5,AMORTIGUADOR SIN ADS SUSPENSION DELANTERA (L/R) MERCEDES W164 (SACHS 315526),1567,4,5,7,16
1643201025 *B,BOLSA AIRE SUSPENSION TRASERA (L/R) MERCEDES W164 W166 (EMBLER) TECH,1925,1,6,1,8
1643201204 *C,COMPRESOR AIRE SUSPENSION MERCEDES W164 W166 (EMBLER) TECH,1664,8,2,6,16
1643201232 *1,TORNILLO BARRA ESTABILIZADORA SUSPENSION TRASERA (L/R) MERCEDES W164 X164 W251 (FREY),1259,4,7,8,19
1643202031 *A,AMORTIGUADOR CON ADS SUSPENSION TRASERA (L/R) MERCEDES W164 (EMBLER) TECH,1803,8,8,3,19
1643202132,TORNILLO DE BARRA ESTABILIZADORA DELANTERA L-R MERCEDES W164 FEBI,1311,4,3,1,8
1643202132 *1,TORNILLO BARRA ESTABILIZADORA SUSPENSION DELANTERA (L/R) MERCEDES W164 (FREY),1371,1,6,5,12
1643202431 *A,AMORTIGUADOR SIN SENSOR SUSPENSION TRASERA (L/R) MERCEDES W164 X164 (EMBLER) TECH,1860,0,6,3,9
1643202531 *1,AMORTIGUADOR TRASERO SIN ADS L-R MERCEDES BENZ W164 FREY,1752,8,9,2,19
1643204513 *A,AMORTIGUADOR AIRE SIN ADS SUSPENSION DELANTERA (L/R) MERCEDES W164 (EMBLER) TECH,1358,1,8,3,12
1643204513 *B,BOLSA AIRE SUSPENSION DELANTERA (L/R) MERCEDES W164 X164 (EMBLER) TECH,1942,3,0,2,5
1643204513-100,ORINGS BOLSA AIRE SUSPENSION DELANTERA (L/R) INACTIVO,1337,1,0,8,9
164320453-100,PAR BOLSA AIRE SUSPENSION DELANTERA (L/R) INACTIVO,1247,7,8,8,23
1643205813 *A,AMORTIGUADOR AIRE CON ADS SUSPENSION DELANTERA (L/R) MERCEDES W164 X164 (EMBLER) TECH,1555,6,8,7,21
1643205813-100,AMORTIGUADOR AIRE SIN ADS SUSPENSION DELANTERA (L/R) MERCEDES W164 X164 (EMBLER),1771,3,9,0,12
1643231185,BUJE BARRA ESTABILIZADORA SUSPENSION DELANTERA L-R MERCEDES W164 LEMFOERDER,1836,3,9,0,12
1643231185 *1,BUJE BARRA ESTABILIZADORA SUSPENSION DELANTERA (L/R) MERCEDES W164 (FREY),1349,4,9,2,15
1643231185-1,BUJE BARRA ESTABILIZADORA SUSPENSION DELANTERA L-R MERCEDES W164-M272 FEBI,1955,6,4,8,18
1643231185-2,BUJE BARRA ESTABILIZADORA SUSPENSION DELANTERA L-R MERCEDES W164-M272 BMTR,1239,7,4,8,19
1643231185-3,BUJE BARRA ESTABILIZADORA SUSPENSION DELANTERA L-R MERCEDES W164 GENUINO,1782,8,6,2,16
1643231185-4,BUJE BARRA ESTABILIZADORA SUSPENSION DELANTERA L-R MERCEDES W164 OPTIMAL,1957,5,4,8,17
1643231185-6,BUJE BARRA ESTABILIZADORA SUSPENSION DELANTERA L-R MERCEDES W164 TOPRAN,1998,3,2,5,10
1643231185-7,BUJE BARRA ESTABILIZADORA SUSPENSION DELANTERA L-R MERCEDES W164 DORMAN ALEMAN,1819,5,3,0,8
1643300685,CUBRE POLVO FLECHA DELANTERA L-R MERCEDES W164 EMPI,1796,9,6,3,18
1643300685 *1,CUBRE POLVO FLECHA DELANTERA 125X96 MM (L/R)MERCEDES W251 W164 X164 (FREY),1949,1,1,4,6
1643300743 *1,BUJE HORQUILLA INFERIOR SUSPENSION DELANTERA (L) MERCEDES W164 X164 (FREY),1219,8,1,1,10
1643300743-100,BUJE INFERIOR DE HORQUILLA DE SUSPENSION DELANTERA (L) MERCEDES W164 SIDEM INACTIVO,1377,1,2,0,3
1643300843 *1,BUJE HORQUILLA INFERIOR SUSPENSION DELANTERA (R) MERCEDES W164 (FREY),1299,5,8,6,19
1643300843 *B2,BUJE INFERIOR DE HORQUILLA DE SUSPENSION DELANTERA R MERCEDES W164 SIDEM,1512,7,4,0,11
1643300935,ROTULA DE SUSPENSION DELANTERA MERCEDES W164 / W246 ( DELPHI ),1660,5,3,4,12
1643300935 *1,ROTULA INFERIOR SUSPENSION DELANTERA MERCEDES W164 W251 X164 (FREY),1506,3,3,8,14
1643301103 *1,TERMINAL DIRECCION SIN BIELETA SUSPENSION DELANTERA (L) MERCEDES W164-X164 M272 (FREY),1975,1,5,6,12
1643301103-1,TERMINAL DIRECCION SIN BIELETA SUSPENSION DELANTERA (L) MERCEDES W164-X164 M272 (DELPHI),1693,4,0,9,13
1643301103-100,TERMINAL DE DIRECCION L MERCEDES W164-X164 BMTR INACTIVO,1422,7,7,3,17
1643301103-2,TERMINAL DIRECCION SIN BIELETA SUSPENSION DELANTERA (L) MERCEDES W164-X164 M272 (LEMFOERDER),1483,9,0,0,9
1643301203 *1,TERMINAL DIRECCION SIN BIELETA SUSPENSION DELANTERA (R) MERCEDES W164 X164 (FREY),1455,7,7,0,14
1643301203-1,TERMINAL DIRECCION SIN BIELETA SUSPENSION DELANTERA (R) MERCEDES W164-X164 M272 (DELPHI),1208,8,0,6,14
1643301203-2,TERMINAL DIRECCION SIN BIELETA SUSPENSION DELANTERA (R) MERCEDES W164-X164 M272 (LEMFOERDER),1501,3,6,3,12
1643303407 *1,HORQUILLA INFERIOR SUSPENSION DELANTERA (L) MERCEDES W164 (FREY),1700,5,6,1,12
1643303507 *1,HORQUILLA INFERIOR SUSPENSION DELANTERA (R) MERCEDES W164 (FREY),1850,2,2,1,5
1643330314,BUJE DE BRAZO DE CONTROL INFERIOR DELANTERO MERCDES W164 SIDEM,1994,5,4,8,17
1643330314 *1,BUJE DE BRAZO DE CONTROL INFERIOR DELANTERO MERCDES W164 FREY,1598,6,8,8,22
1643330414,BUJE DE BRAZO INFERIOR DE SUSPENSION DELANTERA MERCEDES W164-X164 LEMFOERDER,1833,7,6,1,14
1643330414 *1,BUJE DE BRAZO INFERIOR DE SUSPENSION DELANTERA MERCEDES W164-X164 FREY,1718,1,0,3,4
1643330414-1,BUJE DE BRAZO INFERIOR DE SUSPENSION DELANTERA MERCEDES W164-X164 SIDEM,1581,6,2,6,14
1643331414,BUJE DE DIFERENCIAL TRASERO MERCEDES W164 FEBI,1214,4,6,4,14
1643331414 *1,BUJE DE DIFERENCIAL TRASERO MERCEDES W164 FREY,1701,4,5,4,13
1643500053 *1,TIRANTE SUSPENSION TRASERA (L/R) W164 W166 (FREY),1910,9,3,9,21
1643501306 *1,BRAZO CORTO SUSPENSION TRASERA (L ) MERCEDES W164 (FREY),1853,1,7,4,12
1643501406 *1,BRAZO RECTO INFERIOR SUSPENSION TRASERA (L/R) MERCEDES W164 W251  (FREY),1359,5,4,9,18
1643501606 *1,BRAZO CORTO SUSPENSION TRASERA (R) MERCEDES W164 W251 (FREY),1474,8,8,1,17
1643560201 *1,MASA RUEDA DELANTERA (L/R) MERCEDES W164 W251 X164 (FREY),1892,0,8,9,17
1644200820 *1,BALATAS FRENOS DELANTEROS 193X70 MM MERCEDES W211 X164 W164 W251 (FREY),1895,4,7,7,18
1644200820 *3,BALATAS FRENOS DELANTEROS 193X70 MM MERCEDES W211 X164 W164 W251 (TRW GDB1642),1730,5,4,6,15
1644200820 *5,BALATAS FRENOS DELANTEROS 193X70 MM MERCEDES W211 X164 W164 W251 (FERODO) SSF,1467,9,1,7,17
1644200820 *6,BALATAS FRENOS DELANTEROS 193X70 MM MERCEDES W211 X164 W164 W251 (ATE) SSF,1615,9,6,3,18
1644200920 *6,BALATAS FRENOS DELANTEROS 193X82 MM MERCEDES W164 W251 (BREMBO P50105N),1485,5,0,5,10
1644202320 *3,BALATAS FRENOS DELANTEROS 193X82 MM MERCEDES W164 W251 (TRW GDB1794),1524,8,9,0,17
1644202320 *5,BALATAS FRENOS DELANTEROS 193X82 MM MERCEDES W164 W251 (JURID),1280,7,4,6,17
1644202420,BALATAS FRENOS TRASEROS MERCEDES W164 PAGID T1735,1651,0,1,0,1
1644202720 *1,BALATAS FRENOS TRASEROS MERCEDES 140.3 X 51.6 MM W164 X164 (FREY),1729,6,7,0,13
1644202720 *3,BALATAS FRENOS TRASEROS MERCEDES W164-X164 (TRW GDB1643),1913,3,9,4,16
1644202720 *4,BALATAS FRENOS TRASEROS MERCEDES 140.3 X 51.6 MM W164 X164 (TEXTAR),1626,6,9,0,15
1644202720 *5,BALATAS FRENOS TRASEROS MERCEDES 140.3 X 51.6 MM W164 X164 (JURID) SSF,1988,5,6,9,20
1644210712 *1,DISCO FRENOS DELANTEROS HIPERVENTILADO 390MM L-R MERCEDES W164-AMG ZIMMERMANN COATZ,1932,9,6,8,23
1644211312 *1,DISCO FRENO DELANTERO VENTILADO (L/R) 330X54.6X170 MM MERCEDES W164 W251 (FREY),1958,4,9,6,19
1644211412 *1,DISCO FRENO DELANTERO VENTILADO (L/R) 350X54.5X169 MM MERCEDES X164 W164 W251 (FREY),1304,0,3,9,12
1644211412 *5,DISCO FRENO DELANTERO VENTILADO (L/R) 350X54.5X169 MM MERCEDES X164 W164 W251 (PAGID),1213,7,2,1,10
1644230512 *5,DISCO FRENO TRASERO SOLIDO (L/R) 330X62.9X225 MM MERCEDES W164 W251 (ZIMMERMANN) SSF,1307,4,0,8,12
1644231212 *1,DISCO FRENO TRASERO SOLIDO (L/R) 330X62.9X225 MM MERCEDES W164 W251 (FREY),1868,6,1,4,11
1644231212-100,DISCO FRENO TRASERO MERCEDES W164 BREMBO 08R10111 INACTIVO,1413,5,3,7,15
1644600005 *1,BIELETA DIRECCION SIN TERMINAL SUSPENSION DELANTERA (L/R) MERCEDES W164 X164 (FREY),1230,0,8,8,16
1644600005-1,BIELETA DIRECCION SIN TERMINAL SUSPENCION DELANTERA (L/R) MERCEDES W164-M272 (KARLYN),1429,3,3,7,13
1644600005-101,BIELETA DE DIRECCION INTERNA L-R MERCEDES W164-X164 M273 BMTR INACTIVO,1618,9,5,4,18
1644600005-7,BIELETA DIRECCION SIN TERMINAL SUSPENCION DELANTERA (L/R) MERCEDES W164-M272 (DELPHI),1733,8,6,7,21
1644600029 *1,KIT 4 PZ. BUJES DIRECCION HIDRAULICA MERCEDES W164 (FREY),1397,1,4,3,8
1644600029 *5,KIT 4 PZ. BUJES CAJA DIRECCION HIDRAULICA MERCEDES W164 (URO) SSF,1219,9,5,7,21
1644600029-100,KIT DE BUJES DE DIRECCION HIDRAULICA MERCEDES W164 BEMQW INACTIVO,1838,1,0,0,1
1644600096 *1,CUBRE POLVO DIRECCION HIDRAULICA (L/R) MERCEDES W164 W251 (FREY),1375,7,9,8,24
1644600100 *1,CAJA DE DIRECCION HIDARULICA MERCEDES W164 (FREY),1288,5,1,7,13
1644700290 *1,FILTRO REGULADOR GASOLINA FLOTADOR MERCEDES W164 W251 (FREY),1259,2,5,8,15
1644701994 *1,BOMBA GASOLINA ELECTRICA MERCEDES W164 X164 (FREY),1339,9,8,4,21
1644701994-2,BOMBA DE GASOLINA COMPLETA MERCEDES W164-X164 URO,1778,9,7,9,25
1645000049 *1,DEPOSITO ANTICONGELANTE ENFRIAMIENTO MOTOR MERCEDES W164 M272 (FREY),1441,8,3,2,13
1645000049-1,DEPOSITO DE ANTICONGELANTE MERCEDES W164-M272 (EMBLER),1737,3,0,7,10
1645010282,MANGUERA SUPERIOR DE RADIADOR MERCEDES W164 ( MOTOR 5.0L V8 ),1321,1,4,3,8
1645010282 *1,MANGUERA SUPERIOR DE RADIADOR MERCEDES W164 MOTOR 5.0L V8 FREY,1773,4,3,5,12
1645010382,MANGUERA INFERRIOR DE RADIADOR MERCEDES W164 MOTOR 5.0 L V8,1970,1,8,1,10
1645010382 *1,MANGUERA INFERIOR DE RADIADOR MERCEDES W164 MOTOR 5.0 L V8 FREY,1263,1,8,3,12
1645010582,MANGUERA INFERIOR DE RADIADOR MERCEDES W164 MEISTERSATZ,1396,5,9,6,20
1645010582 *1,MANGUERA INFERIOR DE RADIADOR MERCEDES W164 FREY,1571,9,5,0,14
1645010682,MANGUERA SUPERIOR DE RADIADOR MERCEDES MOTOR M273 8CIL VAICO,1694,5,1,7,13
1645010682 *1,MANGUERA SUPERIOR RADIADOR MERCEDES M273 (FREY),1425,9,8,6,23
1645051361,MANGUERA DE ADMISION MERCEDES W164 M273 (L) EMBLER,1279,4,7,9,20
1645051461,MANGUERA DE ADMISION MERCEDES W164 M273 (R) URO,1367,0,1,1,2
1645400717 *1,SENSOR DE FRENOS ABS TRASERO MERCEDES W164 FREY,1827,8,4,4,16
1645404633,SENSOR DE FRENOS ABS DELANTERO MERCEDES W164 GENUINO,1242,4,9,7,20
1647400145 *1,AMORTIGUADOR CAJUELA 725 NEWTONS 560 MM (L) MERCEDES W164 (FREY),1768,1,4,7,12
1647400245 *1,AMORTIGUADOR CAJUELA 725 NEWTONS 560 MM (R) MERCEDES W164 (FREY),1215,6,3,2,11
1647400345,AMORTIGUADOR CAJUELA SISTEMA AUTOMATICO 700 NEWTONS 531 MM (L) MERCEDES W164 BMTR,1368,5,5,8,18
1647400345 *1,AMORTIGUADOR CAJUELA SISTEMA AUTOMATICO 700 NEWTONS 531 MM (L) MERCEDES W164 FREY,1410,8,8,1,17
1647400445,AMORTIGUADOR CAJUELA SISTEMA AUTOMATICO 700 NEWTONS 561 MM (R) MERCEDES W164 BMTR,1483,7,1,0,8
1647400445 *1,AMORTIGUADOR CAJUELA SISTEMA AUTOMATICO 700 NEWTONS 561 MM (R) MERCEDES W164  FREY,1407,6,3,0,9
1647400645  *1,AMORTIGUADOR CAJUELA 760 NEWTONS 521 MM (R) MERCEDES W164 (FREY),1797,1,4,4,9
1647874080 *3,BALATAS FRENOS DELANTERAS PEUGEOT/CITROï¿½N (TRW GDB1691),1302,6,5,2,13
1648203185,MODULO DE QUINTA PUERTA AUTOMï¿½TICA MERCEDEZ W164 ( ORIGINAL ),1745,7,8,2,17
1648203185 *1,MODULO DE QUINTA PUERTA AUTOMï¿½TICA MERCEDEZ W164 FREY,1456,6,4,6,16
1648204926,MODULO ELECTRONICO DE CAJUELA MERCEDES W164 ( GENUINO ),1727,8,9,4,21
1648204926 *1,MODULO ELECTRONICO DE CAJUELA MERCEDES W164 FREY,1840,4,5,8,17
1648300218,FILTRO POLEN AIRE CABINA MERCEDES W164 KOLBENSCHMIDT 50014234,1346,7,5,2,14
1648300218 *1,FILTRO POLEN AIRE CABINA MERCEDES W164 FREY,1907,9,7,5,21
1648300218 *3,FILTRO POLEN AIRE CABINA MERCEDES W164 (MAHLE LAK295/S),1532,5,6,2,13
1648300218-2,FILTRO POLEN AIRE CABINA MERCEDES W164 CORTECO,1706,4,5,4,13
1648800029 *1,AMORTIGUADOR COFRE FUERZA 330 NEWTONS 533 MM (L) MERCEDES W164 (FREY),1361,0,7,7,14
1648800129,AMORTIGUADOR COFRE FUERZA 330 NEWTONS 570 MM (R) MERCEDES W164 BMTR,1279,1,4,2,7
1648800129B,AMORTIGUADOR COFRE FUERZA 330 NEWTONS 570 MM (R) MERCEDES W164 (FREY),1478,4,3,5,12
1649058200,SENSOR DE FRENOS ABS DELANTERO MERCEDES W164-M273 BMTR,1552,0,9,6,15
1649058200 *1,SENSOR DE FRENOS ABS DELANTERO MERCEDES W164-M273 FREY,1685,5,0,5,10
1649058200-1,SENSOR DE FRENOS ABS DELANTERO MERCEDES W164-M273 PEX,1689,1,8,6,15
1649058200-2,SENSOR DE FRENOS ABS DELANTERO MERCEDES W164-M273 BREMI,1433,7,1,1,9
1649058300,SENSOR DE FRENOS ABS TRASERO MERCEDES W164 BREMI,1751,0,2,6,8
1649058300-1,SENSOR DE FRENOS ABS TRASERO MERCEDES W164 BMTR,1510,7,4,9,20
1649058300-2,SENSOR DE FRENOS ABS TRASERO MERCEDES W164 PEX,1525,8,6,5,19
1649058300-6,SENSOR DE FRENOS ABS TRASERO MERCEDES W164 BEMQW,1344,7,6,0,13
1649800364 *1,AMORTIGUADOR COFRE FUERZA 355 NEWTONS 590 MM (L) MERCEDES X164 (FREY),1352,6,6,4,16
1649800464-100,AMORTIGUADOR COFRE 355 NEWTONS LARGO 590 MM (R) MERCEDES X164 (FREY) INACTIVO,1874,4,0,4,8
1649810206,BALERO DE RUEDA DELANTERA L-R MERCEDES X164-M273 BMTR,1574,6,5,7,18
1649810206 *1,BALERO DOBLE RUEDA DELANTERA 50 X 54 X 98 MM (L/R) MERCEDES W164 X164 (FREY),1553,3,9,7,19
1649810206-1,BALERO DE RUEDA DELANTERA L-R MERCEDES X164-M273 OPTIMAL,1475,2,5,1,8
1649810206-2,BALERO DE RUEDA DELANTERA L-R MERCEDES X164-M273 BENDIX,1608,6,6,6,18
1649810406,BALERO DE RUEDA DELANTERO TRASERO L-R MERCEDES W164 BMTR,1339,9,2,1,12
1649810406 *1,BALERO DE RUEDA DELANTERO TRASERO L-R MERCEDES W164 FREY,1506,5,6,2,13
1649810406-1,BALERO DE RUEDA DELANTERO TRASERO L-R MERCEDES W164 NTN,1603,6,9,7,22
1660100014 *5,RETEN CIGUEï¿½AL TRASERO MERCEDES W168 M166 (ELRING),1441,9,1,3,13
1660160220,JUNTA CABEZA MOTOR MEDIDA STANDAR 0.70 MM MERCEDES M166 ELRING 445190,1814,1,5,4,10
1660160220 *1,JUNTA CABEZA MOTOR MEDIDA STANDAR 0.70 MM MERCEDES M166 (FREY) 445190,1374,7,6,8,21
1660940004,FILTRO ENTRADA AIRE MOTOR MERCEDES W168 1.4 L KOLBENSCHMIDT,1455,2,1,6,9
1660940004 *3,FILTRO ENTRADA AIRE MOTOR MERCEDES W168 1.4 L (MAHLE LX794),1837,7,1,6,14
1660940004-2,FILTRO ENTRADA AIRE MOTOR MERCEDES W168 1.4 L MANN C1381,1480,7,7,6,20
1661800009-1,FILTRO ACEITE MOTOR MERCEDES BENZ W168 TOPRAN,1943,0,2,6,8
1662000720,BOMBA AGUA MECANICA ENFRIAMIENTO MOTOR MERCEDES CLASE A W168 (GRAF),1263,9,8,8,25
1662030275,TERMOSTATO DE MOTOR MERCEDES W168 GENUINO,1616,2,9,5,16
1662030275 *1,TERMOSTATO DE MOTOR MERCEDES W168 FREY,1315,0,7,2,9
1662030275-4,TERMOSTATO DE MOTOR MERCEDES W168 OSSCA,1823,8,2,9,19
1662400818 *1,SOPORTE TRANSMISION AUTOMATICA TRASERO MERCEDES W166 M276 (FREY),1992,3,6,2,11
1662400918 *2,SOPORTE DE TRANSMISION MERCEDES W164 W166 (EMBLER),1763,6,0,1,7
1662403817-100,SOPORTE DE MOTOR L MERCEDES W166 BEMQW INACTIVO,1211,1,2,9,12
1662403917,SOPORTE DE MOTOR R MERCEDES W166 BMTR,1591,2,5,3,10
1662403917-2,SOPORTE DE MOTOR R MERCEDES W166 KZR GERMANY,1209,9,7,6,22
1662403917-4,SOPORTE DE MOTOR R MERCEDES W166 BEMQW,1351,5,4,9,18
1662405817 *1,SOPORTE MOTOR (L) MERCEDES W166 3.0L 3.5L (FREY),1676,9,2,8,19
1662405917 *1,SOPORTE MOTOR (R) MERCEDES W166 3.0L 3.5L (FREY),1970,8,9,1,18
1662406017 *1,SOPORTE MOTOR (L) MERCEDES W166 4.6L (FREY),1854,9,4,4,17
1662406117 *1,SOPORTE MOTOR (R) MERCEDES W166 4.6L (FREY),1807,0,8,3,11
1662406817 *1,SOPORTE MOTOR CON SENSOR (R) MERCEDES C292 W166 X166 (FREY),1750,5,5,9,19
1662406917 *1,SOPORTE MOTOR CON SENSOR (L) MERCEDES C292 W166 X166 (FREY),1716,7,2,0,9
1663200030 *1,AMORTIGUADOR SIN ADS SUSPENSION TRASERA (L/R) MERCEDES W164 2012 A 2015 W166 2016 A 2019 (FREY),1305,8,8,7,23
1663200130 *A,AMORTIGUADOR CON ADS SUSPENSION TRASERA (L/R) MERCEDES W164 2012 A 2015 W166 X166 (EMBLER) TECH,1423,8,5,2,15
1663200325 *KB,PAR BOLSA AIRE SUSPENSION TRASERA (L/R) MERCEDES W164 W166 (EMBLER),1243,6,9,4,19
1663200325 *O,ORINGS BOLSA AIRE SUSPENSION TRASERA (L/R) MERCEDES W164 W166 (EMBLER),1710,4,0,4,8
1663200325 *T,TAPA BOLSA AIRE SUSPENSION TRASERA (L/R) MERCEDES W164 W166 (EMBLER),1767,2,6,0,8
1663200326B,BASE AMORTIGUADOR SUSPENSION DELANTERA (L/R) 3 TORNILLOS MERCEDES W166 (FREY),1213,2,5,3,10
1663200789,TORNILLO ESTABILIZADOR SUSPENSION DELANTERA (L) MERCEDES W166 (SIDEM),1592,0,7,2,9
1663200789 *1,TORNILLO ESTABILIZADOR SUSPENSION DELANTERA (L) MERCEDES W166 (FREY),1473,9,1,2,12
1663200789-1,TORNILLO ESTABILIZADOR SUSPENSION DELANTERA (L) MERCEDES W166 (TOPRAN),1989,5,3,5,13
1663200889,TORNILLO ESTABILIZADOR SUSPENSION DELANTERA (R) MERCEDES W166 (SIDEM),1447,6,6,7,19
1663200889 *1,TORNILLO ESTABILIZADOR SUSPENSION DELANTERA (R) MERCEDES W166 (FREY),1736,6,1,1,8
1663200889-1,TORNILLO ESTABILIZADOR SUSPENSION DELANTERA (R) MERCEDES W166 (TOPRAN),1237,0,0,6,6
166320113-100,AMORTIGUADOR SIN BOLSA DE AIRE SUSPENSION DELANTERA (L) MERCEDES W166 INACTIVO,1824,1,6,4,11
16632013-100,AMORTIGUADOR DE AIRE SUSPENSION DELANTERA ( L ) MERCEDES INACTIVO,1826,4,9,3,16
166320131-100,AMORTIGUADOR AIRE ADS SUSPENSION DELANTERA (L) MERCEDES W166 INACTIVO,1365,9,7,0,16
1663201313 *1,AMORTIGUADOR AIRE ADS SUSPENSION DELANTERA (L) MERCEDES W166 X166 1a GEN (FREY),1994,2,8,5,15
1663201313 *A,AMORTIGUADOR AIRE ADS SUSPENSION DELANTERA (L) MERCEDES W166 X166 1a GEN (EMBLER) TECH,1658,9,7,9,25
1663201313 *B,BOLSA AIRE SUSPENSION DELANTERA (L) MERCEDES W166 X166 1a GEN (EMBLER) TECH,1496,5,9,5,19
1663201313 *S,AMORTIGUADOR SIN BOLSA SUSPENSION DELANTERA (L) MERCEDES W166 (EMBLER),1563,7,6,1,14
1663201313 -6,AMORTIGUADOR AIRE SUSPENSION DELANTERA (L) MERCEDES W166 (GENUINO).,1747,8,8,1,17
1663201313-100,AMORTIGUADOR AIRE SUSPENSION DELANTERA (L) MERCEDES W166 (GENUINO) INACTIVO,1952,1,2,8,11
1663201313-101,AMORTIGUADOR SIN BOLSA AIRE DELANTERO (L) MERCEDES W166 (GENUINO) INACTIVO,1924,6,6,1,13
1663201314-100,AMORTIGUADOR AIRE ADS SUSPENSION DELANTERA (R) MERCEDES W166 (EMBLER) CYS INACTIVO,1639,9,7,0,16
1663201314-101,AMORTIGUADOR AIRE ADS SUSPENSION DELANTERA (R) MERCEDES W166 (EMBLER)CYS INACTIVO,1999,5,5,6,16
1663201314-102,AMORTIGUADOR AIRE CON ADS SUSPENSION DELANTERA (R) MERCEDES W166 (GENUINO) INACTIVO,1279,1,6,9,16
1663201314-103,AMORTIGUADOR AIRE SUSPENSION DELANTERA (R) MERCEDES W166 (GENUINO) CYS INACTIVO,1826,7,5,0,12
1663201314-104,AMORTIGUADOR SIN BOLSA DE AIRE DELANTERO (R) MERCEDES W166 (GENUINO) INACTIVO,1704,8,5,2,15
1663201413 *A,AMORTIGUADOR AIRE ADS SUSPENSION DELANTERA (R) MERCEDES W166 X166 1A GEN (EMBLER) TECH,1201,3,9,0,12
1663201413 *B,BOLSA AIRE SUSPENSION DELANTERA (R) MERCEDES W166 X166 1a GEN (EMBLER) TECH,1547,5,7,1,13
1663201730,AMORTIGUADOR DE SUSPENSION TRASERA MERCEDES W166 SACHS 316298,1586,3,6,7,16
1663231000 *1,AMORTIGUADOR SIN ADS SUSPENSION DELANTERA (L/R) MERCEDES W164 2012 A 2015 W166 X166 (FREY),1310,2,8,2,12
1663231465 *1,BARRA ESTABILIZADORA DELANTERA MERCEDES W166 (FREY),1512,3,1,6,10
1663231465B,BUJE BARRA ESTABILIZADORA DELANTERA (L/R) MERCEDES W164 W166 (FREY),1536,0,9,3,12
1663232400-100,AMORTIGUADOR CON RESORTE SUPENSION DELANTERA (L/R) INACTIVO,1299,5,6,4,15
1663232400-101,AMORTIGUADOR DE SUSPENSION DELANTERA L-R MERCEDES W166 SACHS 316297 CYS INACTIVO,1362,5,0,3,8
1663300107 *1,HORQUILLA DE SUSPENSION DELANTERA INFERIOR ( L ) MERCEDES W166 ( FREY ),1929,7,9,3,19
1663300143 *1,BUJE HORQUILLA INFERIOR SUSPENSION DELANTERA (L) MERCEDES W166 (FREY),1804,4,1,0,5
1663300207 *1,HORQUILLA INFERIOR SUSPENSION DELANTERA (R) MERCEDES W166 X166 (FREY),1376,9,1,6,16
1663300235 *1,ROTULA INFERIOR DE SUSPENSION DELANTERA (L/R) MERCEDES C292 W166 X166 (FREY),1245,6,3,7,16
1663300243 *1,BUJE INFERIOR DE HORQUILLA (R) MERCEDES W166 (FREY),1287,6,4,8,18
1663300243 *2,BUJE INFERIOR DE HORQUILLA (R) MERCEDES W166 SIDEM,1558,6,3,6,15
1663301600 *1,FLECHA HOMOCINETICA DELANTERA (L) MERCEDES W166 (FREY),1312,1,8,4,13
1663301707 *1,HORQUILLA SUPERIOR DE SUSPENSION DELANTERA (L) MERCEDES W166 (FREY),1402,8,6,7,21
1663301707 *3,HORQUILLA SUPERIOR DE SUSPENSION DELANTERA (L) MERCEDES W166 (AYD),1919,0,0,5,5
1663301707 *5,HORQUILLA SUPERIOR DE SUSPENSION DELANTERA (L) MERCEDES W166 (FEBI) SSF,1409,9,7,6,22
1663301807 *1,HORQUILLA SUPERIOR DE SUSPENSION DELANTERA (R) MERCEDES W166 (FREY),1318,9,9,4,22
1663330000 *1,BUJE BRAZO DE CONTROL SUSPENSION DELATERA (L/R) MERCEDES W166 (FREY),1701,8,5,1,14
1663330814 *1,BUJE DIFERENCIAL DELANTERO MERCEDES C292 W166 X166 (FREY),1881,7,6,5,18
1663340206 *1,BALERO MAZA DELANTERO MERCEDES BENZ W166 (FREY),1973,7,6,6,19
1663380315 *1,BIELETA DIRECCION SIN TERMINAL SUSPENSION DELANTERA (L/R) MERCEDES W166 (FREY),1536,3,3,6,12
1663500106 *3,BRAZO RECTO DE SUSPENSION TRASERA (L) MERCEDES W166 (ELRING),1913,8,3,0,11
1663500206 *2,BRAZO CURVO DE SUSPENSION TRASERA (R) MERCEDES W166 (EMBLER),1862,5,9,9,23
1664210512 *1,DISCO FRENOS DELANTEROS HIPERVENTILADO (L/R) 390 MM MERCEDES W166 X166 (FREY),1518,7,4,9,20
1664210912 *1,DISCO FRENOS DELANTERO HIPERVENTILADO 375 MM (L/R) MERCEDES W166 (FREY),1867,4,3,6,13
1664210912-3,DISCO DE FRENO DELANTERO MERCEDES W166 FREMAX,1479,4,7,1,12
1664230112 *2,DISCO FRENOS TRASERO (L/R) MERCEDES W166 (EMBLER),1342,8,1,8,17
1664230312 *3,DISCO FRENOS TRASERO 345 X 22 MM MERCEDES X166 W166 (FRICCO),1519,1,3,4,8
1664230412 *1,DISCO FRENOS TRASEROS HIPERVENTILADO 330 MM (L/R) MERCEDES W166 (FREY),1422,1,8,7,16
1664230512,DISCO DE FRENO TRASERO MERCEDES W166 FREMAX,1275,1,9,7,17
1664701794 *1,BOMBA COMBUSTIBLE GASOLINA MERCEDES X166 W166 W251 (FREY),1447,0,0,0,0
1664701794 *2,BOMBA COMBUSTIBLE GASOLINA MERCEDES X166 W166 W251 (EMBLER),1885,3,4,8,15
1664702594 *1,BOMBA ELECTRICA COMBUSTIBLE DIESEL MERCEDES W166 (FREY),1441,4,2,3,9
1665000049 *1,DEPOSITO ANTICONGELANTE ENFRIAMIENTO MOTOR MERCEDES W166 M276 M278 (FREY),1644,8,8,2,18
1665000075 *1,MANGUERA SUPERIOR DE RADIADOR MERCEDES W166 X166 (FREY),1919,0,6,5,11
1665000875 *1,MANGUERA DEPOSITO ANTICONGELANTE A RADIADOR MERCEDES W166 M276 (FREY),1388,0,7,1,8
1665001091 *1,MANGUERA DE RADIADOR MERCEDES W166 (FREY),1847,0,0,4,4
1665001091 *2,MANGUERA DE RADIADOR MERCEDES W166 (EMBLER),1870,4,5,6,15
1665008575,MANGUERA SUPERIOR DE MERCEDES W166 GENUINA,1651,8,2,6,16
1665008575 *1,MANGUERA SUPERIOR DE RADIADOR MERCEDES W166 (FREY),1918,3,9,2,14
1665008675 *1,MANGUERA INFERIOR DE RADIADOR MERCEDES W164 X164 (FREY),1428,3,1,3,7
1665420218 *1 ,CABLE NEGATIVO BATERIA CON SENSOR TEMPERATURA MERCEDES W204 X204 R172 W212 (FREY),1893,9,6,1,16
1665420318 *1 ,CABLE NEGATIVO BATERIA CON SENSOR TEMPERATURA MERCEDES W212 W219 (FREY),1286,1,0,9,10
1668300218 *5,1 PZ FILTRO POLEN AIRE CABINA MERCEDES C190 W205 W213 W164 X164 W166 X166 (AIRMATIC ) SSF,1980,5,9,3,17
1668300218-100,FILTRO AIRE CABINA MERCEDES W205 (MAHLE LA877) INACTIVO,1776,6,2,4,12
1668300318 *5,KIT 2 PZ FILTRO POLEN AIRE CABINA MERCEDES C292 W166 X166 (AIRMATIC) SSF,1803,3,8,3,14
1669002800 *2,BALASTRA MODULO ELECTRONICO LUZ XENON D1S MERCEDES AUDI VW BMW VOLVO (EMBLER) MLL,1533,7,3,2,12
1669054002 *1,SENSOR FRENOS ABS DELANTERO (L/R) MERCEDES W166 (FREY),1354,1,9,9,19
1669054102 *1 ,SENSOR FRENOS ABS TRASERO (L/R) MERCEDES W166 (FREY),1771,4,9,5,18
1669065401 *1,ACTUADOR ELECTRICO FRENO ESTACIONAMIENTO (L/R) MERCEDES W166 W205 W212 (FREY),1505,7,9,0,16
1669803464 *1,AMORTIGUADOR CAJUELA 600 NEWTONS 628 MM (L) MERCEDES BENZ W166 FREY,1772,1,2,3,6
1669970046 *1,RETEN DE CIGUEï¿½AL DELANTERO MERCEDES W168 SAMART FREY,1247,0,5,4,9
1669970246,RETEN DE CIGUEï¿½AL DELANTERO MERCEDES W168 SAMART TOPRAN,1329,2,7,2,11
1673200189 *1,TERMINAL DIRECCION SIN BIELETA SUSPENSION DELANTERA (L) MERCEDES W167 (FREY),1841,6,4,5,15
1673200503 *2,AMORTIGUADOR AIRE SUSPENSION DELANTERA (L) MERCEDES C167 W167 (EMBLER) TECH,1600,2,1,1,4
1673200603 *2,AMORTIGUADOR AIRE SUSPENSION DELANTERA (R) MERCEDES C167 W167 (EMBLER) TECH,1877,4,4,7,15
1673237400 *2,AMORTIGUADOR AIRE SUSPENSION DELANTERA (L/R) MERCEDES W167 (EMBLER),1231,6,8,0,14
1673300700 *1,HORQUILLA SUSPENSION DELANTERA (L) MERCEDES W167 (FREY),1239,6,2,5,13
1673300800 *1,HORQUILLA SUSPENSION DELANTERA (R) MERCEDES W167 (FREY),1300,7,7,2,16
1673301300 *1,BRAZO DE CONTROL SUSPENSION DELANTERA (L) MERCEDES W167 (FREY),1767,1,7,0,8
1673301400 *1,BRAZO DE CONTROL SUSPENSION DELANTERA (R) MERCEDES W167 (FREY),1276,4,4,9,17
1673380000 *2,BIELETA DIRECCION  CON TERMINAL SUSPENSION DELANTERA (L/R) MERCEDES W167 (EMBLER),1827,1,7,1,9
1683201830,AMORTIGUADOR DELANTERO ( L-R ) A160 W168 BLISTEIN,1552,5,5,1,11
1683301335,BIELETA DIRECCION CON TERMINAL SUSPENSION DELANTERA (L/R) MERCEDES CLASE A W168 (LEMFORDER),1421,6,4,2,12
1685000249,DEPOSITO DE ANTICONGELANTE MERCEDES W168 GENUINO,1438,7,2,1,10
1685000249 *1,DEPOSITO DE ANTICONGELANTE MERCEDES W168 FREY,1637,4,0,8,12
1685000249-2,DEPOSITO DE ANTICONGELANTE MERCEDES W168 (EMBLER),1335,3,6,7,16
1685010082,MANGUERA SUPERIOR DE RADIADOR MERCEDES W168 / M166 ( GENUINA ),1937,7,0,4,11
1685010082 *1,MANGUERA SUPERIOR DE RADIADOR MERCEDES W168 / M166 FREY,1911,3,6,3,12
1688300018,FILTRO POLEN AIRE CABINA MERCEDES W168 AIR MATIC,1331,1,8,0,9
1688300018 *3,FILTRO POLEN AIRE CABINA MERCEDES W168 MAHLE (LAK81) DGO,1432,4,8,5,17
1692400618,SOPORTE DE MOTOR ( R ) MERCEDES W169 / W245 ( SWAG 10930008 ),1495,0,3,7,10
1692400618 *1,SOPORTE MOTOR TRASERO (R) MERCEDES W169 W245 (FREY),1589,5,6,8,19
1692400618-1,SOPORTE DE MOTOR TRASERO R MERCEDES W169 - W245 VAICO,1794,6,3,9,18
1692400618-3,SOPORTE DE MOTOR R MERCEDES W169-W245 BMTR,1740,6,3,7,16
1692400817,SOPORTE DE MOTOR DELANTERO L-R MERCEDES W169 - W245 VAICO,1368,2,4,1,7
1692400918 *1,SOPORTE MOTOR DELANTERO (L) MERCEDES W245 M266 (FREY),1228,8,2,4,14
1692401018 *1,SOPORTE MOTOR DERECHO MERCEDES W169 W245  (FREY),1771,0,0,1,1
1692401218 *1,SOPORTE MOTOR (L)MERCEDES W169 W245 (FREY),1932,9,5,3,17
1692401218-1,SOPORTE DE MOTOR L MERCEDES W169-W245 SWAG 10930009,1230,9,3,0,12
1692401218-9,SOPORTE DE MOTOR L MERCEDES W169-W245 BMTR,1596,8,4,3,15
1692401417 *1,SOPORTE DE MOTOR DELANTERO L-R MERCEDES W169 - W245 FREY,1587,5,0,6,11
1692401517,SOPORTE DELANTERO MERCEDEZ CLASE B200 W169 VAICO,1253,8,1,9,18
1692401517 *1,SOPORTE MOTOR DELANTERO (L/R) MERCEDES W169 (FREY),1660,5,7,3,15
1693200073 *1,BASE AMORTIGUADOR SUSPENSION DELANTERA (L/R) MERCEDES W169 W245 (FREY),1324,9,1,9,19
1693200830 *1,AMORTIGUADOR SUSPENSION DELANTERA (L/R) MERCEDES W169 W245 (FREY),1830,8,4,6,18
1693200989,TORNILLO ESTABILIZADOR SUSPENSION DELANTERA (L/R) MERCEDES W245 (DELPHI),1755,1,3,0,4
1693200989 *1,TORNILLO ESTABILIZADOR SUSPENSION DELANTERA (L/R) MERCEDES W245 (FREY),1789,0,6,2,8
1693201730-9,AMORTIGUADOR DE SUSPENSION DELANTERA L-R MERCEDES W245 SACHS 315293,1262,2,4,1,7
1693230192 *2,CUBRE POLVO AMORTIGUADOR SUSPENSION DELANTERA L/R MERCEDES B200 A200 (EMBLER),1819,6,2,3,11
1693260000 *1,AMORTIGUADOR SUSPENSION TRASERA (L/R) MERCEDES W169 W245 (FREY),1210,8,2,1,11
1693300503 *1,TERMINAL DIRECCION SIN BIELETA SUSPENSION DELANTERA (L) MERCEDES W169 (FREY),1608,2,8,6,16
1693300603,TERMINAL DIRECCION SIN BIELETA SUSPENSION DELANTERA (R) MERCEDES W245 (METRIX),1249,0,8,7,15
1693300603 *1,TERMINAL DIRECCION SIN BIELETA SUSPENSION DELANTERA (R) MERCEDES W245 (FREY),1803,4,9,5,18
1693300903 *1,BIELETA DIRECCION SIN TERMINAL SUSPENSION DELANTERA (L/R) MERCEDES W169 W245 (FREY),1499,7,2,2,11
1693330127,ROTULA INFERIOR DE SUSPENSION DELANTERA L-R MERCEDES W245 BMTR,1250,9,7,5,21
1693330127 *1,ROTULA INFERIOR DE SUSPENSION DELANTERA L-R MERCEDES W245 FREY,1518,2,8,7,17
1693601768,KIT JUNTA HOMOCINETICA EXTERIOR (ESPIGA RUEDA) L-R MERCEDES W245 LUZAN,1810,1,7,1,9
1693601768 *1,CUBRE POLVO JUNTA HOMOCINETICA EXTERIOR (L/R) MERCEDES W169 W245 (FREY),1726,8,1,0,9
1693705672 *1,KIT JUNTA HOMOCINETICA EXTERIOR (ESPIGA RUEDA) L-R MERCEDES W245 (FREY),1457,0,3,1,4
1694200120 *3,BALATAS FRENOS DELANTEROS 131 X 70 MERCEDES W169-W245 (TRW GDB1628),1864,3,8,1,12
1694200320 *1,BALATAS FRENOS DELANTEROS MERCEDES W169 W245 (FREY),1930,6,9,1,16
1694200420 *3,BALATAS FRENOS TRASEROS 95 X 41 MERCEDES W169 - W245 (TRW GDB1481),1500,0,3,1,4
1694201720,BALATAS FRENOS TRASEROS 95 X 41 MERCEDES W168 -W245 BREMBO CERAMICA P50090N,1255,4,0,4,8
1694201720-1,BALATAS FRENOS TRASEROS 94 X 41 MERCEDES W169 - W245 PAGID T1530,1235,0,0,3,3
1694201720-2,BALATAS FRENOS TRASEROS 95 x 41 MERCEDES W169 - W245 TEXTAR 2313805,1461,8,9,7,24
1694201920,BALATAS FRENOS DELANTEROS 131 x 70 MERCEDES W169-W245 BREMBO CERAMICA P50057N,1295,6,6,7,19
1694201920-1,BALATAS FRENOS DELANTEROS 131 X 70 MERCEDES W169-W245 TEXTAR 2388101,1375,2,6,5,13
1694700494,BOMBA DE GASOLINA MERCEDES W245 TURBO BMTR,1240,2,0,8,10
1694700494 *1,BOMBA DE GASOLINA MERCEDES W245 TURBO FREY,1254,8,4,1,13
1695000149 *1,DEPOSITO ANTICONGELANTE ENFRIAMIENTO MOTOR MERCEDES W169 W245 (FREY),1907,3,2,1,6
1695401417 *1,SENSOR DE FRENOS ABS DELANTERO MERCEDES W245-W169 FREY,1224,5,7,2,14
1695401417-100,SENSOR DE FRENOS ABS DELANTERO MERCEDES W245-W169 BMTR INACTIVO,1365,6,5,4,15
1695401517,SENSOR DE FRENOS ABS TRASERO MERCEDES W245-W169 BMTR,1211,2,5,1,8
1695401517 *1,SENSOR DE FRENOS ABS TRASERO MERCEDES W245-W169 FREY,1787,0,7,3,10
1695401617 *1,SENSOR BALATAS FRENOS TRASERO (L/R) 0.94 MM MERCEDES C117 C118 W176 W177 W205 W206 W246 W247 X117 X118 (FREY),1936,9,5,3,17
1695401617 *3,SENSOR BALATAS FRENOS TRASERO (L/R) 0.94 MM MERCEDES C117 C118 W176 W177 W205 W206 W246 W247 X117 X118 (SORTECH),1292,7,6,6,19
1695451032 *1,MODULO DE TRANSMISION AUTOMATICA MERCEDES  FREY,1765,6,0,7,13
1695451032 *9,SERVICIO DE REPARACION DE MODULO DE TRANSMISION MERCEDEZ BENZ B200,1613,4,8,8,20
1697400045 *1,AMORTIGUADOR CAJUELA 430 NEWTONS 497 MM (L/R) MERCEDES W169 FREY,1798,5,3,9,17
1698201745,LIMPIAPARABRISAS TRASERO MERCEDES W164 700-530 BOSCH,1840,5,3,7,15
1698201745 *1,LIMPIAPARABRISAS TRASERO MERCEDES W164 700-530 FREY,1537,6,0,7,13
1698203542 *1,MOTOVENTILADOR ENFRIAMIENTO MOTOR MERCEDES W245 (FREY),1351,9,8,6,23
1698206710-100,CONTROLADOR DE VENTANA 4 BOTONES MERCEDES W169 INACTIVO,1514,4,4,5,13
1698206710-9116 *1,CONTROL ELECTRICO PRINCIPAL CRISTALES ESPEJOS (L) NEGRO MERCEDES W169 W245 (FREY),1251,9,4,5,18
1698300218 *1,FILTRO POLEN AIRE CABINA CARBON ACTIVO MERCEDES W169 W245 (FREY),1585,1,4,7,12
1698300218 *3,FILTRO POLEN AIRE CABINA CARBON ACTIVO MERCEDES W169-W245 (MAHLE LAK252),1835,2,9,4,15
169971448,ORING DE LA BOMBA DE TRANSMISION MERCEDES W203 ( DPH ),1884,9,6,3,18
1704100015,JUNTA DE GOMA TRASERA / DELANTERA CARDAN MERCEDES W202-W210-M112 V6 FREY,1445,7,0,9,16
1704100015 *3,JUNTA DE GOMA TRASERA / DELANTERA CARDAN MERCEDES W202-W210-M112 V6 (TOPRAN),1905,6,0,3,9
1708800229,AMORTIGUADOR COFRE FUERZA 260 NEWTONS 874 MM (L/R) MERCEDES R170 STABILUS,1822,1,6,8,15
1708800229 *1,AMORTIGUADOR COFRE FUERZA 260 NEWTONS 874 MM (L/R) MERCEDES R170 FREY,1784,3,3,7,13
1708800229-2,AMORTIGUADOR COFRE FUERZA 260 NEWTONS 874 MM (L/R) MERCEDES R170 OPTIMA,1441,7,6,0,13
17101439101 *2,RADIADOR ENFRIAMIENTO MOTOR BMW E53 M54 M62 (NISSEN),1445,6,0,9,15
17101439110 *1,PLACA DE MONTAJE DE DEPOSITO ANTICONGELANTE BMW E53 / N62  ( FREY ),1279,3,3,4,10
17101439112-100,ENFRIADOR DE ACEITE DE TRANSMISION AUTOMATICA BMW E53-M54 FEBI INACTIVO,1951,4,3,5,12
17101439140 *1,ORING ENFRIADOR ACEITE TRANSMISION 16.5X4.8X23 BMW E53 (FREY),1443,9,0,0,9
17101439140 *3,ORING ENFRIADOR ACEITE TRANSMISION 16.5X4.8X23 BMW E53 (GENUINO),1450,1,1,0,2
17101440252,TOLVA DE VENTILADOR DE RADIADOR BMW E39 M62(URO),1922,3,4,8,15
17107509071 *1,DEPOSITO ANTICONGELANTE ENFRIAMIENTO MOTOR MINI R50 R52 W10 (FREY),1614,0,8,6,14
17107509071 *5,DEPOSITO ANTICONGELANTE ENFRIAMIENTO MOTOR MINI R50 R52 W10 (REIN) SSF,1327,8,9,3,20
17107514964,DEPOSITO DE ANTICONGELANTE BMW E53-M62 BEHR,1507,6,0,2,8
17107514964 *1,DEPOSITO ANTICONGELANTE BMW E53 M62 (FREY),1206,6,6,9,21
17107514964 *2,DEPOSITO DE ANTICONGELANTE BMW E53-M62 (EMBLER),1443,1,5,4,10
17107515485 *5,TAPON DEPOSITO ANTICONGELANTE ENFRIAMIENTO MOTOR MINI R50 R52 W10 (URO) SSF,1853,9,9,3,21
17107515499 *1,TAPON DEPOSITO ANTICONGELANTE ENFRAIMIENTO MOTOR MINI R50 R52 R53 W11 (FREY),1909,6,5,5,16
17107515499 *5,TAPON DEPOSITO ANTICONGELANTE ENFRIAMIENTO MOTOR MINI R50 R52 R53 W10 W11 (FEBI) SSF,1202,4,5,9,18
17107515499-2,TAPON DE DEPOSITO DE ANTICONGELANTE MINI R53 / W11 ( URO,1672,1,7,0,8
17107515499-3,TAPON DE DEPOSITO DE ANTICONGELANTE MINI R53 - W11 ( EMBLER ),1458,7,5,8,20
17107524912,SOPORTE DE RADIADOR DMW E81 E87 E90 (GENUINO),1395,5,3,6,14
17107544668 *1 ,RADIADOR ENFRIAMIENTO MOTOR BMW E53 M54 M62 (FREY),1390,5,7,6,18
17107558267,TERMOSTATO DE TRANSMISION AUTOMATICA BMW E70-N52 BMTR,1914,3,7,7,17
17107558267 *1,TERMOSTATO DE TRANSMISION AUTOMATICA BMW E70-N52 FREY,1957,3,6,1,10
17107559966,TERMOSTATO DE TRANSMISION BMW E53 MOTOR M62 N62 VAICO,1760,0,6,8,14
17107559966 *1,TERMOSTATO DE TRANSMISION BMW E53 MOTOR M62 N62 FREY,1287,1,3,7,11
17111178412,SOPORTE INFERIOR DE GOMA DE RADIADOR BMW E46 / TM ( MTC ),1374,7,4,4,15
17111178412 *1,SOPORTE INFERIOR DE GOMA DE RADIADOR BMW E46 / TM FREY,1742,5,4,3,12
17111436060 *1,RADIADOR ENFRIAMIENTO MOTOR BMW E38 M52 E39 M52 M54 M62 (FREY),1689,1,1,5,7
17111436250 *1,PLACA MONTAJE DEPOSITO ANTICONGELANTE BMW E46 M54 TRANSMISION STANDAR (FREY),1442,9,7,5,21
17111436251 *1,PLACA MONTAJE DEPOSITO ANTICANGELANTE MOTOR BMW AUTOMATICO E46 M54 E85 M54 E86 M54 (FREY),1660,2,1,8,11
17111436251 *2,PLACA MONTAJE DEPOSITO ANTICONGELANTE MOTOR BMW AUTOMATICO E46 M54 E85 M54 E86 M54 (EMBLER) GOG,1977,3,7,0,10
17111436251-1,PLACA DE MONTAJE AUTOMATICO BMW E46 ( URO ),1235,8,7,8,23
17111436251-100,PLACA DE MONTAJE AUTOMATICO BMW E46 KZR GERMANY INACTIVO,1770,3,1,5,9
17111436259 *1,TOLVA ASPAS VENTILADOR RADIADOR ENFRIAMIENTO MOTOR BMW E46 M54 (FREY),1836,4,1,1,6
17111436259 *5,TOLVA VENTILADOR RADIADOR ENFRIAMIENTO MOTOR BMW E46 M54 (URO) SSF,1644,2,5,3,10
17111436259-100,TOLVA DE RADIADOR BMW E46 / M54 INACTIVO,1343,0,5,1,6
17111436381,DEPOSITO DE ANTICONGELANTE BMW E39,1375,8,7,1,16
17111436381 *1,DEPOSITO DE ANTICONGELANTE BMW E39-M54 FREY,1990,2,3,1,6
17111437362 *1,TERMOSTATO TRANSMISION AUTOMATICA BMW E46 E53 E83 M54 (FREY),1368,1,2,9,12
17111437362-2,TERMOSTATO DE TRANSMISION AUTOMATICA BMW E46-M54 TOPRAN,1351,5,5,7,17
17111437362-3,TERMOSTATO DE TRANSMISION AUTOMATICA BMW E46-M54 OSSCA,1417,3,9,5,17
17111438819 *1,PLACA MONTAJE DEPOSITO ANTICONGELANTE BMW E53 M54 (FREY),1883,5,3,7,15
17111438819 -6,PLACA DE MONTAJE DE DEPOSITO DE ANTICONGELANTE BMW E53 / M54 ( FEBI ),1870,9,5,2,16
17111438819-3,PLACA MONTAJE DEPOSITO ANTICONGELANTE BMW E53 M54 EMBLER,1635,0,8,0,8
17111438820,"TUBO CONEXIï¿½N """"T""""  DEL DEPOSITO DE ANTICONGELANTE BMW E53 BMTR",1301,4,0,8,12
17111438820 *1,TUBO CONEXIï¿½N T DEPOSITO ANTICONGELANTE BMW E53 (FREY),1921,1,7,3,11
17111438820 -6,TUBO CONEXIï¿½N T DEPOSITO ANTICONGELANTE BMW E53 (FEBI),1727,6,2,9,17
17111438820-2,"TUBO CONEXIï¿½N """"T""""  DEL DEPOSITO DE ANTICONGELANTE BMW E53 OSSCA",1734,3,7,8,18
17111439108,TOLVA DE RADIADOR BMW E53 / M54 ( GENUINA ) SSF,1999,3,5,5,13
17111439108 *1,TOLVA RADIADOR ENFRIAMIENTO MOTOR BMW E53 M54 (FREY),1961,6,5,5,16
17111707817,TUBO Y GRIEGA DE PLACA DE MONTAJE BMW E46 URO,1388,9,8,5,22
17111707817 *1,TUBO Y GRIEGA PLACA DE MONTAJE BMW E46 M54 (FREY),1510,5,6,0,11
17111707817 -6,TUBO Y GRIEGA DE PLACA DE MONTAJE BMW E46 ( FEBI ),1473,7,5,7,19
17111707817-6,TUBO Y GRIEGA DE PLACA DE MONTAJE BMW E46 OSSCA,1653,1,7,7,15
17111712788 *1,TAPON PURGADOR ANTICONGELANTE BMW E46 E46 E53 E81 E83 E84 E89 E90 (FREY),1201,8,2,6,16
17111712788 *5,TAPON PURGADOR DE ANTICONGELANTE BMW E46-M54 FEBI,1663,3,0,1,4
17111712788-100,TAPON PURGADOR DE ANTICONGELANTE BMW MOTOR M50-M54 INACTIVO,1409,1,2,0,3
17111712835,DEPOSITO DE ANTICONGELANTE BMW Z3-M44 BMTR,1683,1,5,8,14
17111712835 *1,DEPOSITO DE ANTICONGELANTE BMW Z3-M44 FREY,1649,2,0,6,8
17111712911,SOPORTE SUPERIOR DE MOTOR ( RECTANGULAR ) BMW E90 / N55 ( URO ),1948,4,3,3,10
17111712911 *1,SOPORTE SUPERIOR DE MOTOR ( RECTANGULAR ) BMW E90 / N55 FREY,1530,3,8,1,12
17111723031,TOLVA DE RADIADOR BMW E36 / M52 ( GENUINA ),1600,8,2,6,16
17111723031 *1,TOLVA DE RADIADOR BMW E36 / M52 FREY,1535,0,3,0,3
17111723337,SOPORTE DE MONTAJE DE RADIADOR INFERIOR ( R ) BMW E36 Z3 / M42 ( GENUINO ),1679,0,5,6,11
17111723337 *1,SOPORTE DE MONTAJE DE RADIADOR INFERIOR ( R ) BMW E36 Z3 / M42 FREY,1652,7,7,4,18
17111723339,SOPORTE DE MONTAJE DE RADIADOR INFERIOR ( L ) BMW E36 Z3 / M44 ( GENUINO ),1947,3,8,7,18
17111723339 *1,SOPORTE DE MONTAJE DE RADIADOR INFERIOR ( L ) BMW E36 Z3 / M44 FREY,1526,8,0,2,10
17111723341,SOPORTE DE MONTAJE SUPERIOR DE RADIADOR BMW E36 / Z3 ( VAICO ),1358,4,6,1,11
17111723341 *1,SOPORTE DE MONTAJE SUPERIOR DE RADIADOR BMW E36 / Z3 FREY,1938,0,6,2,8
17111723520,DEPOSITO DE ANTICONGELANTE BMW E36-M52 BMTR,1410,8,6,4,18
17111723520 *1,DEPOSITO DE ANTICONGELANTE BMW E36-M52 FREY,1303,0,7,6,13
17111723520-1,DEPOSITO DE ANTICONGELANTE BMW E36-M52 FEBI,1281,9,6,4,19
17111723520-3,DEPOSITO DE ANTICONGELANTE BMW E36-M52 URO,1271,1,3,3,7
17111723521,MANGUERA DE VENTILACION DE DEPOSITO DE ANTICONGELANTE BMW E36 BMTR,1337,6,0,9,15
17111723521 *1,MANGUERA DE VENTILACION DE DEPOSITO DE ANTICONGELANTE BMW E36 FREY,1475,2,7,5,14
17111728905,RADIADOR/CON DEPOSITO DE ANTICONGELANTE INTEGRADO BMW MOTOR M43-M44 BMTR,1426,6,3,0,9
17111728905 *1,RADIADOR/CON DEPOSITO DE ANTICONGELANTE INTEGRADO BMW MOTOR M43-M44 FREY,1404,1,7,3,11
17111728905-2,RADIADOR/CON DEPOSITO DE ANTICONGELANTE INTEGRADO BMW MOTOR M43-M44 REACH,1622,6,5,9,20
17111740699,RADIADOR DE MOTOR BMW E39-M52 BMTRS ALEMAN,1778,9,3,3,15
17111740699 *1,RADIADOR DE MOTOR BMW E39-M52 (FREY),1963,6,7,4,17
17111741167 *1,DEPOSITO DE ANTICONGELANTE BMW E39-M62 FREY,1945,7,8,6,21
17111741167-100,DEPOSITO DE ANTICONGELANTE BMW E39-M62 INACTIVO,1923,2,6,1,9
17112248409 *1,TUBO DRENADO DEPOSITO ANTICONGELANTE BMW E83 M54 (FREY),1387,4,2,8,14
17112248409 *3,TUBO DRENADO ANTICONGELANTE BMW M47 M47N M54 M57 M57N N52 N52N (EMBLER),1710,9,5,6,20
17112248409 *5,TUBO DRENADO DEPOSITO ANTICONGELANTE BMW E83 M54 (VAICO) SSF,1421,7,4,5,16
17112248409-100,TUBO DE DEPOSITO DE ANTICONGELANTE BMW E83-M54 INACTIVO,1306,9,0,9,18
17112751276 *1,RADIADOR ENFRIAMIENTO MOTOR MINI R55 R56 R57 R58 R59 R60 R61 (FREY),1606,0,1,3,4
17113400013,RADIADOR DE MOTOR BMW E83-M54 BMTR,1964,5,9,1,15
17113400013 *1,RADIADOR ENFRIAMIENTO MOTOR BMW E83 M54 (FREY),1579,7,6,3,16
17113400017 *1,PLACA MONTAJE DEPOSITO ANTICONGELANTE BMW E83 M54 TRANSMISION AUTOMATICA (FREY),1315,5,3,8,16
17113400018,PLACA DE MONTAJE BMW E83,1654,1,2,0,3
17113400018 *1,PLACA DE MONTAJE BMW E83 FREY,1742,6,5,7,18
17113415693 *1,RADIADOR ENFRIAMIENTO MOTOR BMW E83 N52N AUTOMATICA (FREY),1369,5,1,4,10
17113438717,TERMOSTATO CILINDRICO DEL DEPOSITO X3 E83 MAHLE,1426,9,6,1,16
17113442089 *2,MOTOVENTILADOR 600W ENFRIAMIENTO MOTOR BMW E83 (EMBLER),1405,0,2,0,2
17113452509 *1,MOTOVENTILADOR ENFRIAMIENTO MOTOR 400W BMW E83 M54 (FREY),1557,3,5,5,13
17113452509-1,MOTOVENTILADOR DE 400 W BMW E83-M54 SIEMENS,1762,5,3,5,13
17113452509-2,MOTOVENTILADOR SEMINUEVO 400 W BMW E83 - M54 ( SIEMENS ),1963,4,8,5,17
17117507972,RADIADOR DE MOTOR BMW E60 / N62 ( BMTR ),1509,4,8,8,20
17117507972 *1,RADIADOR DE MOTOR BMW E60-N62 FREY,1815,8,1,2,11
17117519209 *1,RADIADOR DE MOTOR BMW E60 CON MOTOR M54-N52-N52N-N53-N62-N62N FREY,1778,3,7,6,16
17117519209-100,RADIADOR DE MOTOR BMW E60 CON MOTOR M54-N52-N52N-N53-N62-N62N BMTR INACTIVO,1653,4,4,8,16
17117521781,TAPON DE DRENADO DE RADIADOR BMW E90-E84 AFTERMARKET,1284,2,7,6,15
17117521781 *1,TAPON DE DRENADO DE RADIADOR BMW E90-E84 FREY,1755,8,1,4,13
17117524710,MANGUERA INFERIOR DE RADIADOR/ENFRIADOR SEMINUEVA BMW E90 GENUINA,1776,1,1,7,9
17117524710 *1,MANGUERA INFERIOR DE RADIADOR/ENFRIADOR BMW E90 FREY,1661,8,2,1,11
17117533472,RADIADOR DE MOTOR BMW E70 / N55 ( BMTR ),1837,8,2,5,15
17117533472 *1,RADIADOR DE MOTOR BMW E70-N55 FREY,1463,7,6,7,20
17117534907,PLACA DE MONTAJE BMW E60-N52N REIN,1766,6,7,8,21
17117534907 *1,PLACA MONTAJE DEPOSITO ANTICONGELANTE BMW E60 E63 E65 M54 N52 N62N (FREY),1843,4,7,0,11
17117534914 *1,RADIADOR ENFRIAMIENTO MOTOR BMW  E60 E61 E63 (FREY),1339,6,6,5,17
17117534915,RADIADOR DE MOTOR BMW E60 / N52 ( BMTR ),1930,2,8,5,15
17117534915 *1,RADIADOR DE MOTOR BMW E60 / N52 FREY,1906,7,8,4,19
17117535099 *1,RADIADOR DE MOTOR MINI R55 R56 R57 R58 R59 R60 R61 (FREY),1928,0,7,1,8
17117541092 *5,MOTOVENTILADOR ENFRIAMIENTO MOTOR 300 WATTS MINI R50 R52 R53 W10 W11 (TYC) SSF,1379,4,0,8,12
17117541143,MANGUERA DE AGUA DE RADIADOR A ENFRIADOR DE ACEITE BMW E90-N54 GENUINA,1264,1,7,3,11
17117541143 *1,MANGUERA DE AGUA DE RADIADOR A ENFRIADOR DE ACEITE BMW E90-N54 FREY,1575,9,8,5,22
17117545783,TAPON DE DRENADO DE RADIADOR BMW E83,1786,7,7,5,19
17117545783 *1,TAPON DE DRENADO DE RADIADOR BMW E83 FREY,1965,0,9,2,11
17117547059 *1,RADIADOR MOTOR TRANSMISION AUTOMATICA BMW E90 N54 TURBO (FREY),1759,6,3,0,9
17117547059-2,RADIADOR DE MOTOR AUTOMATICO BMW E90-N54 TFC,1684,3,7,3,13
17117547059-3,RADIADOR DE MOTOR AUTOMATICO BMW E90-N54 SINCERE,1549,0,1,8,9
17117553111-100,RADIADOR DE MOTOR BMW E87-N46 INACTIVO,1827,1,4,9,14
17117558480,RADIADOR DE MOTOR BMW E90 / N54 STANDAR ( FREY ),1666,0,5,0,5
17117559273 *1,RADIADOR ENFRIAMIENTO MOTOR BMW E87 N46 N46N (FREY),1825,4,5,0,9
17117561757 *1,MOTOVENTILADOR 390 WATTS ENFRIAMIENTO MOTOR BMW E46 M54 (FREY),1857,1,6,9,16
17117562079 *1,RADIADOR ENFRIAMIENTO MOTOR TRANSMISION AUTOMATICA BMW E90 N52N (FREY),1266,7,5,8,20
17117562586 *1,RADIADOR BMW F18 F10 F11 F01 F02 F03 F04 FREY,1695,0,9,8,17
17117570489 *5,RADIADOR AGUA ENFRIAMIENO MOTOR MINI COOPER R52 R53 W11 (NISSENS),1450,6,9,4,19
17117573781,DEPOSITO DE ANTICONGELANTE BMW E46-M54 BEHR,1947,9,0,1,10
17117573781-1,DEPOSITO DE ANTICONGELANTE BMW E46-M54 BMTR,1619,6,6,2,14
17117585036 *1,RADIADOR ENFRIAMIENTO MOTOR BMW E70 N52N N62N (FREY),1518,1,2,2,5
17117590699 *1,MOTOVENTILADOR ENFRIAMIENTO MOTOR 400W BMW E90 N52N (FREY),1736,9,0,3,12
17117593842 *1,RADIADOR ENFRIAMIENTO MOTOR BMW F25 N52N (FREY),1764,3,7,1,11
17117593855 *1,TUBO REFRIGERANTE BMW N20 FREY,1765,2,3,7,12
17117600511 *2,RADIADOR ENFRIAMIENTO MOTOR BMW F20-F23 F30-F36 (EMBLER),1266,8,0,3,11
17117600516 *1,RADIADOR MOTOR BMW F20 F21 F30 F35 (FREY),1989,8,8,9,25
17117600516 *3,RADIADOR ENFRIAMIENTO MOTOR BMW F20-F23 F30-F34 F36 (HIGH QUALITY),1812,2,0,5,7
17117603745 *1,RADIADOR ENFRIAMIENTO MOTOR BMW F01 F10 N52N (FREY),1579,0,2,2,4
17117612954-100,RADIADOR ENFRIAMIENTO MOTOR BMW F10 F11 F07 N52N (INACTIVO),1218,6,4,1,11
17117617636 *1,RADIADOR ENFRIAMIENTO MOTOR BMW F39 B42 F46 B38 48 F48 B42 B48 F54 B46 B48 F57 B46 B48 F60 B48 (FREY),1753,8,4,3,15
171176390-100,TAPON DE DEPOSITO DE ANTICONGELANTE 140 INACTIVO,1665,5,0,5,10
17117639020 *1,TAPON DEPOSITO ANTICONGELANTE ENFRIAMIENTO MOTOR 140 BARES BMW N52 N52N (FREY),1271,6,8,1,15
17117639021 *1,TAPON DEPOSITO ANTICONGELANTE ENFRIAMIENTO MOTOR 200 BARES BMW N52 N52N (FREY),1500,8,9,9,26
17117639021 *5,TAPON DEPOSITO DE ANTICONGELANTE 200 BMW E90 N52N (URO),1781,8,9,1,18
17117639021-1,TAPON DE DEPOSITO DE ANTICONGELANTE 200 BMW E90-N52 ORIGINAL,1907,0,6,1,7
17117639021-2,TAPON DE DEPOSITO DE ANTICONGELANTE 200 BMW E90-N52 FEBI,1838,0,3,6,9
17117639021-4,TAPON DE DEPOSITO DE ANTICONGELANTE 200 BMW E90-N52 MEINSTERZATS,1703,1,2,9,12
17117639022 *1,TAPON DEPOSITO ANTICONGELANTE 2.0 BARES BMW M54 (FREY),1575,4,2,4,10
17117639022 *5,TAPON DEPOSITO ANTICONGELANTE ENFRIAMIENTO MOTOR 2.0 BARES BMW E46 (MALHE BEHR) SSF,1904,3,5,8,16
17117639022-100,TAPON DE DEPOSITO DE ANTICONGELANTE BMW MOTOR M54 INACTIVO,1356,0,7,8,15
17117639024 *1,TAPON DEPOSITO ANTICONGELANTE ENFRIAMIENTO BMW SERIE F Y G MINI SERIE R Y F (FREY),1235,3,7,4,14
17117639024 *5,TAPON DEPOSITO ANTICONGELANTE ENFRIAMIENTO MOTOR BMW SERIE F BMW SERIE G  (FEBI) SSF,1255,6,2,8,16
17117639024-1,TAPON DE DEPOSITO DE ANTICONGELANTE MINI R56 ( CALORSTAT ),1611,0,2,5,7
17117639024-2,TAPON DE DEPOSITO DE ANTICONGELANTE CHICO BMW F30 - N20 ( TOPRAN ),1366,5,8,3,16
17117639024-5,TAPON DE DEPOSITO DE ANTICONGELANTE MINI MOTOR B48-B38 VERNET,1934,0,9,6,15
17117690 *100,TAPON DE DEPOSITO DE ANTICONGELANTE 140 BAJA,1959,5,8,3,16
17117823568,RADIADOR DE MOTOR BMW MOTOR N20-N55 HISSENS,1375,9,5,3,17
17117823568 *1,RADIADOR ENFRIMIENTO MOTOR BMW F25 F26 N20 N55 AUTOMATICA (FREY),1353,0,0,4,4
17118482622 *1,RADIADOR ENFRIAMIENTO MOTOR BMW B58 B46 B48 (FREY),1797,8,8,4,20
17118484638 *1,RADIADOR ENFRIAMIENTO MOTOR BMW G11 G12 G14 G15 G16 G30 G31 G32 (FREY),1640,1,9,2,12
17118625426 *1,RADIADOR ENFRIAMIENTO MOTOR BMW F20-F23 F30-F36 (FREY),1302,2,1,8,11
17118645782 *1,RADIADOR ENFRIAMIENTO MOTOR BMW F39 F48 F52 MINI F60 (FREY),1365,5,7,5,17
17118645782 *5,RADIADOR ENFRIAMIENTO MOTOR BMW F39 F40 F44-F46 F488 MINI F60 (MAHLE) SSF,1438,9,5,0,14
17118654431 *1,RADIADOR ENFRIAMIENTO MOTOR BMW  F15 F16 (FREY),1667,7,6,9,22
17118672012 *1,RADIADOR ENFRIAMIENTO MOTOR BMW F07 F10  (FREY),1547,8,5,2,15
17118672104 *1,RADIADOR ENFRIAMIENTO MOTOR BMW  F20 F30 (FREY),1592,5,5,3,13
17118686026 *1,RADIADOR ENFRIAMIENTO MOTOR BMW G30 B46 B48 B58 G11 B48 B58 (FREY),1466,4,8,9,21
17119071518 *1,RADIADOR ENFRIAMIENTO MOTOR TRANSMISION AUTOMATICA BMW E46 M54 (FREY),1921,3,0,4,7
17122754203 *5,MANGUERA SUPERIOR DE RADIADOR MINI R56-N12 (REIN) SSF,1946,3,8,7,18
17122754220 *5,MANGUERA PRINCIPAL TERMOSTATO ENFRIAMIENTO MOTOR MINI R55 A R59 N14 N18 (VAICO) SSF,1782,0,2,2,4
17122754221,MANGUERA DE AGUA SUPERIOR/TERMOSTATO MINI R56-N14 REIN,1243,3,1,5,9
17122754247 *1,MANGUERA INFERIOR RADIADOR ENFRIAMIENTO MOTOR MINI R56 N12 (FREY),1666,6,4,1,11
17122754247 *2,MANGUERA INFERIOR RADIADOR MINI R56 N12 (EMBLER),1883,8,3,9,20
17122754247 *5,MANGUERA INFERIOR DE RADIADOR MINI R56-N12 ( REIN) SSF,1773,2,3,4,9
17122754247-3,MANGUERA INFERIOR DE RADIADOR MINI R56-N12 MEISTERSATZ,1967,7,2,3,12
17123413819,MANGUERA INFERIOR DE RADIADOR BMW E83 M54 DORMAN ALEMAN,1806,4,8,0,12
17123413819 *1,MANGUERA INFERIOR DE RADIADOR BMW E83 M54 FREY,1809,6,0,6,12
17123415433 *1,MANGUERA SUPERIOR RADIADOR (FORMA ï¿½Tï¿½) BMW E83 N52N (FREY),1751,5,3,4,12
17123415433-2,"MANGUERA SUPERIOR DE RADIADOR BMW E83 (FORMA""""T"""") FEBI",1215,7,4,6,17
17123415433-4,"MANGUERA SUPERIOR DE RADIADOR BMW E83 (FORMA """"T"""") EMBLER",1340,5,5,5,15
17123422785,MANGUERA DE AGUA FLEXIBLE DE CALEFACCION BMW E83-N52N MEISTESATZ,1749,3,9,8,20
17123422785 *1,MANGUERA DE AGUA FLEXIBLE DE CALEFACCION BMW E83-N52N FREY,1946,3,7,5,15
17123424499,MANGUERA INFERIOR DE RADIADOR BMW E83 GENUINA,1506,1,1,0,2
17123424499 *1,MANGUERA INFERIOR DE RADIADOR BMW E83 FREY,1469,9,1,1,11
17123424499-5,MANGUERA INFERIOR DE RADIADOR BMW E83 BMTR,1599,7,0,0,7
17127508010,MANGUERA SUPERIOR DE RADIADOR / BOMBA DE AGUA BMW E65-N62 GENUINA,1811,4,7,4,15
17127508010 *1,MANGUERA SUPERIOR DE RADIADOR / BOMBA DE AGUA BMW E65-N62 FREY,1248,4,2,2,8
17127508010-2,MANGUERA SUPERIOR DE RADIADOR / BOMBA DE AGUA BMW E65-N62 MEISTERSATZ,1926,1,5,9,15
17127508011,MANGUERA INFERIOR DE RADIADOR BMW E60-N62 BMTR,1924,0,6,6,12
17127508011 *1,MANGUERA INFERIOR DE RADIADOR BMW E60-N62 FREY,1624,7,8,0,15
17127508012,MANGUERA DE VENTILACION DE DEPOSITO DE ANTICONGELANTE BMW E66 BMTR,1716,4,7,8,19
17127508012 *1,MANGUERA DE VENTILACION DE DEPOSITO DE ANTICONGELANTE BMW E66 FREY,1721,2,3,6,11
17127508013,MANGUERA SUPERIOR DE DEPOSITO DE ANTICONGELANTE BMW E65 BMTR,1829,7,2,9,18
17127508013 *1,MANGUERA SUPERIOR DE DEPOSITO DE ANTICONGELANTE BMW E65 FREY,1848,4,1,5,10
17127508014,MANGERA DE RADIADOR BMW  E65 FREY,1894,9,7,5,21
17127508015,MANGUERA DE RADIADOR E65 N62 FREY,1724,2,2,1,5
17127509963 *1,MANGUERA SUPERIOR RADIADOR ENFRIAMIENTO MOTOR BMW E53 N62 (FREY),1674,5,9,3,17
17127509966,MANGUERA AGUA DE ENFRIADOR ANTICONGELANTE BMW MOTOR N62 DORMAN ALEMAN,1757,9,6,6,21
17127509967 *1,MANGUERA RADIADOR ENFRIAMIENTO  MOTOR BMW E53 (FREY),1633,1,4,1,6
17127510952 *1,MANGUERA SUPERIOR RADIADOR ENFRIAMIENTO MOTOR BMW E46 M54 (FREY),1427,7,2,9,18
17127510952 *2,MANGUERA SUPERIOR RADIADOR BMW MOTOR M52 M54 (EMBLER) GOG,1973,2,1,4,7
17127514404,MANGUERA SUPERIOR DE RADIADOR BMW E85 Z4 - M54 MEISTERSATZ,1511,4,2,4,10
17127514404 *1,MANGUERA SUPERIOR DE RADIADOR BMW E85 Z4 - M54 FREY,1908,5,3,8,16
17127514405,MANGUERA INFERIOR DE RADIADOR BMW E85-M54 VAICO,1918,3,8,8,19
17127514405 *1,MANGUERA INFERIOR DE RADIADOR BMW E85-M54 FREY,1204,4,2,1,7
17127515487 *1,TUBO AGUA ENFRIAMIENTO MOTOR CODO CON PURGADOR MINI R50 W10 (FREY),1871,7,9,7,23
17127515494 *5,TOMA AGUA ENFRIAMIENTO MOTOR 4 VIAS CON PURGADOR MINI W10 (URO) SSF,1540,0,5,9,14
17127515500 *5,MANGUERA SUPERIOR RADIADOR ENFRIAMIENTO MOTOR (R) 156MM LARGO MINI R52 R53 W11 (REIN) SSF,1329,7,2,0,9
17127515501 *5,MANGUERA SUPERIOR RADIADOR ENFRIAMIENTO MOTOR (L) 385MM LARGO MINI R52 R53 W11 (URO) SSF,1655,6,7,4,17
17127515502 *1,COPLE CON PURGADOR MANGUERA SUPERIOR RADIADOR MINI R52 R53 W11 (FREY),1892,0,1,7,8
17127515502 *5,COPLE CON PURGADOR MANGUERA SUPERIOR RADIADOR MINI R52 R53 W11 (FEBI) SSF,1853,7,4,4,15
17127519248,MANGUERA SUPERIOR DE RADIADOR/BOMBA DE AGUA BMW E60-N62 AFTERMARKET,1339,8,0,0,8
17127519248 *1,MANGUERA SUPERIOR RADIADOR A BOMBA DE AGUA BMW E60 N62 (FREY),1621,1,3,0,4
17127519248-2,MANGUERA SUPERIOR DE RADIADOR/BOMBA DE AGUA BMW E60-N62 (OSSCA),1743,4,8,2,14
17127519255,MANGUERA DE AGUA SUPERIOR RADIADOR/TERMOSTATO BMW E60-M54 BMTR,1929,6,4,9,19
17127519255 *1,MANGUERA SUPERIOR RADIADOR ENFRIAMIENTO MOTOR BMW E60 E61 M54 (FREY),1359,0,6,0,6
17127519257 *1,MANGUERA INFERIOR RADIADOR ENFRIAMIENTO MOTOR E60 E65 M54 (FREY),1686,2,5,5,12
17127519259 *1,MANGUERA INFERIOR DEPOSITO ANTICONGELANTE BMW E60 E61 M54 (FREY),1896,1,5,6,12
17127521775,MANGUERA DE VENTILACION DEPOSITO DE ANTICONGELANTE BMW E60 BMTR,1314,1,1,6,8
17127521775 *1,MANGUERA DE VENTILACION DEPOSITO DE ANTICONGELANTE BMW E60 FREY,1307,7,1,3,11
17127521777,MANGUERA SUPERIOR DE RADIADOR BMW E60-N52 REIN,1273,8,2,2,12
17127521777 *1,MANGUERA SUPERIOR RADIADOR ENFRIAMIENTO MOTOR BMW E60 N52 (FREY),1938,8,4,5,17
17127521778,MANGUERA INFERIOR DE RADIADOR BMW E60-N52 FEBI,1351,6,0,3,9
17127521778 *1,MANGUERA INFERIOR DE RADIADOR BMW E60-N52 FREY,1280,3,0,6,9
17127525022,MANGUERA INFERIOR DE RADIADOR BMW E87 N46N BMTR,1221,7,6,3,16
17127525022 *1,MANGUERA INFERIOR DE RADIADOR BMW E87 N46N (FREY),1454,6,2,1,9
17127525022-2,MANGUERA INFERIOR DE RADIADOR BMW E87 N46N KZR,1257,0,2,3,5
17127525023 *1,MANGUERA AGUA SUPERIOR RADIADOR BMW E87 N46N (FREY),1697,8,0,7,15
17127525023-1,MANGUERA SUPERIOR DE RADIADOR BMW E87 N46N ( VAICO ),1330,3,1,3,7
17127525023-3,MANGUERA SUPERIOR DE RADIADOR BMW E87 N46N ( FEBI ),1769,6,1,8,15
17127525023-4,MANGUERA SUPERIOR DE RADIADOR BMW E87 N46N ( OSSCA ),1957,2,3,5,10
17127526856,MANGUERA SUPERIOR DE RADIADOR BMW E53-N62 HORTUM,1664,0,2,8,10
17127526856 *1,MANGUERA SUPERIOR DE RADIADOR BMW E53-N62 FREY,1666,2,3,5,10
17127526856-1,MANGUERA SUPERIOR DE RADIADOR BMW E53-N62 MEINSTERSATZ,1596,5,4,4,13
17127531579 *1,MANGUERA SUPERIOR RADIADOR BMW E90 N52 N52N (FREY),1574,5,6,9,20
17127531579 *2,MANGUERA SUPERIOR RADIADOR BMW E90 N52 N52N (EMBLER),1619,1,9,0,10
17127531579-1,MANGUERA SUPERIOR DE RADIADOR BMW E90-N52 FEBI,1607,7,1,4,12
17127531581,MANGUERA INFERIOR DE RADIADOR BMW E90-N52 BMTR,1236,2,2,4,8
17127531581 *1,MANGUERA INFERIOR RADIADOR ENFRIAMIENTO MOTOR BMW E81 E90 N52 (FREY),1558,3,1,6,10
17127531581-1,MANGUERA INFERIOR DE RADIADOR BMW E90-N52 REIN,1624,5,0,7,12
17127532063,MANGUERA DE ENFRIADOR ACEITE TRANSMISION BMW E87 EMBLER,1647,8,4,6,18
17127532063 *1,MANGUERA DE ENFRIADOR ACEITE TRANSMISION BMW E87 FREY,1890,8,4,6,18
17127534918 *2,MANGUERA SUPERIOR RADIADOR (L) ENFRIAMIENTO MOTOR BMW E60 E61 E63 E64 (EMBLER),1715,9,9,0,18
17127535529 *5,MANGUERA SUPERIOR RADIADOR ENFRIAMIENTO MOTOR BMW G01 G02 B46 B48 (REIN) SSF,1792,6,2,1,9
17127535536 *1,MANGUERA ENFRIAMIENTO MOTOR BMW G01 G02 (FREY),1563,7,9,7,23
17127536230,MANGUERA SUPERIOR DE RADIADOR BMW E70-N62N CRP,1920,1,3,4,8
17127536230 *1,MANGUERA SUPERIOR DE RADIADOR BMW E70-N62N FREY,1605,1,4,6,11
17127536230-1,MANGUERA SUPERIOR DE RADIADOR BMW E70-N62N VAICO,1589,5,0,5,10
17127536231 *1,MANGUERA DE RADIADOR BMW E70 FREY,1312,1,2,5,8
17127536232 *1,MANGUERA INFERIOR DEPOSITO ANTICONGELANTE MOTOR BMW E70 N62N 4.8L (FREY),1980,7,1,2,10
17127536235,MANGUERA DE RADIADOR/DEPOSITO BMW E70-N62N BMTR,1339,9,3,5,17
17127536235 *1,MANGUERA DE RADIADOR/DEPOSITO BMW E70-N62N FREY,1601,5,4,1,10
17127537101,MANGUERA DE RADIADOR BMW E70 (FREY),1673,7,3,4,14
17127537101 *2,MANGUERA DE RADIADOR BMW E70 (EMBLER),1763,8,3,0,11
17127537108,MANGUERA INFERIOR DE RADIADOR BMW E70 MOTOR N52N BMTR,1438,2,4,4,10
17127537108 *1,MANGUERA INFERIOR DE RADIADOR BMW E70 MOTOR N52N FREY,1500,1,6,9,16
17127537109 *1,MANGUERA DISTRIBUCION AGUA ENFRIAMIENTO MOTOR BMW E70 N52N (FREY),1814,3,2,6,11
17127540020,MANGUERA DE AGUA RADIADOR BMW E90-N52 VAICO,1554,7,0,5,12
17127540020 *1,MANGUERA AUXILIAR INFERIOR RADIADOR ENFRIAMIENTO MOTOR BMW E90 N52N (FREY),1420,9,5,2,16
17127540127 *1,MANGUERA SUPERIOR DE RADIADOR BMW E90 N54 (FREY),1318,4,0,9,13
17127540127-1,MANGUERA SUPERIOR DE RADIADOR BMW E90-N54 TOPRAN,1526,6,3,9,18
17127540127-2,MANGUERA SUPERIOR DE RADIADOR BMW E90-N54 ( FEBI ),1296,0,9,3,12
17127542540,MANGUERA DE VENTILACION BMW E60-N62 EMBLER,1671,8,6,5,19
17127545653,MANGUERA DE RADIADOR/DEPOSITO BMW MOTOR N62-N62N OSSCA,1268,0,0,3,3
17127546064,MANGUERA SUPERIOR DE RADIADOR BMW E60-N52 FEBI,1679,1,7,0,8
17127546064 *1,MANGUERA SUPERIOR DE RADIADOR BMW E60 N52N (FREY),1524,6,7,5,18
17127546064-2,MANGUERA SUPERIOR DE RADIADOR BMW E60-N52 OSSCA,1914,9,2,8,19
17127546064-4,MANGUERA SUPERIOR DE RADIADOR BMW E60-N52 MEISTERSATZ,1458,0,4,4,8
17127548222 *1,MANGUERA DISTRIBUCION 5 SALIDAS AGUA MOTOR BMW E87 N46 N46N (FREY),1945,9,3,4,16
17127548223 *1,MANGUERA DISTRIBUCION 3 SALIDAS AGUA MOTOR BMW E87 E90 N52 N52N (FREY),1598,8,6,0,14
17127548224 *1,MANGUERA DISTRIBUCION 4 SALIDAS AGUA MOTOR BMW E87 E90 N52 N52N (FREY),1345,1,7,1,9
17127548224 *2,MANGUERA DISTRIBUCION 4 SALIDAS AGUA MOTOR BMW E87 E90 N52 N52N (EMBLER),1815,3,9,8,20
17127548230 *1,MANGUERA DISTRIBUCION 3 SALIDAS AGUA MOTOR BMW E82 E88 E90 E92 N54 (FREY),1621,3,9,5,17
17127548242 *1,MANGUERA DISTRIBUCION ANTICONGELANTE ENFRIAMIENTO MOTOR BMW E87 N46 (FREY),1740,1,1,3,5
171275508011,MANGUERA INFERIOR DE RADIADOR,1500,3,4,8,15
17127561686 *1,MANGUERA CALEFACCION A MANGUERA DISTRIBUCION BMW E70 N52N (FREY),1977,4,9,1,14
17127564478 *1,MANGUERA INFERIOR RADIADOR ENFRIAMIENTO MOTOR BMW E81 E84 E89 E90 N52N (FREY),1291,9,0,4,13
17127564478-100,MANGUERA INFERIOR DE RADIADOR SEMINUEVA BMW E90-N52N INACTIVO,1482,2,3,5,10
17127564478-101,MANGUERA INFERIOR DE RADIADOR BMW E90-N52N INACTIVO,1544,0,7,1,8
17127564480,MANGUERA INFERIOR DE RADIADOR BMW E90-N54 FEBI,1481,1,3,7,11
17127564480 *1,MANGUERA INFERIOR DE RADIADOR BMW E90-N54 FREY,1564,5,5,2,12
17127565091,MANGUERA DE VENTILACION DEPOSITO ANTICONGELANTE BMW E87 N46N ( BMTR ),1719,4,5,8,17
17127565091 *1,MANGUERA DE VENTILACION DEPOSITO ANTICONGELANTE BMW E87 N46N ( FREY ),1423,3,1,0,4
17127565092 *1,MANGUERA DE VENTILACION DEPOSITO ANTICONGELANTE BMW E87 N46N (FREY),1261,0,6,2,8
17127565094 *1,MANGUERA VENTILACION DEPOSITO ANTICONGELANTE BMW E88 N54 E90 N54 E84 N20 (FREY),1594,3,1,0,4
17127565780,MANGUERA INFERIOR DE RADIADOR BMW E60-N52N,1588,7,1,7,15
17127565780 *1,MANGUERA INFERIOR DE RADIADOR BMW E60-N52N FREY,1921,7,3,0,10
17127568754,MANGUERA DE AGUA RADIADOR BMW E60 BMTR,1385,7,5,2,14
17127568754 *1,MANGUERA DE AGUA RADIADOR BMW E60 FREY,1969,6,7,0,13
17127576358,MANGUERA INFERIOR DE RADIADOR BMW F15 VAICO,1707,1,3,4,8
17127576358 *1,MANGUERA INFERIOR DE RADIADOR BMW F15 FREY,1710,1,8,7,16
17127576368 *1,MANGUERA ENFRIADOR ACEITE TRANSMISION (L) BMW E79 E71 F15 F16 N20 N54 N55 (FREY),1394,9,9,8,26
17127578398,MANGUERA DE RADIADOR BMW N52 FREY,1382,2,8,7,17
17127578399,MANGUERA DE RADIADOR BMW F10 N52N (OSSCA),1210,5,7,6,18
17127578399 *1,MANGUERA DE RADIADOR BMW F10 N52N (FREY),1477,2,8,3,13
17127578403 *1,MANGUERA DE REFRIGERANTE PARA BMW N52N (FREY),1647,8,7,1,16
17127578404,MANGUERA DE RADIADOR BMW N52N FREY,1471,5,7,8,20
17127578405,MANGUERA DE VENTILACION DE DEPOSITO DE ANTICONGELANTE BMW F10 BMTR,1239,4,1,7,12
17127578405 *1,MANGUERA DE VENTILACION DE DEPOSITO DE ANTICONGELANTE BMW F10 FREY,1778,4,2,7,13
17127578703,MANGUERA INFERIOR DE RADIADOR BMW E70 MOTOR N55 GENUINA,1382,2,9,8,19
17127578703 *1,MANGUERA INFERIOR DE RADIADOR BMW E70-N55 FREY,1497,4,6,7,17
17127580957,MANGUERA DE RADIADOR BMW F10 ORIGINAL,1854,7,4,6,17
17127580957 *1,MANGUERA DE RADIADOR BMW F10 FREY,1888,2,5,5,12
17127580957-3,MANGUERA DE RADIADOR BMW F10,1882,4,8,6,18
17127582924,MANGUERA SUPERIOR DE RADIADOR FREY,1899,6,9,0,15
17127586774 *1,MANGUERA SUPERIOR RADIADOR BMW N55 (FREY),1222,3,0,3,6
17127592651 *1,MANGUERA DE REFRIGERANTE PARA BMW N52N N63N (FREY),1792,9,5,4,18
17127593490 *1,MANGUERA SUPERIOR DE RADIADOR BMW E70 MOTOR N52N (FREY),1702,8,9,0,17
17127596831 *1,TUBO REFRIGERANTE N20 (FREY),1637,6,4,7,17
17127596831 *2,TUBO REFRIGERANTE N20 (EMBLER),1711,8,1,2,11
17127596832 *1,MANGUERA SUPERIOR DE RADIADOR BMW N13 F20 FREY,1904,1,1,9,11
17127596832-2,MANGUERA SUPERIOR DE RADIADOR BMW N13 F20 EMBLER,1814,0,2,7,9
17127596834 *2,MANGUERA DE RADIADRO BMW F20 F21 F30 F31 (EMBLER),1632,7,7,3,17
17127596837 *1,MANGUERA DE RADIADOR SUPERIOR BMW F30 N20 (FREY),1721,4,7,3,14
17127596837 *2,MANGUERA DE RADIADOR SUPERIOR BMW F30 N20 (EMBLER),1965,3,2,8,13
17127596837 -6,MANGUERA DE RADIADOR,1233,8,4,8,20
17127599450 *1,MANGUERA INFERIOR RADIADOR ENFRIAMIENTO MOTOR BMW E84 E88 E90 N55 (FREY),1983,1,4,3,8
17127599452 *1,MANGUERA VENTILACION RADIADOR DEPOSITO ANTICONGELANTE BMW E84 E90 N55 (FREY),1233,0,2,9,11
17127600554 *1,TUBO REFRIGERANTE N20 FREY,1805,5,4,6,15
17127617363 *1,MANGUERA INFERIOR RADIADOR BMW F45 F48 B48 MINI F56 B38 (FREY),1843,1,1,4,6
17127617366 *1,MANGUERA DE RADIADOR BMW F45 F46 F48 F39 MINI F56 F55 F54 F57 F60 (FREY),1537,3,1,1,5
17127617373 *1 ,MANGUERA AGUA ENFRIADOR ACEITE TRANSMISION F39 F45 F46 F56 B38 B38 B46 B48 (FREY),1584,0,7,1,8
17127617377 *1,MANGUERA AGUA ENFRIAMIENTIO MOTOR BMW B48 F52 F48 F49 F55 F56 F54 F57 F60 (FREY),1967,9,1,7,17
17127618510,MANGUERA DE VENTILACION DE DEPOSITO DE ANTICONGELANTE BMW E90-N52 BMTR,1934,9,9,0,18
17127618510 *1,MANGUERA DE VENTILACION DE DEPOSITO DE ANTICONGELANTE BMW E90-N52 FREY,1217,4,3,9,16
17127618510-2,MANGUERA DE VENTILACION DE DEPOSITO DE ANTICONGELANTE BMW E90-N52 EMBLER,1927,2,9,8,19
17127619684 *1,MANGUERA SUPERIOR RADIADOR BMW F07 F10 F11 (FREY),1715,1,3,1,5
17127624676 *1,TUBO DE REFRIGERANTE BMW N52N FREY,1558,9,7,8,24
17127639213 *1,MANGUERA SUPERIOR RADIADOR ENFRIAMIENTO MOTOR F25 F26 N20 (FREY),1792,8,9,5,22
17127640287 *1 ,MANGUERA AGUA ENFRIADOR ACEITE MOTOR BMW F20 F30 F32 G30 G11 B38 B46 B48 (FREY),1891,7,8,0,15
17127640917 *2,MANGUERA INFERIOR RADIADOR ENFRIAMIENTO MOTOR BMW F07 F10 F11 (EMBLER),1215,6,1,4,11
17127644094 *1,Radiador Manguera De Lï¿½nea Intercambiador FREY,1218,9,4,5,18
17127646150 *1,MANGUERA SUPERIOR RADIADOR ENFRIAMIENTO MOTOR BMW F25 N52N N55 F26 N55 (FREY),1492,5,1,3,9
17127646150 *2,MANGUERA SUPERIOR RADIADOR ENFRIAMIENTO MOTOR BMW F25 N52N N55 F26 N55 EMBLER,1568,6,7,0,13
17127646155 *1,MANGUERA SUPERIOR RADIADOR ENFRIAMIENTO MOTOR BMW F25 F26 N20 (FREY),1695,0,0,1,1
17127646157 *1,MANGUERA DE RADIADOR N20 FREY,1950,0,9,7,16
17127646158 *1,TUBO REFIGERANTE N20 X3 FREY,1424,1,8,9,18
17127799184 *1,TAPON PLUG UNIVERSAL SISTEMA ENFRIAMIENTO MOTOR BMW B38 B46 B48 (FREY),1475,8,0,2,10
17128570061,MANGUERA DE VENTILACION DEPOSITO ANTICONGELANTE BMW F21 N55 OSSCA,1424,5,9,3,17
17128602027 *1 ,MANGUERA SUPERIOR RADIADOR (L) ENFRIAMIENTO MOTOR BMW F20 F22 F30 F32 B38 (FREY),1934,6,5,2,13
17128602599 *2,MANGUERA DE RADIADOR BMW G11 G12 G30 G31 G32 (EMBLER),1386,1,7,3,11
17128602870 *1 ,MANGUERA SUPERIOR RADIADOR (L) ENFRIAMIENTO MOTOR BMW G30 G32 G11 B46 B48 (FREY),1772,7,3,1,11
17128602871 *1,MANGUERA DE RADIADOR BMW G11 G12 G30-G32 (FREY),1801,7,4,8,19
17128616528 *1,MANGUERA DE RADIADOR A MOTOR BMW F20-F23 F30-F36 B46 B48 (FREY),1770,9,8,4,21
17128616914 *2,MANGUERA INFERIOR RADIADOR ENFRIAMIENTO MOTOR BMW F20-F23 F30-F34 F36 (EMBLER),1758,1,3,6,10
17128651298,TUBO FLEXIBLE DE VENTILACION BMW F25-F26 GENUINO,1524,3,7,0,10
17128651298 *1,TUBO FLEXIBLE DE VENTILACION BMW F25-F26 FREY,1350,7,2,9,18
17128662836 *1,Manguera Radiador Termostato superior FREY,1578,0,3,2,5
17128740118 *1,MANGUERA DEPOSITO ANTICONGELANTE CABEZA MOTOR BMW F20 F30 B48 (FREY),1881,2,0,5,7
1713200073 *1,BASE COMPLETA AMORTIGUADOR DELANTERO (L/R) MERCEDES R171 (FREY),1292,7,4,0,11
1713201030 *1,AMORTIGUADOR SUSPENSION DELANTERA (L/R) MERCEDES R171 (FREY),1211,9,7,7,23
1713230017 *1,TORNILLO BARRA ESTABILIZADORA SUSPENSION DELANTERA (L/R) MERCEDES R171 (FREY),1274,5,3,3,11
1713230017 *3,TORNILLO BARRA ESTABILIZADORA SUSPENSION DELANTERA (L/R) MERCEDES R171 (METRIX),1291,8,2,3,13
1713261100 *1,AMORTIGUADOR TRASERO ( L-R )  MERCEDES BENZ M271 FREY,1983,8,5,1,14
17137501959,DEPOSITO DE ANTICONGELANTE BMW MOTOR N62 BEHR 376755211,1966,3,1,3,7
17137501959 *1,DEPOSITO DE ANTICONGELANTE BMW MOTOR N62 FREY,1784,7,8,8,23
17137501959-1,DEPOSITO DE ANTICONGELANTE BMW MOTOR N62 BMTR,1738,6,3,9,18
17137524812,SENSOR DE NIVEL ANTICONGELANTE KZR,1402,6,8,9,23
17137524812 *1,SENSOR DE NIVEL DE ANTICONGELANTE BMW E46 FREY,1734,4,0,6,10
17137524812-1K,SENSOR DE NIVEL ANTICONGELANTE OSSCA,1305,5,0,9,14
17137529273,DEPOSITO DE ANTICONGELANTE MINI R53-W11 BEHR,1747,7,0,0,7
17137529273 *1,DEPOSITO ANTICONGELANTE ENFRIAMIENTO MINI R53 W11 SUPER CARGADO (FREY),1468,2,5,0,7
17137529273-1,DEPOSITO DE ANTICONGELANTE MINI R53-W11 REIN,1524,3,4,7,14
17137529273-2,DEPOSITO DE ANTICONGELANTE MINI R53-W11 HELLA,1654,0,1,9,10
17137529273-4,DEPOSITO DE ANTICONGELANTE MINI R53-W11 EMBLER,1440,9,8,4,21
17137542986,DEPOSITO DE ANTICONGELANTE BMW E60 BEHR,1235,9,3,6,18
17137542986 *1,DEPOSITO ANTICONGELANTE ENFRIAMIENTO MOTOR BMW E60 E63 M54 N52 N62 N62N (FREY),1521,6,9,3,18
17137542986-1,DEPOSITO DE ANTICONGELANTE BMW E60 BMTR,1677,4,4,5,13
17137542986-3,DEPOSITO DE ANTICONGELANTE BMW E60 HELLA,1424,6,0,4,10
17137542986-4,DEPOSITO DE ANTICONGELANTE BMW E60 (EMBLER),1923,9,8,7,24
17137543003 *1,DEPOSITO DE ANTICONGELANTE BMW E65-N62 FREY,1889,7,8,7,22
17137553919,SENSOR DE NIVEL DE ANTICONGELANTE BMW E46 AFTERMARKET,1661,5,0,4,9
17137553919-2,SENSOR DE NIVEL DE ANTICONGELANTE BMW E46 KZR GERMANY,1910,2,6,2,10
17137567462 *1,DEPOSITO ANTICONGELANTE ENFRIAMIENTO MOTOR BMW E87 E90 N46N N52N N54 (FREY),1589,0,7,8,15
17137567462 *2,DEPOSITO ANTICONGELANTE ENFRIAMIENTO MOTOR BMW E87 E90 N46N N52N N54 (EMBLER) GOG,1797,5,9,4,18
17137601948 *1,TANQUE DE EXPANSION BMW N52 N54 N63 (FREY),1280,1,7,9,17
17137601950 *1,DEPOSITO ANTICONGELANTE ENFRIAMIENTO MOTOR BMW F10 N52N (FREY),1679,7,6,4,17
17137607482,DEPOSITO DE ANTICONGELANTE BMW E87 E90 N52N-N46N-N54 OSSCA,1518,9,3,5,17
17137609469-2,DEPOSITO DE ANTICONGELANTE BMW F30-N20 URO,1386,9,8,9,26
17137609469-4,DEPOSITO ANTICONGELANTE BMW F30-N20 (BWMQ),1310,8,2,5,15
17137609469-9,DEPOSITO DE ANTICONGELANTE BMW F30-N20 DORMAN ALEMAN,1494,2,5,0,7
17137617362 *1,DEPOSITO ANTICONGELANTE BMW F45 F46 F48 B38 B48 MINI F56 B38 (FREY),1608,4,3,7,14
17137639 *100,TAPON DEPOSITO ANTICONGELANTE (1.4 BAR)  BAJA,1726,8,3,8,19
17137639023 *1,TAPON DEPOSITO ANTICONGELANTE 1.4 BARES BMW E39 E46 E53 E83 (FREY),1332,5,2,1,8
17137640515,DEPOSITO DE ANTICONGELANTE BMW E90-N55 BMTR,1206,2,1,8,11
17137640515 *1,DEPOSITO ANTICONGELANTE ENFRIAMIENTO MOTOR BMW E84 E88 E90 N55 (FREY),1529,5,1,3,9
17137642158 *1,DEPOSITO ANTICONGELANTE ENFRIAMIENTO MOTOR BMW F20 F30 (FREY),1608,6,7,0,13
17137647281,TANQUE DE EXPANSION BMW E70 FREY,1299,4,1,7,12
17137647283,DEPOSITO DE ANTICONGELANTE BMW F10-N55 FEBI,1438,5,7,5,17
17137647283 *1,DEPOSITO DE ANTICONGELANTE BMW F10-N55 FREY,1315,4,4,8,16
17137647713,DEPOSITO DE ANTICONGELANTE BMW E65-N62,1928,2,2,1,5
17137787039 *1,DEPOSITO ANTICONGELANTE ENFRIAMIENTO MOTOR BMW E46 E53 E83 M54 (FREY),1727,8,7,0,15
17137787039 *K,"KIT DEPOSITO RECUPERADOR, TAPON TERMOSTATO Y SENSOR DE NIVEL ANTICONGELANTE BMW M52 M54",1258,8,1,2,11
17137787039-101,DEPOSITO ANTICONGELANTE BMW E46 E53 E83 M54 INACTIVO,1373,0,4,3,7
17137823544 *1,DEPOSITO ANTICONGELANTE ENFRIAMIENTO MOTOR BMW F25 N20 (FREY),1699,3,3,9,15
17137823626 *1,DEPOSITO ANTICONGELANTE ENFRIAMIENTO MOTOR MINI R56 N16 (FREY),1765,6,1,1,8
17137823626 *2,DEPOSITO DE ANTICONGELANTE BMW i8 MINI R55 AL R61 ( EMBLER ) GOG,1359,7,9,4,20
17137823626 *5,DEPOSITO RECUPERADOR ANTICONGELANTE MOTOR MINI R56 N12 N14 N16 N18 BMW i8 B38 (MAHLE) SSF,1405,9,0,8,17
17138614293 *1,DEPOSITO ANTICONGELANTE MOTOR BMW F07 F10 F11 N20 (FREY),1656,1,0,8,9
17138617045 *1,TANQUE DE EXPANSION F30 F31 F35 (FREY),1919,4,2,7,13
17138621092 *1 ,DEPOSITO ANTICONGELANTE ENFRIAMIENTO MOTOR BMW E70 E71 N20 N52N N55 N62N N63N (FREY),1361,8,9,4,21
17138621092-100,DEPOSITO DE ANTICONGELANTE BMW E70-N52 (EMBLER) INACTIVO,1414,6,5,0,11
17138677649 *1,DEPOSITO ANTICONEGELANTE ENFRIAMIENTO MOTOR BMW F20 F22 F30 F32 B46 B48 B58 (FREY),1623,0,2,6,8
17139485733 *1,DEPOSITO ANTICONGELANTE ENFRIAMIENTO MOTOR BMW G30 G11 G14 (FREY),1748,2,8,5,15
17139846642 *1,DEPOSITO ANTICONGELANTE ENFRIAMIENTO MOTOR BMW G11 G12 G14 G30 G32 B46 B48 B58 (FREY),1987,9,0,4,13
1714000125,EMBLEMA CENTRO DE RIN 74 MM MERCEDES BENZ,1394,6,1,1,8
1714700990 *1,FILTRO REGULADOR GASOLINA MERCEDES W221 (FREY),1556,2,8,8,18
1715000049 *1,DEPOSITO ANTICONGELANTE ENFRIAMIENTO MOTOR MERCEDES R171 (FREY),1873,4,0,1,5
1715400117,SENSOR DE FRENOS ABS TRASERO MERCEDES ( L ) R171 / TM ( ATE ),1833,5,4,8,17
1715400117 *1,SENSOR DE FRENOS ABS TRASERO MERCEDES ( L ) R171 / TM FREY,1395,9,6,3,18
1715400217,SENSOR DE FRENOS ABS TRASERO MERCEDES ( R ) R171 / TM ( ATE ),1729,5,0,3,8
1715400217 *1,SENSOR DE FRENOS ABS TRASERO MERCEDES ( R ) R171 / TM FREY,1793,9,5,1,15
1715400617 *1,SENSOR BALATAS FRENOS DELANTERO TRASERO C209 W463 W166 W221 C216 MERCEDES (FREY),1875,0,0,0,0
1717500036 *2,AMORTIGUADOR CAJUELA 560 NEWTONS 280 MM (L/R) MERCEDES W171 (EMBLER),1551,8,6,0,14
17176390-100,TAPON DE DEPOSITO DE ANTICONGELANTE 200 INACTIVO,1205,0,7,2,9
1718300418,FILTRO POLEN AIRE CABINA TOPRAN,1315,6,5,4,15
1718300418 *3,FILTRO POLEN AIRE CABINA MERCEDES R171 (MAHLE LAK246),1877,4,8,4,16
1718800129 *1,AMORTIGUADOR COFRE FUERZA 300 NEWTONS 674 MM (L) MERCEDES BENZ R171 FREY,1894,3,1,1,5
17207500754 *1,ENFRIADOR ACEITE TRANSMISION AUTOMATICA BMW E53 M54 M62 (FREY),1822,9,8,5,22
1720750754-100,ENFRIADOR DE ACEITE DE TRANSMISION AUTO INACTIVO,1433,5,6,2,13
17211437772 *1,TERMOSTATO DE TRANSMISION AUTOMATICA E39-M62 FREY TO1186,1439,0,9,6,15
17211437772 *3,TERMOSTATO DE TRANSMISION AUTOMATICA E39-M62 (MAHLE TO1186) DGO,1506,3,3,9,15
17211437772-3,TERMOSTATO DE TRANSMISION AUTOMATICA E39-M62 BMTR,1494,6,3,7,16
17217505823,ENFRIADOR DE ACEITE DE TRANSMISION AUTOMATICA BMW E39-M62 TAIFA,1983,2,2,8,12
17217505823 *1,ENFRIADOR DE ACEITE DE TRANSMISION AUTOMATICA BMW E39-M62 FREY,1601,2,1,6,9
17217507974-100,ENFRIADOR DE ACEITE DE MOTOR BMW 525i 530i 545i 645ci BMTRS INACTIVO,1630,3,2,2,7
17217519213 *1,ENFRIADOR ACEITE TRANSMISION AUTOMATICA BMW E60 E63 E64 E65 M54 N52 N52N N62N (FREY),1787,3,0,8,11
17217536929 *1,ENFRIADOR ACEITE TRANSMISION AUTOMATICA BMW E84 E88 E89 E90 N54 N55 (FREY),1375,9,6,3,18
17217541058,ENFRIADOR DE ACEITE BMW E67 FREY,1961,7,9,4,20
17217551647,ENFRIADOR DE ACEITE DE TRANSMISION AUTOMATICA BMW E90-N52 TAIFA,1701,5,9,3,17
17217551647 *1,ENFRIADOR ACEITE TRANSMISION AUTOMATICA BMW E90 N52 (FREY),1246,3,3,0,6
17217553389 *1,ENFRIADOR ACEITE TRANSMISION AUTOMATICA BMW E70 E71 (FREY),1293,5,9,5,19
17217593856 *1,ENFRIADOR DE TRANSMISION AUTOMATICA BMW F25 F26 (FREY),1489,3,1,7,11
17217599546-9,TERMOSTATO DE MOTOR BMW F10 / N55 ( BMTR ),1241,6,0,4,10
17217600553,ENFRIADOR DE ACEITE DE TRANSMISION AUTOMATICA BMW F30 GENUINO,1476,7,8,6,21
17217600553 *1,ENFRIADOR ACEITE TRANSMISION AUTOMATICA BMW F20 F22 F30 F32 (FREY),1464,5,0,4,9
17217600553-2,ENFRIADOR DE ACEITE DE TRANSMISION AUTOMATICA BMW F30 GENUINO SEMINUEVO,1876,1,9,0,10
17217638678 *1,ENFRIADOR ACEITE TRANSMISION AUTOMATICA BMW F01 F06 F10 N54 N55 N63 (FREY),1328,7,2,2,11
17217638681,TERMOSTATO DE TRANSMISION AUTOMATICA BMW F10-N55 BMTR,1248,2,6,0,8
17217638681 *1,TERMOSTATO DE MOTOR BMW F10 / N55 FREY,1376,4,5,8,17
17217803830,ENFRIADOR DE ACEITE DE TRANSMISION AUTOMATICA BMW MOTOR N62 TAIFA,1800,0,4,3,7
17218514515 *2,ENFRIADOR ACEITE MOTOR BMW F20-F26 F30-F36 G01 G02 G05 G11 G12 G20 G21 G30-G32 (EMBLER),1776,1,7,5,13
17227505826 *1,ENFRIADOR ACEITE TRANSMISION AUTOMATICA BMW E46 E83 E85 (FREY),1548,6,1,1,8
17227505826 *2,ENFRIADOR DE ACEITE DE TRANSMISION AUTOMATICA  BMW E46 OSSCA,1799,4,8,3,15
1723200630 *2,AMORTIGUADOR SUSPENSION DELANTERA (L/R) MERCEDES SLK200 SLK350 (VERMO),1901,5,1,6,12
1723230117,TORNILLO ESTABILIZADOR SUSPENSION DELANTERA (L) MERCEDES R172 (SIDEM),1528,7,7,9,23
1723230217,TORNILLO ESTABILIZADOR SUSPENSION DELANTERA (R) MERCEDES R172 (SIDEM),1994,0,1,9,10
1725400617 *1,SENSOR FRENOS ABS TRASERO (L) MERCEDES R172 (FREY),1675,3,1,9,13
1725400717 *1,SENSOR FRENOS ABS TRASERO (R ) MERCEDES R172 (FREY),1918,0,5,5,10
1729056101 *1,SENSOR FRENOS ABS DELANTERO (L/R) MERCEDES R172 (FREY),1823,5,1,0,6
1729060200 *1,ACTUADOR FRENO ESTACIONAMIENTO ( R ) MERCEDES R172 R231  (FREY),1505,7,4,6,17
1729060300 *1,ACTUADOR FRENO ESTACIONAMIENTO (L) MERCEDES R172 R231  ( FREY ),1822,5,7,0,12
1729800064 *1,AMORTIGUADOR COFRE FUERZA 255 NEWTONS 674 MM (L/R) MERCEDES BENZ R172 FREY,1490,4,5,3,12
1729800464 *1,AMORTIGUADOR CAJUELA 400 NEWTONS 408 MM (L/R) MERCEDES BENZ R172 FREY,1310,6,8,9,23
17417504732,ASPAS DE VENTILADOR MECANICO BMW E53-M62 ORIGINAL BMW,1786,3,4,1,8
17417504732 *1,ASPAS DE VENTILADOR MECANICO BMW E53-M62 FREY,1606,3,4,3,10
17417505109,FAN CLUTCH DE 4 TORNILLOS BMW E53-M62 BMTR,1603,9,6,7,22
17417505109 *1,FAN CLUTCH DE 4 TORNILLOS BMW E53-M62 FREY,1381,4,8,1,13
17418642160 *1,MOTOVENTILADOR ENFRIAMIENTO MOTOR 400W BMW F07 F10 F11 (FREY),1750,7,9,0,16
17422752632 *5,MOTOVENTILADOR ENFRIAMIENTO MOTOR MINI R55 R56 R57 R58 R59 (ACM) SSF,1913,4,2,1,7
17422754854 *5,MOTOVENTILADOR MOTOR 187W MINI R55 A R61 N12 N14 N16 N18 (MAHLE) SSF,1641,9,6,0,15
17427523259-1,MOTOVENTILADOR NUEVO DE 400W  BMW E90-N52N TOPAZ,1226,8,5,3,16
17427526824,MARCO VENTILADOR BMW E60 SEMINUEVO (ORIGINAL),1245,9,7,9,25
17427540681 *1,MOTOVENILADOR ENFRIAMIENTO MOTOR 400W BMW E60 N52N (FREY),1542,6,3,0,9
17427543282 *1,MOTOVENTILADOR ENFRIAMIENTO MOTOR 600W BMW E60 E61 E64 E65 E66 (FREY),1248,7,0,3,10
17427545366,MOTOVENTILADOR DE 600 W BMW E92-N52N SEMINUEVO,1438,6,6,9,21
17427545366 *1,MOTOVENTILADOR ENFRIAMIENTO MOTOR 600W BMW N52N (FREY),1276,4,5,4,13
17427560877 *1,MOTOVENTILADOR 600 WATTS ENFRIAMIENTO MOTOR BMW F25 F26 N20 N55 (FREY),1440,8,0,6,14
17427562080 *1,MOTOVENTILADOR ENFRIAMIENTO MOTOR 600W BMW E90 N52N (FREY),1680,5,8,7,20
17427562080-100,MOTOVENTILADOR NUEVO DE 600W BMW E90 - N52N ( BMTR ) INACTIVO,1257,9,8,3,20
17427563259 *1,MOTOVENTILADOR ELECTRICO NUEVO DE 400W BMW E87-N46 FREY,1698,3,5,4,12
17427563259-2,MOTOVENTILADOR ELECTRICO BMW E90-N52N BMTSR,1235,6,7,3,16
17427601176 *1,MOTOVENTILADOR 400 WATTS ENFRIAMIENTO MOTOR BMW F25 F26 N20 (FREY),1522,5,2,4,11
17427601176 *2,MOTOVENTILADOR USADO 400W BMW F25 F26 (GENUINO),1911,2,3,7,12
17427617609 *1,MOTOVENTILADOR 400W ENFRIAMIENTO BMW MINI F39 F48 F56 B36 B38 B42 B46 B48 (FREY),1506,2,5,2,9
17427634466 *1,MOTOVENTILADOR 400 WATTS ENFRIAMIENTO MOTOR BMW F15 F16 N20 N55 (FREY),1625,7,7,3,17
17427634466 *M,MOTOVENTILADOR 400 WATTS ENFRIAMIENTO MOTOR BMW F15 F16 N20 N55 (EMBLER) TECH,1755,3,7,0,10
17427634472 *1,MOTOVENTILADOR ENFRIAMIENTON MOTOR BMW F15 F16 (FREY),1506,3,9,7,19
17427640509 *1,MOTOVENTILADOR ENFRIAMIENTO MOTOR 400W BMW F20 F22 F30 F32 N13 N20,1531,7,9,1,17
17428487636 *M,MOTOVENTILADOR 400 WATTS ENFRIAMIENTO MOTOR BMW X3 G01 (EMBLER) TECH,1418,0,7,6,13
17428509743,MOTOVENTILADOR DE 850W BMW F10-N63 GENUINO,1352,0,5,0,5
17428509743 *1,MOTOVENTILADOR DE 850W BMW F10-N63 FREY,1527,4,4,4,12
17428618239 *1,MOTOVENTILADOR 400 WATTS ENFRIAMIENTO MOTOR BMW E70 E71 N55 (FREY),1278,0,2,4,6
17428618240 *1,MOTOVENTILADOR ENFRIAMIENTO MOTOR 600 W BMW E70 N52N M62N (FREY),1500,5,5,6,16
17428618241 *1,MOTOVENTILADOR ENFRIAMIENTO MOTOR 600 WATTS BMW E71 N54 (FREY),1311,3,7,2,12
17428625440 *1,MOTOVENTILADOR ENFRIAMIENTO MOTOR BMW F20  B38 F30 B48 B58 F32 B46 B48 F58 (FREY),1998,7,6,9,22
17428641964 *1 ,MOTOVENTILADOR ENFRIAMIENTO MOTOR 600W BMW F20 F22 F30 F32 B38 N13 N20 N26 N55 (FREY),1562,7,1,6,14
17517617598 *1,RADIADOR ENFRIAMIENTO MOTOR BMW F39 F40 F44-F46 F48 MINI F54-F57 F60 (FREY),1725,4,0,2,6
1763234300 *6,AMORTIGUADOR SUSPENSION DELANTERA (L) MERCEDES W176 W246 (BILSTEIN) SSF,1248,5,7,7,19
1763234300-100,AMORTIGUADOR AIRE SUSPENSION DELANTERA (L) MERCEDES W176 W246 (EMBLER) CYS INACTIVO,1371,1,0,5,6
1763234400 *5,AMORTIGUADOR SUSPENSION DELANTERA (R) MERCEDES W176 W246 (SACHS) SSF,1771,3,5,1,9
1763234400 *6,AMORTIGUADOR SUSPENSION DELANTERA (R) MERCEDES W176 W246 (BILSTEIN) SSF,1594,1,1,1,3
1768200545 *1,LIMPIAPARABRISAS MERCEDEZ BENZ FREY,1303,0,9,3,12
1769001204 *2,BALASTRA MODULO ELECTRONICO LUZ XENON MERCEDES W176 C117 (EMBLER) MLL,1210,4,2,7,13
1769800264 *1,AMORTIGUADOR CAJUELA 390 NEWTONS 527 MM (L/R) MERCEDES W176 (FREY),1330,2,7,6,15
1770940004 *1,KIT 2 PZ. FILTRO ENTRADA AIRE MOTOR (L/R) MERCEDES MOTOR M177 4.0L (FREY),1940,6,2,2,10
1770940004 *5,FILTRO ENTRADA AIRE MOTOR (L/R) MERCEDES MOTOR M177 4.0L (VAICO) SSF,1651,3,3,3,9
1770940004 *6,FILTRO ENTRADA AIRE MOTOR (L/R) MERCEDES MOTOR M177 4.0L (FEBI) SSF,1573,1,6,2,9
1772400900 *1,SOPORTE INFERIOR CENTRAL MOTOR  MERCEDES C118 W177 W247 (FREY),1965,8,0,2,10
1772406500 *1,SOPORTE TRANSMISION AUTOMATICA (L) MERCEDES H247 W177 X247 (FREY),1537,9,4,3,16
1773230100 *1,AMORTIGUADOR AIRE SUSPENSION DELANTERA (L) MERCEDES W117 (FREY),1894,0,4,7,11
1773230100 *5,AMORTIGUADOR AIRE SUSPENSION DELANTERA (L) MERCEDES W117 (GENUINO),1418,9,3,1,13
1773230100 *6,AMORTIGUADOR AIRE SUSPENSION DELANTERA (L) MERCEDES W117 (BILSTEIN) SSF,1282,1,5,2,8
1773230100 *A,AMORTIGUADOR AIRE SUSPENSION DELANTERA (L) MERCEDES W117 (EMBLER) TECH,1750,7,5,6,18
1773230200 *A,AMORTIGUADOR AIRE SUSPENSION DELANTERA (R) MERCEDES W117 (EMBLER) TECH,1955,1,6,7,14
1802209,FILTRO ACEITE MOTOR MERCEDES W203-W163 MANN HU7185X,1320,5,3,4,12
1810750234-100,JUNTA DE TUBO DE ESCAPE BMW MOTOR M54 6CIL INACTIVO,1543,9,3,6,18
18107502346 *1,JUNTA DE TUBO DE ESCAPE BMW MOTOR M54 6CIL FREY,1828,1,0,7,8
18107502346-2,JUNTA DE TUBO DE ESCAPE BMW MOTOR M54 6CIL EMBLER,1802,6,3,8,17
18107549447 *1,JUNTA PLANA TUBO ESCAPE GASES MOTOR 49.5 MM BMW N52 N52N (FREY),1482,0,6,2,8
18111170941 *5,JUNTA ESCAPE MOTOR MINI R50 R53 R52 (ELRING) SSF,1863,2,4,2,8
18207503246,SOPORTE DE GOMA DE SILENCIADOR DE ESCAPE BMW E46-M54 MEISTERSATZ,1380,1,6,0,7
18207503246 *1,SOPORTE DE GOMA DE SILENCIADOR DE ESCAPE BMW E46-M54 FREY,1473,9,3,0,12
18207590154,SOPORTE DE GOMA DE SILENCIADOR DE ESCAPE BMW E90-N52 GENUINO,1241,0,1,8,9
18207590154 *1,SOPORTE DE GOMA DE SILENCIADOR DE ESCAPE BMW E90-N52 FREY,1669,8,3,3,14
18211745426,SOPORTE DE GOMA DE SILENCIADOR DE ESCAPE DELANTERO BMW E46 / M54 ( FEBI ),1478,8,7,4,19
18211745426 *1,SOPORTE DE GOMA DE SILENCIADOR DE ESCAPE DELANTERO BMW E46 / M54 FREY,1945,7,1,1,9
18301440183,EMPAQUE DE ESCAPE BMW E46 E39 (EMBLER),1213,0,5,3,8
18307540797 *1,JUNTA DE ESCAPE DE MOTOR BMW E87-N46 FREY,1313,2,6,4,12
18307540797-100,JUNTA DE ESCAPE DE MOTOR BMW E87-N46 BMTR INACTIVO,1214,0,8,0,8
18307553595,COPIA DE CATALIZADOR SEMINUEVO BMW E90-N54 ORIGINAL 335,1705,1,6,1,8
18307553595 *1,COPIA DE CATALIZADOR SEMINUEVO BMW E90-N54 FREY 335,1372,1,5,2,8
18307553601,JUNTA DE ESCAPE DEL TURBOCARGADOR BMW E90-N54 ELRING,1904,5,3,5,13
18307553601 *1,JUNTA DE ESCAPE DEL TURBOCARGADOR BMW E90-N54 FREY,1748,7,3,2,12
18307553603,JUNTA DE TUBO DE ESCAPE DE MOTOR BMW E92-N54 BI TURBO ELRING,1800,6,7,2,15
18307553603 *1,JUNTA TUBO ESCAPE MOTOR BMW N54 BI TURBO (FREY),1831,1,7,8,16
18307574127 ,EMPAQUE DEL TURBO COMPRESOR R56  (MEISTERSATZ),1399,2,5,0,7
18307581970 *1,JUNTA GASES ESCAPE CATALIZADOR (L/R) BMW N20 N26 N54 N55 B36 B38 B42 B46 B48 (FREY),1412,6,5,9,20
18407518679,CATALIZADOR ( 1 ) DE GASES DE ESCAPE BMW E53-M54,1214,3,4,8,15
18407518679 *1,CATALIZADOR ( 1 ) DE GASES DE ESCAPE BMW E53-M54 FREY,1657,4,8,6,18
18407518680,CATALIZADOR ( 2 ) DE GASES DE ESCAPE BMW E53-M54,1271,4,0,0,4
18407518680 *1,CATALIZADOR ( 2 ) DE GASES DE ESCAPE BMW E53-M54 FREY,1393,0,2,7,9
18407527796,JUNTA DE MULTIPLE DE ADMISION BMW MOTOR N46N-N46 4CIL-6CIL 2.0L ELRING,1772,9,2,6,17
18407527796 *1,JUNTA DE MULTIPLE DE ESCAPE BMW MOTOR N46N-N46 4CIL-6CIL 2.0L FREY,1379,7,6,9,22
18407530606,JUNTA DE MULTIPLE DE ESCAPE 52 MM BMW E90-N52N VICTOR REINZ,1677,0,8,7,15
18407530606 *1,JUNTA MULTIPLE ESCAPE MEDIDA 52 MM BMW N52 N52N (FREY),1285,3,0,4,7
18407563111,JUNTA DE MULTIPLE DE ESCAPE MINI R56 ELRING,1307,0,3,7,10
185459932,RESISTENCIA DE AIRE ACONDICIONADO MERCEDES W202-M111 GENUINA,1977,4,6,4,14
189970447,SELLO DE BOMBA DE TRANSMISION MERCEDES W204 ( CORTECO ),1434,0,2,2,4
19-171609 *5,AMORTIGUADOR SUSPENSION TRASERA (L/R) AUDI A4 A5 Q5ï¿½(BILSTEIN)ï¿½SSF,1975,6,9,4,19
1903632136,GIGABYTE GB-BRI3H-8130 SIN ACCESORIOS,1466,4,4,4,12
191906383C *1,RELEVADOR 167 CON 4 PINES BOMBA GASOLINA AUDI VW SEAT (FEBI) SSF,1585,1,3,2,6
191959481 A 95 *5,TERMO SWICH BULBO TEMPERATURA AUDI VW (WALER),1276,0,0,6,6
19353945 *A,AMORTIGUADOR CON SENSOR SUSPENSION DELANTERA (L/R) ESCALADE SUBURBAN 2007 A 2014 (EMBLER) TECH,1227,2,5,3,10
19727V001,FILTRO ACEITE MOTOR SMART FORTWO MANN HU68X,1429,3,2,2,7
19727v001-1,FILTRO ACEITE MOTOR SMART ROADSTER VALEO,1609,7,6,7,20
19730023371,FLECHA DELANTERA IZQUIERDA VOLVO S40 ( GENUINA ),1555,1,5,3,9
19937896,BANDA W176 CONTINENTAL 6PK2315,1771,8,7,6,21
1E0698451-100,BALATAS FRENOS TRASEROS AUDI A4 PAGID T5075 INACTIVO,1730,3,5,3,11
1H0837581D,MANIJA DE CRISTAL VOLKSWAGEN (EMBLER),1896,7,9,9,25
1J0121403B,DEPOSITO DE ANTICONGELANTE AUDI A3 1.8L GENERICO,1780,2,3,3,8
1J0121403B-1,DEPOSITO DE ANTICONGELANTE AUDI A3 1.8L BORSEHUNG,1841,8,5,6,19
1J0122291D,TOMA DE AGUA AUDI TT / VW JETTA VAICO,1292,6,8,8,22
1J0129620,FILTRO ENTRADA AIRE MOTOR AUDI A3 1.8L MANN C37153,1348,3,0,3,6
1J0129620 *3,FILTRO ENTRADA AIRE MOTOR AUDI A3 1.8L (MAHLE LX1835),1399,0,3,6,9
1J0129620 *5,FILTRO ENTRADA AIRE MOTOR 184 X 364 AUDI VW (BOSCH) SSF,1753,7,5,5,17
1J0129684AD *1,MANGUERA ENTRADA AIRE MOTOR AUDI VW 1.8T 20 VALVULAS (EMBLER) GOG,1202,9,5,6,20
1J0199262,SOPORTE DE MOTOR VW 2.5L AUDI A3 CORTECO,1309,0,0,2,2
1J0199262B,SOPORTE DE MOTOR VW 2.5L (MEISTERSATZ),1899,8,9,2,19
1J0199555,SOPORTE DE MOTOR VW GOLF JETTA NEW BEETLE CORTECO,1468,4,9,0,13
1J0201511A ,FILTRO COMBUSTIBLE GASOLINA AUDI MANN WK730/1,1588,4,3,7,14
1J0201511A *3,FILTRO COMBUSTIBLE GASOLINA AUDI (MAHLE KL79),1291,5,5,6,16
1J0407181 *5,BUJE HORQUILLA SUSPENSION DELANTERA (L/R) AUDI VW (CORTECO) SSF,1684,2,6,8,16
1J0411314T,BUJE DE BARRA ESTABILIZADIORA JETTA 1J TOPRAN,1922,2,2,0,4
1J0501541C,BUJES DE PUENTE DE SUSPENSION TRASERA JETTA 1J MEYLE,1957,6,0,6,12
1J0521127,GOMA DE CARDAN VW GOLF,1390,7,2,3,12
1J0698151F,BALATAS FRENOS DELANTEROS VW JETTA 2.0 BREMBO P85072N,1531,6,7,3,16
1J0819644A *3,FILTRO ENTRADA AIRE MOTOR CARBON ACTIVO AUDI (MAHLE LAK63),1764,4,0,5,9
1J0907660B *5,SENSOR DE NIVEL DE ACEITE AUDI A4 / 1.8 ( URO ) SSF,1653,6,2,5,13
1J0907660B *6,SENSOR DE NIVEL DE ACEITE AUDI A4 / 1.8 ( HELLA ) SSF,1501,5,3,5,13
1J0907660C,SENSOR DE NIVEL DE ACEITE  VIKA,1321,2,3,1,6
1J0907660F *5,SENSOR DE NIVEL DE ACEITE (VEMO) SSF,1877,3,9,5,17
1J0973724,ARNES DE BOBINA AUDI A4 BMTR,1244,6,5,0,11
1K0121070BD *3,TUBO AGUA CURVO ENFRIAMIENTO MOTOR AUDI VW BEETLE (VIKA),1382,3,6,0,9
1K0121251DM *5,RADIADOR ENFRIAMIENTO MOTOR AUDI A3 TT JETTA EOS GOLF PASSAT (REACH) SSF,1232,0,1,3,4
1K0121407A-1,DEPOSITO DE ANTICONGELANTE AUDI A3 2.0L VIKA,1310,8,3,1,12
1K0121407F *5,DEPOSITO DE ANTICONGELANTE AUDI A3 2.0L (MAHLE) SSF,1817,0,8,5,13
1K0122291BE,TOMA DE AGUA AUDI A3 1.4 TSI AFTERMARKET,1570,9,9,7,25
1K0122291BE *2,TOMA AGUA MANGUERA SUPERIOR RADIADOR AUDI VW (EMBLER) GOG,1220,0,3,2,5
1K0129620,FILTRO ENTRADA AIRE MOTOR AUDI A3 3.2LTS MANN C36188,1337,6,3,4,13
1K0129620E,FILTRO ENTRADA AIRE MOTOR AUDI Q3 2.0L MANN C35154,1399,4,1,1,6
1K0129620G *5,FILTRO ENTRADA AIRE MOTOR 135 X 344 MM AUDI VW SEAT (HENGST) SSF,1604,6,7,3,16
1K019644B-100,FILTRO DE AIRE CABINA CARBON ACTIVO INACTIVO,1511,5,1,2,8
1K0199262,SOPORTE HIDRAULICO MOTOR DERECHO OSSCA,1863,7,8,9,24
1K0199555R *S,SOPORTE TRANSMISION AUTOMATICA (L) AUDI A3 VW (EMBLER) TECH,1837,2,1,8,11
1K0199855,SOPORTE DE MOTOR AUDI A3 SEAT CORTECO,1353,5,0,4,9
1K0199867,SOPORTE DE MOTOR AUDI A3 Q3 VW BORA CORTECO,1880,4,4,1,9
1K0199868,SOPORTE DE MOTOR AUDI A3 Q3 CORTECO,1512,9,4,4,17
1K0201051B,FILTRO COMBUSTIBLE GASOLINA AUDI A3 MANN WK69/1,1971,3,7,6,16
1K0201051K *3,FILTRO COMBUSTIBLE GASOLINA AUDI A3 (MAHLE KL572) DGO,1495,0,9,0,9
1K0407182,BUJE DE HORQUILLA DE SUSPENCION DELANTERA VW JETTA MEISTERSATZ,1966,9,0,2,11
1K0407255AA *2,MANGO SUSPENSION DELANTERA (L) AUDI A3 VW SEAT (EMBLER),1740,0,4,4,8
1K0698451 G *5,BALATAS FRENOS TRASEROS 105 X 56 MM AUDI A3 TT GOLF GTI JETTA (FERODO) SSF,1306,3,0,0,3
1K0698451H *8,BALATAS FRENOS DELANTEROS 155 X 71 MM AUDI VW SEAT (AKEBONO EURO) SSF,1399,5,3,4,12
1K0819644A *3,FILTRO POLEN AIRE CABINA CON CARBON ACTIVO AUDI WV SEAT (MAHLE LAK181),1846,4,9,1,14
1K0819644B-100,FILTRO AIRE CABINA AUDI MAHLE LA181 INACTIVO,1477,0,0,0,0
1K0820803N,VALVULA SOLENOIDE DE SISTEMA VALVETRONIC AUDI A3  2.0 L,1630,1,8,7,16
1K0823359A *2,AMORTIGUADOR COFRE FUERZA 250 NEWTONS 730 MM (L/R) JETTA (EMBLER),1348,5,9,9,23
1K0906093H *2,RELEVADOR MODULO CONTROL BOMBA GASOLINA AUDI A3 VW GTI JETTA (EMBLER) GOG,1384,4,9,4,17
1K0906207A,SENSOR DE PRESION ABSOLUTA MULTIPLE MAP AUDI A1 / 1.4 TFSI ( BOSCH ),1765,8,9,0,17
1K0919051DA,BOMBA DE GASOLINA AUDI A3 URO,1657,4,9,7,20
1K0959455ET *2,ASPAS DE MOTOVENTILADOR AUDI TT 2.0 TFSI / AUDI A3 2.0 TFSI (EMBLER) GOG,1474,5,7,9,21
1K0959455ET-2,ASPAS DE MOTOVENTILADOR AUDI TT 2.0 TFSI / AUDI A3 2.0 TFSI ( BEHR ),1560,7,4,4,15
1K0959455FR,MODULO DE MOTOVENTILADOR IZQ. AUDI TT 2.0 TFSI / AUDI A3 2.0 TFSI ( GENERICO ),1991,8,4,4,16
1K0965561G,BOMBA AGUA AUXILIAR ELECTRICA ENFRIAMIENTO MOTOR AUDI A3 2.0 (REIN),1746,5,7,8,20
1K0965561G *5,BOMBA AGUA AUXILIAR ELECTRICA ENFRIAMIENTO MOTOR AUDI A3 2.0 (PIERBURG) SSF,1557,8,4,9,21
1K0965561J,BOMBA AGUA AUXILIAR ELECTRICA ENFRIAMIENTO MOTOR AUDI A3 2.0L (AFTERMARKET),1514,5,3,4,12
1K1971111AJ *3,ARNES DIRECCION ELECTROASISTIDA VW JETTA GLI GOLF GTI MK6 SEAT CUPRA AUDI A3 (GENUINO) HC,1689,7,0,9,16
1K5827550C,AMORTIGUADOR CAJUELA 710 NEWTONS 300 MM (L/R) VW JETTA (EMBLER),1588,6,9,2,17
1L1Z5319AA *C,COMPRESOR AIRE SUSPENSION EXPEDITION LINCOLN NAVIGATOR 1998 A 2006 (EMBLER) TECH,1669,8,5,9,22
1R1300 *SC,SECADOR COMPRESOR AIRE SUSPENSION EXPEDICION TOWN CAR 1 ENTRADA (EMBLER),1235,9,0,4,13
1R4300 *SC,SECADOR COMPRESOR AIRE SUSPENSION EXPEDITION TOWN CAR 1 ENTRADA (EMBLER),1833,8,1,8,17
1R7593 *V,VALVULA SOLENOIDE LINCOLN EXPEDITION TOWN CAR CROWN VICTORIA MERCURY CONTINENTAL MARK VIII (EMBLER),1404,5,0,2,7
1S7E6A642CC,ENFRIADOR DE ACEITE MOTOR JAGUAR MAZDA MONDEO 2000 A 2007 V6 30.L KAIZZER,1649,3,1,2,6
1S7Z-6A642-AA,ENFRIADOR DE ACEITE DE MOTOR MAZDA FORD ESCAPE BMTRS,1812,6,8,8,22
1X439601AA,FILTRO ENTRADA AIRE MOTOR JAGUAR X-TYPE 2.5 LTS MANN C38116,1849,8,0,8,16
1ab,ART DE PRUEBA,1465,6,8,6,20
20034 *5,20 LITROS LIQUIDO TRANSMISION AUTOMATICA TOP TEC ATF6 (LIQUI MOLY) SSF,1452,7,3,3,13
20124 *5 ,20 LITROS ACEITE MOTOR 100% SINTETICO 5W-30 ESPECIAL TEC LL (LIQUI MOLY) SSF,1481,2,4,0,6
2021619,POLEA DE RE ENVIO RAYADA MERCEDES MOTOR M271 3.5L TOPRAN,1476,7,6,0,13
2021719,POLEA DE REENVIO LISA MERCEDES W205 ( INA ),1543,3,3,5,11
2022401617 *1,SOPORTE  MOTOR (L/R) MERCEDES W202 W203  M112 M113 M272 M273 (FREY),1522,6,8,5,19
2023304907,HORQUILLA SUPERIOR (R) W202 DELPHI,1649,7,2,8,17
2023520165,BUJE TRASERO MERCEDES R170 URO,1497,5,6,3,14
2024101115,JUNTA DE GOMA CARDAN DELANTERA MERCEDES W202 FEBI,1912,1,9,8,18
2024101115 *1,JUNTA DE GOMA CARDAN DELANTERA MERCEDES W202 FREY,1948,3,2,3,8
2024101315,JUNTA DE GOMA CARDAN MERCEDES W202 FEBI,1230,2,8,2,12
2024101315 *1,JUNTA DE GOMA CARDAN MERCEDES W202 FREY,1561,2,4,6,12
2024600405 *1,BARRA CENTRAL DIRECCION CON BIELETAS MERCEDES W202 C220 C230 C280 FREY,1382,0,7,4,11
2024600405 *5,BARRA CENTRAL DE DIRECCION CON BIELETAS MERCEDES W202 C220 C230 C280 (FEBI) SSF,1614,9,1,7,17
2024600505 *1,BARRA CENTRAL DIRECCION MERCEDES W202 (FREY),1551,9,2,0,11
2025000649,DEPOSITO DE ANTICONGELANTE MERCEDES W202 C43 AMG C63 AMG C280A FEBI,1358,0,8,2,10
2025000649 *1,DEPOSITO DE ANTICONGELANTE MERCEDES W202 C43 AMG C63 AMG C280A FREY,1766,5,7,2,14
2025000649-1,DEPOSITO DE ANTICONGELANTE MERCEDES W202 C43 AMG C63 AMG C280A URO,1322,7,9,4,20
2025005203,RADIADOR DE MOTOR MERCEDES W202-M111 FREY,1668,9,9,8,26
2025014382,MANGUERA INFERIOR DE RADIADOR MERCEDES W202-M111 REIN,1900,3,1,3,7
2025014382 *1,MANGUERA INFERIOR DE RADIADOR MERCEDES W202-M111 FREY,1272,6,4,1,11
20320013-100,AMORTIGUADOR DE AIRE SUSPENSION DELANTERA ( L / R ) MERCEDES INACTIVO,1268,1,5,2,8
2032400417-100,SOPORTE HIDRAULICO DE MOTOR MERCEDES W202 ( FREY ) INACTIVO,1852,8,6,5,19
2033200273,BASE DE AMORTIGUADOR DELANTERO L-R MERCEDES W203 BMTR,1655,2,7,6,15
2033200273 *1,BASE COMPLETA AMORTIGUADOR DELANTERO (L/R) MERCEDES W203 (FREY),1384,7,1,6,14
2033200273B,CENTRO GOMA BASE AMORTIGUADOR DELANTERO (L/R) MERCEDESï¿½W203ï¿½(FREY),1559,2,4,8,14
2033200744,CUBRE POLVO DE AMORTIGUADOR MERCEDES W203 URO,1419,0,0,4,4
2033200744 *1,CUBRE POLVO DE AMORTIGUADOR MERCEDES W203 FREY,1425,8,8,5,21
2033201330,AMORTIGUADOR DE SUSPENSION DELANTERA L-R MERCEDES W203 COUPE W209 BMTR,1539,8,2,6,16
2033202689 *1,TORNILLO ESTABILIZADOR SUSPENSION DELANTERA (L/R) MERCEDES W203 (FREY),1690,7,7,8,22
2033202889 *1,TORNILLO ESTABILIZADOR SUSPENSION DELANTERA (L/R) MERCEDES W203 FREY,1652,6,6,3,15
2033202889 *5,TORNILLO ESTABILIZADOR SUSPENSION DELANTERA (L/R) MERCEDES C209 W203 (DELPHI) SSF,1629,8,4,5,17
2033202989 *1,TORNILLO ESTABILIZADOR SUSPENSION DELANTERA (L/R) 12 MM MERCEDES W203 (FREY),1436,1,7,1,9
2033202989 *6,TORNILLO ESTABILIZADOR SUSPENSION DELANTERA (L/R) 12 MM MERCEDES W203 (KARLYN) SSF,1839,2,0,9,11
2033203089,TORNILLO ESTABILIZADOR SUSPENSION DELANTERA (L/R) MERCEDES W203 10MM (LEMFORDER),1413,1,4,5,10
2033205330 *1,AMORTIGUADOR SUSPENSION DELANTERA (L/R) MERCEDES W203 SEDAN (FREY),1516,1,7,6,14
2033206530 *1,AMORTIGUADOR SUSPENSION DELANTERA (L/R) MERCEDES W203 COUPE CLK W209 (FREY),1320,3,5,9,17
2033232085 *1,BUJE GOMA BARRA ESTABILIZADORA SUSPENSION DELANTERA 20 MM (L/R) MERCEDES C209 W20 (FREY),1958,8,6,3,17
2033232085 *5,BUJE GOMA BARRA ESTABILIZADORA SUSPENSION DELANTERA 20 MM (L/R) MERCEDES C209 W203 (FEBI) SSF,1808,1,6,7,14
2033232085-100,BUJE DE BARRA ESTABILIZADORA MERCEDES W203 INACTIVO,1942,3,0,2,5
2033261700 *1,AMORTIGUADOR SUSPENSION TRASERA (L/R) MERCEDES W203 (FREY),1633,4,4,2,10
2033261700-2,AMORTIGUADOR DE SUSPENSION TRASERA L-R MERCEDES W203 SACHS,1494,7,1,3,11
2033270090,ENLACE ESTABILIZADOR (FEBI),1447,2,4,6,12
2033270090 *1,CUBRE POLVO BUJE BARRA ESTABILIZADORA DELANTERA (L/R) MERCEDES W203 C209 (FREY),1435,1,7,6,14
2033300060,RETEN DE RUEDA DELANERA MERCEDES W203 ( CORTECO 48 X 68 X 9.3 ),1603,3,1,9,13
2033300060 *1,RETEN DE RUEDA DELANTERA MERCEDES W203 ( FREY 48 X 68 X 9.3 ),1597,4,4,4,12
2033300111 *1,BRAZO RECTO SUPERIOR SUSPENSION DELANTERA (L) MERCEDES W203 W204 W209 W212 R172 (FREY),1701,3,6,9,18
2033300211 *1,BRAZO RECTO SUPERIOR SUSPENSION DELANTERA (R) MERCEDES W203 W204 W209 W212 R172 (FREY),1843,8,6,8,22
2033300307 *1,HORQUILLA SUSPENSION DELANTERA (L) 4 MATIC MERCEDES W203 (FREY),1805,5,3,9,17
2033300407 *1,HORQUILLA SUSPENSION DELANTERA (R) 4 MATIC MERCEDES W203 (FREY),1315,4,2,6,12
2033301903,TERMINAL DIRECCION SIN BIELETA SUSPENSION DELANTERA (L) MERCEDES W203 (BMTR),1224,4,1,2,7
2033301903-1,TERMINAL DIRECCION SIN BIELETA SUSPENSION DELANTERA (L) MERCEDES W203 (OPTIMAL),1817,3,0,9,12
2033301903-2,TERMINAL DIRECCION SIN BIELETA SUSPENSION DELANTERA (L) MERCEDES W203 (BENDIX),1608,3,9,2,14
2033302003-1,TERMINAL DIRECCION SIN BIELETA SUSPENSION DELANTERA (R) MERCEDES W203 (DELPHI),1508,1,0,0,1
2033303311 *1,BRAZO RECTO INFERIOR SUSPENSION DELANTERA (L) MERCEDES W203 W209 R170 (FREY),1845,4,5,7,16
2033303311 *3,BRAZO HIERRO INFERIOR DE SUSPENSION DELANTERA (L) MERCEDES W203 204 (LEMFORDER),1460,6,0,7,13
2033303311-100,BRAZO DE HIERRO INFERIOR DE SUSPENSION DELANTERA ( L ) MERCEDES W203-204 ( BMTR ) INACTIVO,1433,1,3,0,4
2033303411 *1,BRAZO RECTO INFERIOR SUSPENSION DELANTERA (R) MERCEDES W203 W209 R170 (FREY),1717,1,1,6,8
2033303411 *2,BRAZO DE HIERRO INFERIOR SUSPENSION DELANTERA ( R ) MERCEDES W203-204 BENDIX,1766,9,6,1,16
2033303411 *3,BRAZO DE HIERRO INFERIOR SUSPENSION DELANTERA ( R ) MERCEDES W203-204 (BMTR),1307,8,9,8,25
2033303903 *1,TERMINAL DIRECCION SIN BIELETA SUSPENSION DELANTERA (L) MERCEDES W203 (FREY),1730,4,7,1,12
2033304003 *1,TERMINAL DIRECCION SIN TERMINAL SUSPENSION DELANTERA (R) MERCEDES W203 (FREY),1636,8,9,3,20
2033330214 *1,BUJE BRAZO SUPERIOR SUSPENSION 80X70X17.5 MM (L/R) MERCEDES W203 W204 (FREY),1351,3,4,5,12
2033330214 *3,BUJE BRAZO SUPERIOR SUSPENSION 80X70X17.5 MM (L/R) MERCEDES W203 W204 (CORTECO),1831,9,6,5,20
2033330214 *5,BUJE BRAZO SUPERIOR SUSPENSION 80X70X17.5 MM (L/R) MERCEDES W203 W204 (LEMFORDER) SSF,1276,8,5,6,19
2033330514,BUJE DIRECCION HIDRAULICA MERCEDES W203 (ORIGINAL),1549,4,0,5,9
2033330514 *1,BUJE DIRECCION HIDRAULICA MERCEDES W203 (FREY),1908,4,7,1,12
2033330514-2,BUJE DIRECCION HIDRAULICA MERCEDES W203 (OSSCA),1822,8,7,9,24
2033330914,BUJE CHICO DE BRAZO INFERIOR L-R MERCEDES W203-M272 BMTR,1601,4,0,1,5
2033330914 *1,BUJE CHICO DE BRAZO INFERIOR L-R MERCEDES W203-M272 FREY,1967,2,1,7,10
2033330914 *5,BUJE CHICO BRAZO INFERIOR SUSPENSION DELANTERA (L/R) MERCEDES W203 (CORTECO),1922,2,9,4,15
2033330914 *6,BUJE CHICO BRAZO INFERIOR SUSPENSION DELANTERA (L/R) MERCEDES W203 (FEBI) SSF,1929,0,7,5,12
2033570008 *1,MAZA DE RUEDA TRASERO L-R MERCEDES W203 FREY,1543,8,8,4,20
2033570108,MAZA DE RUEDA TRASERO L-R MERCEDES W203 OPTIMAL,1778,4,3,6,13
2034210312,DISCO DE FRENOS DELANTEROS MERCEDES W203 ( ATE 288 X 22 MM ),1315,4,7,8,19
2034210312 *1,DISCO FRENOS DELANTEROS VENTILADO (L/R) 288 MM MERCEDES C209 W203 R171 (FREY),1314,4,0,3,7
2034210312-1,DISCO DE FRENOS DELANTEROS MERCEDES W203 PAGID 288 X 22 MM JUEGO,1968,4,1,1,6
2034210512,DISCO DE FRENOS DELANTEROS MERCEDES W203 300 X 28MM PAGID,1461,2,5,7,14
2034210912 *3,DISCO FRENOS DELANTERO 345x30x67 MM MERCEDES AMG W203 W209 (FRASLE),1534,5,2,0,7
2034210921,DISCO DE FRENOS DELANTEROS MERCEDES W203 / W209 ( FREMAX ),1696,2,6,9,17
2034210921 *1,DISCO DE FRENOS DELANTEROS MERCEDES W203 / W209 FREY,1797,4,9,8,21
2034230112,DISCO DE FRENOS TRASEROS 278X56 MM MERCEDES C208 C209 R170 R171 W203 W210 ( ATE ),1664,0,5,3,8
2034230112 *1,DISCO DE FRENOS TRASEROS 278X56 MM MERCEDES C208 C209 R170 R171 W203 W210 (FREY),1756,6,6,7,19
2034230112-2,DISCO DE FRENOS TRASEROS 278X56 MM MERCEDES C208 C209 R170 R171 W203 W210 ( PAGID 355124381 ),1474,9,7,9,25
2034601100 *1,CAJA DIRECCION HIDRAULICA CREMALLERA MERCEDES W203 (FREY),1562,6,9,4,19
2034630296,COBRE POLVO DE DIRECCION MERCEDES W203 CRP,1755,8,3,6,17
2034630296-1,COBRE POLVO DE DIRECCION MERCEDES W203 LEMFORDER,1763,0,0,4,4
2034701641,SENSOR DE NIVEL DE COMBUSTIBLE MERCEDES W203 PIERBUG,1395,1,8,9,18
2034701641-1,SENSOR DE NIVEL DE COMBUSTIBLE MERCEDES W203 KOLBENSCHMIDT,1830,1,9,4,14
2034702394 *1,BOMBA GASOLINA ELECTRICA MERCEDES C209 W203 (FREY),1966,9,5,1,15
2034702394 *5,BOMBA GASOLINA ELECTRICA MERCEDES C209 W203 (URO) SSF,1906,0,4,1,5
2034702394 *6,BOMBA GASOLINA ELECTRICA MERCEDES C209 W203 (BOSCH) SSF,1825,4,3,9,16
2035000049,DEPOSITO DE ANTICONGELANTE MERCEDES W203 1.8 L BEHR,1325,0,5,8,13
2035000049 *1,DEPOSITO ANTICONGELANTE MERCEDES W203 KOMPRESSOR W209 CLK (FREY),1979,8,9,2,19
2035000503 *1,RADIADOR ENFRIAMIENTO MOTOR TRANSMISION AUTOMATICA Y STANDAR MERCEDES W203 R171 M272 (FREY),1276,9,4,1,14
2035000503-1,RADIADOR DE MOTOR MERCEDES W203 M111-M271-M272 AUTOMATICO REACH,1938,3,2,3,8
2035000503-100,RADIADOR DE MOTOR MERCEDES W203 M111-M271-M272 AUTOMATICO BMTR INACTIVO,1597,6,2,0,8
2035001693 *1,MOTOVENTILADOR ENFRIAMIENTO MOTOR 600W MERCEDES W203 W204 M272 (FREY),1244,4,7,1,12
2035010025 *1,MANGUERA DE DEPOSITO DE ANTICONGELANTE MERCEDES W203-M271 FREY,1868,8,6,6,20
2035010025-100,MANGUERA DE DEPOSITO DE ANTICONGELANTE MERCEDES W203-M271 (OSSCA) INACTIVO,1918,0,5,3,8
2035010025-2,MANGUERA DE DEPOSITO DE ANTICONGELANTE MERCEDES W203-M271 REIN,1506,6,0,8,14
2035010782,MANGUERA RADIADOR MERCEDES W203 KZR,1883,1,4,8,13
2035010782 *1,MANGUERA SUPERIOR RADIADOR MERCEDES W203 (FREY),1738,0,2,7,9
2035010882 *1,MANGUERA DE RADIADOR MERCEDES W203 FREY,1386,6,8,9,23
2035012882,MANGUERA INFERIOR DE RADIADOR MERCEDES W203-M111 FEBI,1779,3,0,8,11
2035012882 *1,MANGUERA INFERIOR DE RADIADOR MERCEDES W203-M111 FREY,1352,1,5,1,7
2035014582 *3,MANGUERA RADIADOR ENFRIAMIENTO MOTOR MERCEDES W203 (MEISTERSATZ),1741,8,7,0,15
2035014682 *1,MANGUERA DE AGUA MERCEDES M272 FREY,1690,2,8,3,13
2035015582,MANGUERA INFERIOR DE RADIADOR MERCEDES W203 L4 1.8L REIN,1821,1,5,1,7
2035015582 *1,MANGUERA INFERIOR DE RADIADOR MERCEDES W203 L4 1.8L FREY,1394,3,4,1,8
2035015582 *2,MANGUERA INFERIOR DE RADIADOR MERCEDES W203 L4 1.8L (EMBLER),1207,5,1,5,11
2035400253,ADAPTADOR CONECTOR TRANSMISION MOTOR MERCEDES W140 W163 W202-W204 W210-W212 W220 W463 (OSSCA),1677,9,2,3,14
2035400253 *1,ADAPTADOR CONECTOR TRANSMISION MOTOR MERCEDES W140 W163 W202-W204 W210-W212 W220 W463 (FREY),1510,7,0,4,11
2035400417,SENSOR DE FRENOS ABS DELANTERO ( L / R ) MERCEDES W203 ( ATE ),1919,3,7,1,11
2035400417 *1,SENSOR FRENOS ABS DELANTERO (L/R) MERCEDES W203 (FREY),1534,5,1,1,7
2035400417-1,SENSOR DE FRENOS ABS DELANTERO ( L-R ) MERCEDES W203 BREMI,1659,0,1,4,5
2035400688,MOTOVENTILADOR 400W MERCEDES W203-M272 V6 GENUINO,1757,5,1,4,10
2035400688 *1,MOTOVENTILADOR 400W MERCEDES W203-M272 V6 FREY,1862,2,5,3,10
2035401317,SENSOR DE FRENOS ABS TRASERO ( L ) MERCEDES W203 ( ATE ),1538,4,8,9,21
2035401317 *1,SENSOR DE FRENOS ABS TRASERO ( L ) MERCEDES W203 FREY,1988,1,0,1,2
2035401417 *1,SENSOR FRENOS ABS TRASERO (R ) MERCEDES W203 (FREY),1914,1,2,7,10
2038210679 *1,CONTROL ELECTRICO MAESTRO VENTANILLAS CAJUELA (L/R) MERCEDES W203 (FREY),1566,9,4,9,22
2038300118-1,FILTRO POLEN AIRE CABINA MERCEDES BENZ W203-M271 MICRO AIR,1596,5,0,7,12
2038300118-2,FILTRO POLEN AIRE CABINA MERCEDES BENZ W203-M271 CORTECO,1602,3,6,9,18
2038300596 *1,MANGUERA AGUA ENFRIAMIETO MOTOR MERCEDES W203 M112 C208 M113 (FREY),1204,5,3,9,17
2038300918 *1,FILTRO POLEN AIRE CABINA MERCEDES W203 C209 (FREY),1779,5,8,6,19
2038300918 *3,FILTRO POLEN AIRE CABINA MERCEDES BENZ W203-M271 (MAHLE LA129),1816,3,3,0,6
2038800029,AMORTIGUADOR COFRE FUERZA 280 NEWTONS 570 MM (R) MERCEDES W203 URO,1967,6,1,2,9
2038800029 *1,AMORTIGUADOR COFRE FUERZA 280 NEWTONS 570 MM (R) MERCEDES W203 (FREY),1891,9,4,2,15
2038800029 *2,AMORTIGUADOR COFRE FUERZA 280 NEWTONS 570 MM (R) MERCEDES W203 (STABILUS) SSF,1256,3,2,9,14
2038800429,AMORTIGUADOR COFRE FUERZA 280 NEWTONS 525 MM (L) MERCEDES W203 BMTR,1409,6,9,1,16
2038800429 *1,AMORTIGUADOR COFRE FUERZA 280 NEWTONS 525 MM (L) MERCEDES W203 FREY,1597,5,8,4,17
2038800429-2,AMORTIGUADOR COFRE FUERZA 280 NEWTONS 525 MM (L) MERCEDES W203 URO,1689,7,5,6,18
2038870227,MANIJA DE LIBERACION DE COFRE MERCEDES W203 ( GENUINA ),1572,4,8,9,21
2038870227 *1,MANIJA DE LIBERACION DE COFRE MERCEDES W203 FREY,1476,2,9,9,20
2042400618,SOPORTE DE TRANSMISION MERCEDES W204 / X204 ( BMTRS ),1543,4,4,9,17
2042400618 *2,SOPORTE TRANSMISION AUTOMATICA MERCEDES W204 X204 ( CORTECO ),1556,3,1,7,11
2042400917,SOPORTE DE MOTOR L-R MERCEDES W204 FEBI,1946,7,5,3,15
2042400917 *,SOPORTE DE MOTOR L-R MERCEDES W204 BMTR,1818,9,4,3,16
2042400917 *3,SOPORTE DE MOTOR L-R MERCEDES W204 REIN,1942,5,7,6,18
2042400917 *5,SOPORTE MOTOR (L/R) MERCEDES W204 W211 M272 (CORTECO),1885,9,7,1,17
2042400917-100,SOPORTE DE MOTOR L-R MERCEDES W204 BEMWQ INACTIVO,1567,2,2,2,6
2042401517 *1,SOPORTE DE MOTOR DELANTERO L-R MERCEDES W204 FREY,1269,6,6,6,18
2042401517 *2,SOPORTE DE MOTOR DELANTERO L-R MERCEDES W204 BMTR,1520,4,9,7,20
2042402017 *,SOPORTE DE MOTOR DELANTERO ( L - R ) MERCEDES W204 GLK350 3.5 L V6 ( CORTECO ),1922,4,2,1,7
2042402017 *1,SOPORTE MOTOR DELANTERO (L/R) MERCEDES W204 GLK350 3.5 L V6 (FREY),1465,3,3,2,8
2042403517 *5,SOPORTE MOTOR DELANTERO (L/R) MERCEDES X204 M272 M276 2013 A 2016 (LEMFOERDER),1854,2,4,3,9
2042404317 *1,SOPORTE MOTOR (L/R) MERCEDES W212 M272 W204 M272 (FREY),1410,6,0,1,7
2042404817 *1,SOPORTE MOTOR (L) W212 MERCEDES (FREY ),1841,4,4,3,11
2042405617 *1,SOPORTE MOTOR DELANTERO (L/R) MERCEDES X204 M272 M276 2013 A 2016 (FREY),1632,3,9,3,15
2043200073 *1,BASE AMORTIGUADOR SUSPENSION DELANTERA (L/R) MERCEDES W204 (FREY),1881,1,4,2,7
204320013-100,AMORTIGUADOR DE SUSPENSION DELANTERA L-R MERCEDES INACTIVO,1702,6,7,8,21
2043200130 *1,AMORTIGUADOR SUSPENSION DELANTERA (L/R) MERCEDES W204 (FREY),1814,0,1,6,7
2043200331,AMORTIGUADOR DE SUSPENSION TRASERA ( L- R ) MERCEDES GLK X204 ( BILSTEIN ),1361,3,4,8,15
2043200331 *1,AMORTIGUADOR SUSPENSION TRASERA (L/R) MERCEDES GLK X204 (FREY),1928,7,1,5,13
2043200331-3,AMORTIGUADOR DE SUSPENSION TRASERA ( L-R ) MERCEDES GLK X204 ( SACHS ),1573,8,9,4,21
2043200489 *1,TORNILLO BARRA ESTABILIZADORA SUSPENSION TRASERA (R) BMW W204 W212 (FREY),2000,2,8,8,18
2043200589 *1,TORNILLO BARRA ESTABILIZADORA SUSPENSION TRASERA (L) BMW W204 W212 (FREY),1565,1,4,7,12
2043200789 *1,TORNILLO ESTABILIZADOR SUSPENSION DELANTERA (L) MERCEDES W204 X204 (FREY),1337,0,8,5,13
2043201273 *3,BASE AMORTIGUADOR DELANTERO (L/R) MERCEDES W204 (CORTECO),1949,4,7,1,12
2043201273-100,BASE DE AMORTIGUADOR DELANTERO ( L-R ) MERCEDES W204 BMTR INACTIVO,1398,5,0,9,14
2043201273-2,BASE DE AMORTIGUADOR DELANTERO ( L-R ) MERCEDES W204 LEMFOLDER,1872,1,1,7,9
2043201273-4,BASE DE AMORTIGUADOR DELANTERO ( L-R ) MERCEDES W204 BEMQW,1406,4,4,8,16
2043201789 *1,TORNILLO ESTABILIZADOR SUSPENSION DELANTERA (L) MERCEDES W204 (FREY),1336,6,7,1,14
2043201789 *2,TORNILLO ESTABILIZADOR SUSPENSION DELANTERA (L) MERCEDES W204 (LEMFOERDER),1538,0,6,7,13
2043201789 *4,TORNILLO ESTABILIZADOR SUSPENSION DELANTERA (L) MERCEDES W204 (DELPHI),1907,7,5,7,19
2043201789 *5,TORNILLO ESTABILIZADOR SUSPENSION DELANTERA (L) MERCEDES W204 (SIDEM),1713,2,3,1,6
2043201789-100,TORNILLO DE BARRA ESTABILIZADORA SUSPENSION DELANTERA ( L ) MERCEDES W204 FREY INACTIVO,1427,1,5,6,12
2043201889 *1,TORNILLO BARRA ESTABILIZADORA SUSPENSION DELANTERA (R) MERCEDES W204 (FREY),1625,7,3,3,13
2043201889 *2,TORNILLO ESTABILIZADOR SUSPENSION DELANTERA (R) MERCEDES W204  (LEMFOERDER),1541,5,9,1,15
2043201889 *4,TORNILLO ESTABILIZADOR SUSPENSION DELANTERA (R) MERCEDES W204 (MEYER),1800,9,0,8,17
2043201889-100,TORNILLO ESTABILIZADOR DELANTERO (R) MERCEDES W204 BMTRS INACTIVO,1925,2,2,9,13
2043202289 *1,TORNILLO ESTABILIZADOR SUSPENSION DELANTERA (R) MERCEDES W204 X204 (FREY),1665,2,9,1,12
2043202289 *3,TORNILLO ESTABILIZADOR SUSPENSION DELANTERA (R) MERCEDES W204-X204  (FRAP),1285,1,7,3,11
2043230044 *5,GOMA DE REBOTE DE AMORTIGUADOR DELANTERO MERCEDES W204 M272 (FEBI) SSF,1915,2,0,3,5
2043230120,BASE DE AMORTIGUADOR DELANTERO L-R MERCEDES X204 BMTR,1822,4,9,0,13
2043230120 *1,BASE AMORTIGUADOR SUSPENSION DELANTERA (L/R) MERCEDES X204 (FREY),1979,3,5,0,8
2043230120-3,BASE DE AMORTIGUADOR DELANTERO L-R MERCEDES X204 TOPRAN,1805,4,6,4,14
2043230665 *1,BARRA ESTABILIZADORA CON BUJES SUSPENSIO DELANTERA MERCEDES W204 W212 (FREY),1219,7,1,7,15
2043230665B,BUJE BARRA ESTABILIZADORA SUSPENSIO DELANTERA (L/R) MERCEDES W204 W212 (FREY),1485,4,5,1,10
2043231700 *1,AMORTIGUADOR SUSPENSION DELANTERA (L/R) MERCEDES GLK X204 (FREY),1908,1,5,5,11
2043231700 *3,AMORTIGUADOR SUSPENSION DELANTERA (L/R) MERCEDES GLK X204 (SACHS 314006),1513,5,2,4,11
2043232400 *5,AMORTIGUADOR SUSPENSION DELANTERA (L/R) MERCEDES W204 (BILSTEIN) SSF,1658,2,9,0,11
2043260200 *1,AMORTIGUADOR SUSPENSION TRASERA (L/R) MERCEDES W204 (FREY),1529,3,7,4,14
2043260200-1,AMORTIGUADOR DE SUSPENSION TRASERA L-R MERCEDES W204-M271 SACHS 317266,1222,9,7,5,21
2043300625 *1,BALERO DE RUEDA DELANTERA (L/R) MERCEDES A207 C207 R172 W204 (FREY),1840,4,8,8,20
2043300903 *1,TERMINAL DIRECCION SIN BIELETA SUSPENSION DELANTERA (L) MERCEDES W204 W212 (FREY),1384,0,6,1,7
2043301003 *1,TERMINAL DIRECCION SIN BIELETA SUSPENSION DELANTERA (R) MERCEDES W204 W212 (FREY),1787,8,2,8,18
2043301501 *1,JUNTA HOMOSINETICA FLECHA DELANTERA (L) MERCEDES X204 (FREY),1753,8,9,4,21
2043301601 *1,JUNTA HOMOSINETICA FLECHA DELANTERA (R) MERCEDES X204 (FREY),1810,4,2,3,9
2043301903 *1,TERMINAL DIRECCION SIN BIELETA SUSPENSION DELANTERA (L) MERCEDES X204 W212 W218 (FREY),1392,6,6,0,12
2043302003 *1,TERMINAL DIRECCION SIN BIELETA SUSPENSION DELANTERA (R) MERCEDES X204 W212 W218 (FREY),1473,2,1,1,4
2043303111 *1,BRAZO CURVO INFERIOR SUSPENSION DELANTERA (L) MERCEDES W204 W212 R172 (FREY),1636,4,1,7,12
2043303211 *1,BRAZO CURVO INFERIOR SUSPENSION DELANTERA (R) MERCEDES W204 W212 R172 (FREY),1746,5,8,8,21
2043306711,BRAZO SEMI CURVO INFERIOR SUSPENSION DELANTERA (L) W204 W212 R172 (VIKA),1561,4,4,0,8
2043306811-100,BRAZO SEMI CURVO INFERIOR SUSPENSION DELANTERA (R) W204 W212 R172 INACTIVO,1920,6,3,4,13
2043306811-101,BRAZO INFERIOR DE SUSPENSION DELANTERA R MERCEDES W204-TM BMTR INACTIVO,1977,2,4,5,11
2043308011,BRAZO INFERIOR DE SUSPENSIï¿½N DELANTERA L-R MERCEDES X204 BMTR,1822,2,6,3,11
2043308011 *1,BRAZO INFERIOR SUSPENSIï¿½N DELANTERA (L/R) MERCEDES X204 (FREY),1839,5,4,8,17
2043308011-100,BRAZO INFERIOR DE SUSPENSIï¿½N DELANTERA L-R MERCEDES X204 BEMQW INACTIVO,1274,8,9,4,21
2043308111 *1,BRAZO SUPERIOR SUSPENSION DELANTERA (L) MERCEDES X204 (FREY),1817,6,9,7,22
2043308211 *1,BRAZO SUPERIOR SUSPENSION DELANTERA (R) MERCEDES X204 (FREY),1213,4,4,3,11
2043380415 *1,BIELETA DIRECCION SIN TERMINAL SUSPENSION DELANTERA (L/R) MERCEDES W204 W212 (FREY),1552,1,9,9,19
2043380515,BIELETA DIRECCIï¿½N SIN TERMINAL SUSPENSION DELANTERA (L/R) MERCEDES BENZ X204 (BENDIX),1997,4,0,8,12
2043380515 *1,BIELETA DIRECCION SIN TERMINAL SUSPENSION DELANTERA (L/R) MERCEDES W204 X204 W212 W221 (FREY),1821,1,1,0,2
2043500553 *1,BRAZO RECTO SUPERIOR SUSPENSION TRASERA (L) MERCEDES W204 W205 X204 (FREY),1202,1,8,0,9
2043500653 *1,BRAZO RECTO SUPERIOR SUSPENSION TRASERA (R) MERCEDES W204 W205 X204 (FREY),1440,0,7,4,11
2043501506 *3,BRAZO CURVO SUSPENSION TRASERA (L) MERCEDES W204 W205 W212 W213 W253 (MEISTERSATZ),1795,4,0,6,10
2043502106 *1,BRAZO CURVO SUSPENSION TRASERA (L) MERCEDES W204 W205 W212 W213 W253 (FREY),1836,4,0,5,9
2043502206 *1,BRAZO CURVO SUSPENSION TRASERA (R) MERCEDES W204 W205 W212 W213 W253 (FREY),1575,1,1,3,5
2043520027,BUJE DE SUSPENSION TRASERA L-R MERCEDES W203-W204-W209-W210-W211-W212 FEBI,1510,0,2,2,4
2043520027 *1,BUJE DE SUSPENSION TRASERA L-R MERCEDES W203-W204-W209-W210-W211-W212 FREY,1297,7,4,5,16
2044100981,SOPORTE DE CARDAN MERCEDES W168 VAICO,1538,4,2,3,9
2044106701 *1,EJE TRANSMISION DELANTERO (L/R) MERCEDES W221 W222 X204 (FREY),1947,5,1,4,10
2044212912,DISCO DE FRENO DELANTERO MERCEDES X204 ( FREEMAX ),1838,3,4,3,10
2044212912*1,DISCO DE FRENO DELANTERO MERCEDES X204 (OSSCA),1706,1,4,4,9
2044230512 *1,DISCO BALATAS FRENOS TRASEROS SOLIDO (L/R) 278 MM MERCEDES W204 (FREY),1382,2,2,4,8
2044231512,DISCO DE FRENOS TRASEROS 300X10 MM MERCEDES W204 ( PAGID 355123681 ),1479,3,3,4,10
2044231512 *1,DISCO DE FRENOS TRASEROS 300X10 MM MERCEDES W204 (FREY),1252,3,7,7,17
2044231512 *5,DISCO DE FRENOS TRASEROS 300X10 MM MERCEDES W204 (FREMAX) SSF,1546,0,7,0,7
2044604324 *1 ,MANGUERA DIRECCION ALTA PRECION MERCEDES W204 W212 X204 M272 (FREY),1990,2,2,0,4
2044605900 *1,CAJA DE DIRECCION HIDRAULICA CREMALLERA MERCEDES W204 (FREY),1663,9,2,3,14
2044630296,CUBRE POLVO DE DIRECCION MERCEDES W204 LEMFORDER,1470,1,6,5,12
2044630296 *1,CUBRE POLVO DE DIRECCION MERCEDES W204 FREY,1726,4,5,3,12
2044700294,BOMBA DE GASOLINA MERCEDES W204 3.5L DELPHI,1276,3,6,8,17
2044700294 *1,BOMBA COMBUSTIBLE GASOLINA MERCEDES W204 W212 (FREY),1583,2,9,4,15
2044700894 *1,BOMBA GASOLINA ELECTRICA LADO DERECHO MERCEDES W204 (FREY),1213,0,9,4,13
2044700894-100,BOMBA GASOLINA ELECTRICA MERCEDES W204 3.5L (FREY) INACTIVO,1561,5,8,2,15
2044701094 *2,BOMBA COMBUSTIBLE GASOLINA MERCEDES W204 W212 (EMBLER),1926,0,3,6,9
2044701394 *1,BOMBA GASOLINA ELECTRICA MERCEDES W204 W205 W212 (FREY),1492,4,1,5,10
2044702094,BOMBA DE GASOLINA CON FLOTADOR LADO IZQUIERDO MERCEDES W204 BMTR,1411,8,6,7,21
2044702094 *1,BOMBA DE GASOLINA CON FLOTADOR LADO IZQUIERDO MERCEDES W204 FREY,1700,5,1,2,8
2045000049,DEPOSITO DE ANTICONGELANTE MERCEDES W204 BEHR,1424,0,4,0,4
2045000049-3,DEPOSITO DE ANTICONGELANTE MERCEDES W204 (EMBLER),1262,2,3,0,5
2045000100,INTERCOOLER ENFRIADOR TURBO CARGADOR MERCEDES W204 NISSENS,1249,4,4,3,11
2045000100 *1,INTERCOOLER ENFRIADOR TURBO CARGADOR MERCEDES W204 FREY,1373,7,4,0,11
2045000193 *1,MOTOVENTILADOR ENFRIAMIENTO MOTOR MERCEDES C218 M276 (FREY),1746,8,8,7,23
2045000200 *1,INTERCOOLER TURBO CARGADOR MERCEDES (FREY),1695,3,8,6,17
2045000293 *1,MOTOVENTILADOR ENFRIAMIENTO MOTOR 600W MERCEDES R172 M271 W204 M272 M156 W212 M273 (FREY),1957,2,1,7,10
20450003-100,MOTOVENTILADOR ENFRIAMIENTO MOTOR 600W MERCEDES INACTIVO,1887,4,9,5,18
2045000549 *1,DEPOSITO ANTICONGELANTE ENFRIAMIENTO MOTOR MERCEDES W204 W212 X204 (FREY),1882,2,6,4,12
2045000654 *1,CONDENSADOR AIRE ACONDICIONADO MERCEDES W204 W212 X156 (FREY),1332,1,0,2,3
2045002803 *1,RADIADOR ENFRIMIENTO MOTOR MERCEDES W204 M272 (FREY),1469,6,2,4,12
2045002803-3,RADIADOR DE MOTOR MERCEDES W204 / M272 NRF,1443,4,6,1,11
2045003603 *1,RADIADOR ENFRIAMIENTO MOTOR MERCEDES X204 M272 W212 M273 (FREY),1996,1,1,2,4
2045010182 *1,MANGUERA SUPERIOR DE RADIADOR MERCEDES W204-C180 FREY,1323,9,3,9,21
2045010382,MANGUERA DE RADIADOR LADO IZQUIERDO (FORMA Y) W204 MOTOR 3.0L V6,1771,7,9,2,18
2045010382 *1,MANGUERA DE RADIADOR LADO IZQUIERDO (FORMA Y) W204 MOTOR 3.0L V6 FREY,1697,5,7,8,20
2045010382-2,MANGUERA DE RADIADOR LADO IZQUIERDO (FORMA Y) W204 MOTOR 3.0L V6 EMBLER,1718,4,9,0,13
2045010925 *1,MANGUERA VENTILACION RADIADOR DEPOSITO ANTICONGELANTE MERCEDES W204 M271 2a GEN TURBO (FREY),1916,2,2,5,9
2045011682 *1 ,MANGUERA INFERIOR RADIADOR (R) ENFRIAMIENTO MOTOR MERCEDES W204 M271 M272 (FREY),1321,8,9,0,17
2045012582 *1,MANGUERA SUPERIOR RADIADOR ENFRIAMIENTO MERCEDES W204 W271 2a GEN (FREY),1270,5,3,7,15
2045012782,MANGUERA DE RADIADOR LADO IZQUIERDO W204 MOTOR 3.0L V6,1509,4,4,2,10
2045012782 *1,MANGUERA DE RADIADOR LADO IZQUIERDO W204 MOTOR 3.0L V6 FREY,1228,6,9,3,18
2045012825 *1,MANGUERA RADIADOR MERCEDES W204 (FREY),1570,0,8,0,8
2045013782,MANGUERA DE RADIADOR LADO DERECHO W204-M272 BMTR,1748,4,4,3,11
2045013782 *1,MANGUERA DE RADIADOR LADO DERECHO W204-M272 FREY,1662,4,4,6,14
2045013782 *2,MANGUERA DE RADIADOR LADO DERECHO W204-M272 (EMBLER),1936,6,8,3,17
2045013782-1,MANGUERA DE RADIADOR LADO DERECHO W204-M272 GENUINA,1234,3,2,6,11
2045013982,MANGUERA INFERIOR MERCEDES W204 EMBLER,1924,7,0,1,8
2045013982 *1,MANGUERA INFERIOR RADIADOR ENFRIAMIENTO MOTOR MERCEDES W204 (FREY),1711,2,6,7,15
2045014082,MANGUERA INFERIOR DE RADIADOR R MERCEDES  W204-C300 GENUINA,1358,3,3,6,12
2045019082 *1,MANGUERA INFERIOR DE RADIADOR R MERCEDES  W204-C300 FREY,1271,7,8,8,23
2045400117 *1,SENSOR DE FRENOS ABS DELANTERO ( L/R ) MERCEDES W204 FREY,1333,9,5,1,15
2045400117-1,SENSOR DE FRENOS ABS DELANTERO MERCEDES W204 DELPHI,1436,4,5,1,10
2045400317 *1,SENSOR FRENOS ABS TRASERO MERCEDES W204 (FREY),1399,9,4,6,19
2045401317,SENSOR DE FRENOS ABS TRASERO MERCEDES X204 BMTR,1527,2,7,3,12
2045401317 *1,SENSOR DE FRENOS ABS TRASERO MERCEDES X204 FREY,1788,5,6,7,18
2045403710 *1,SENSOR FRENOS ABS DELANTERO (L) MERCEDES W204 (FREY),1659,6,8,1,15
2047302735,ACTUADOR ELECTRICO DE CHAPA TRASERO ( L ) MERCEDES W204/C250 FREY,1660,7,2,6,15
2047302835 *1,ACTUADOR ELECTRICO DE CHAPA TRASERO ( R ) MERCEDES W204 FREY,1206,8,6,1,15
2048170616,EMBLEMA DE CAPUCHA FRONTAL AZUL 57MM MERCEDES ORIGINAL,1640,8,6,1,15
2048700126 *2,BALASTRA MODULO ELECTRONICO LUZ XENON MERCEDES SMART (EMBLER) MLL,1862,6,0,4,10
2048800023-100,PARRILLA MERCEDES BENZ W204 SEMINUEVA (ORIGINAL) INACTIVO,1990,3,8,6,17
2049050100,SENSOR DE FRENOS ABS TRASERO MERCEDES W204 BMTR,1696,4,3,2,9
2049052705,SENSOR DE FRENOS ABS DELANTERO MERCEDES X204 BMTR,1731,2,4,1,7
2049052705 *1,SENSOR DE FRENOS ABS DELANTERO MERCEDES X204 FREY,1863,1,9,3,13
2049057900,SENSOR ABS DELANTERO  MERCERDES W204 (EMBLER),1667,1,8,7,16
2049061005,PORTA FUSIBLES MODULO SAM  MERCEDES X204 ( ORIGINAL),1488,2,5,8,15
2049800564 *1,AMORTIGUADOR COFRE FUERZA 300 NEWTONS 588 MM (L/R ) MERCEDES X204 (FREY),1521,5,8,6,19
2049802264 *1,AMORTIGUADOR CAJUELA 580 NEWTONS 479 MM (L/R) MERCEDES W204 FREY,1607,3,5,9,17
2049802664 *1,AMORTIGUADOR CAJUELA 515 NEWTONS 506 MM (L/R) MERCEDES BENZ W204 X204 (FREY),1501,3,8,0,11
2049810025 *1,BALERO BASE AMORTIGUADOR DELANTERO (L/R) MERCEDES W204 W211 (FREY),1556,7,8,0,15
205/55R16 *3,LLANTA 205/55R16 (OVATION),1743,9,1,8,18
2052400200 *1,SOPORTE MOTORHIDRAULICO (L) MERCEDES W205 M274  (FREY),1544,0,8,9,17
2052400300 *1,SOPORTE MOTOR HIDRAULICO (R) MERCEDES W205 M274 (FREY),1246,5,6,4,15
2052400300 *9,SOPORTE MOTOR HIDRAULICO (R) MERCEDES W205 M274 (CORTECO),1208,9,9,3,21
2052402500 *1 ,SOPORTE TRANSMISION AUTOMATICA TRASERO MERCEDES W205 W212 X253 M264 M274 (FREY),1991,5,6,4,15
2052403300 *1,SOPORTE TRANSMISION AUTOMATICA TRASERO MERCEDES W205 M274 (FREY),1781,8,4,2,14
2052405900 *1,SOPORTE DE MOTOR (L) MERCEDES W205 M274 (FREY),1870,8,6,1,15
2052406000 *1,SOPORTE MOTOR (R) MERCEDES W205 M274 (FREY),1722,3,5,2,10
2052406217 *1,SOPORTE MOTOR (R) MERCEDES W205 M264 M274 M276 (FREY),1682,9,5,8,22
2052406317 *1,SOPORTE MOTOR (L) MERCEDES W205 M264 M274 M276 (FREY),1406,9,5,4,18
2053200130 *1,AMORTIGUADOR SUSPENSION DELANTERA (L/R) MERCEDES W205 (FREY),1438,5,2,3,10
2053200130 *5,AMORTIGUADOR SUSPENSION DELANTERA (L/R) MERCEDES W205 (BILSTEIN) SSF,1581,1,1,4,6
2053200130 *A,AMORTIGUADOR SUSPENSION DELANTERA (L/R) MERCEDES W205 (EMBLER) TECH,1212,4,1,4,9
2053200130-100,AMORTIGUADOR SUSPENSION DELANTERA (L/R) MERCEDES W205 INACTIVO,1232,2,8,1,11
2053202330-100,AMORTIGUADOR DE SUSPENSION DELANTERA (L/R) MERCEDES W205 (KONI) INACTIVO,1890,2,5,3,10
2053204768 *A,AMORTIGUADOR AIRE SUSPENSION DELANTERA (L) MERCEDES W205 (EMBLER) TECH,1282,8,4,6,18
2053204868 *A,AMORTIGUADOR AIRE SUSPENSION DELANTERA (R) MERCEDES W205 (EMBLER) TECH,1984,8,5,5,18
2053207830 *1,AMORTIGUADOR SUSPENSION TRASERA (L/R) MERCEDES W205 (FREY),1445,9,8,9,26
2053208330k*,KIT AMORTIGUADORES DE SUSPENSION DELANTERA ( L - R ) MERCEDES W205 ( SUNCORE ),1551,7,9,8,24
2053230020 *1,BASE AMORTIGUADOR SUSPENSION DELANTERA (L/R) MERCEDES W205 W213 X153 (FREY),1931,1,1,8,10
2053230020-100,BASE DE AMORTIGUADOR DELANTERO MB W205 (EMBLER) INACTIVO,1801,0,1,2,3
2053230717 *3,TORNILLO ESTABILIZADOR SUSPENSION DELANTERA (L) MERCEDES W205 GLCW213 (EMBLER),1517,8,4,6,18
2053230817 *2,TORNILLO ESTABILIZADOR SUSPENSION DELANTERA (R) MERCEDES W205 GLCW213 (EMBLER),1389,7,2,9,18
2053301305-100,BRAZO DELANTERO (L) MERCEDES BENZ W205 INACTIVO,1318,1,8,2,11
2053301505 *1,BRAZO RECTO INFERIOR SUSPENSION DELANTERA (L) MERCEDES W205 W213 (FREY),1297,5,1,3,9
2053301605 *1,BRAZO RECTO INFERIOR SUSPENSION DELANTERA (R) MERCEDES W205 W213 (FREY),1482,5,9,1,15
2053301705 *1 ,BRAZO CURVO INFERIOR SUSPENSION DELANTERA (L) MERCEDES X253 (FREY),1211,8,3,7,18
2053301805 *1 ,BRAZO CURVO INFERIOR SUSPENSION DELANTERA (R) MERCEDES X253 (FREY),1440,8,2,2,12
2053304507 *1,BRAZO RECTO SUSPENSION DELANTERA (L/R) MERCEDES W205 W213 W238 W253 W257 (FREY),1636,3,5,5,13
2053304507 *3,BRAZO RECTO SUSPENSION DELANTERA (L) MERCEDES W205 W213 W238 W253 W257 (AYD),1217,2,3,2,7
2053305501 *1,HORQUILLA SUPERIOR SUSPENSION DELANTERA (L) MERCEDES W205 W213 W218 W253 (FREY),1235,6,8,7,21
2053305601 *1,HORQUILLA SUPERIOR SUSPENSION DELANTERA (R) MERCEDES W205 W213 W218 W253 (FREY),1755,7,0,1,8
2053305801 *1,BRAZO RECTO SUSPENSION DELANTERA (L/R) MERCEDES W205 W213 W253 W238 W257 (FREY),1862,4,1,3,8
2053306101 *1,BRAZO RECTO SUPERIOR SUSPENSION DELANTERA (L) MERCEDES W205 (FREY),1886,0,2,5,7
2053306201 *1,BRAZO RECTO SUPERIOR SUSPENSION DELANTERA (R) MERCEDES W205 (FREY),1592,1,6,5,12
2053306401 *1,BUJE BRAZO RECTO SUPERIOR SUSPENSION DELANTERA (L/R) MERCEDES W205 (FREY),1706,6,2,1,9
2054600005 *2,TERMINAL DIRECCION SIN BIELETA SUSPENSION DELANTERA (L) MERCEDES W205 W213 X253 4-MATIC (AYD),1386,3,1,4,8
2054600405 *1,BIELETA DIRECCION SIN TERMINAL SUSPENSION DELANTERA (L/R) MERCEDES W205 W213 X253 (FREY),1467,0,6,1,7
2054600605 *1,TERMINAL DIRECCION SIN BIELETA SUSPENSION DELANTERA (L) MERCEDES W205 (FREY),1256,2,5,0,7
2054600705 *1,TERMINAL DIRECCION SIN BIELETA SUSPENSION DELANTERA (R) MERCEDES W205 (FREY),1670,0,1,8,9
2054600805 *1,BIELETA DIRECCION SIN TERMINAL SUSPENSION DELTANTERA (L/R) MB W205 (FREY),1661,5,1,7,13
2054603401 *1,CAJA DE DIRECCION HIDRAULICA CREMALLERA RECONSTRUIDA MERCEDES W205 (FREY),1593,0,0,7,7
2054701594 *1,BOMBA COMBUSTIBLE GASOLINA MERCEDES W205 W213 W274 (FREY),1224,5,1,0,6
2054704900 *1,BOMBA COMBUSTIBLE GASOLINA MERCEDES W205 W213 X253 (FREY),1420,8,5,7,20
2055000049 *1,DEPOSITO ANTICONGELANTE MERCEDES W205 M264 X256 M274 W213 M276 (FREY),1346,7,9,4,20
2058205700 *3,KIT 2 PLUMAS LIMPIA PARABRISAS MERCEDES W205 W253 (SORTECH),1705,6,9,9,24
2058350147,FILTRO POLEN AIRE CABINA MERCEDES W205-M276 KOLBENSCHMIDT,1791,3,4,5,12
2058350147 *1,FILTRO POLEN AIRE CABINA MERCEDES W205-M276 (FREY),1706,4,8,3,15
2058350147 *3,FILTRO POLEN AIRE CABINA MERCEDES W205-M276 (UNIFIL),1974,4,1,5,10
2059053414 *1,BATERIA AUXILIAR TRANSFORMADOR VOLTAJE 12 VOLTIOS MERCEDES (FREY),1830,4,1,5,10
2059053414 *5,BATERIA AUXILIAR TRANSFORMADOR VOLTAJE 12 VOLTIOS MERCEDES (HELLA) SSF,1603,8,7,7,22
2059057803 *1,CONTROL ELECTRICO ASIENTO DELANTER (L/R) MERCEDES W205 (FREY,1220,6,4,6,16
2059058003 *1,SENSOR FRENOS ABS DELANTERO (R) MERCEDES W205 (FREY),1858,5,3,5,13
2059058103 *1,SENSOR FRENOS ABS DELANTERO (L) MERCEDES W205 (FREY),1763,3,3,4,10
2059800064 *1,AMORTIGUADOR COFRE FUERZA 220 NEWTONS 471 MM (L) MERCEDES W205 (FREY),1417,1,8,2,11
2059800164 *1,AMORTIGUADOR COFRE FUERZA 220 NEWTONS 471 MM (R) MERCEDES W205 (FREY),1553,8,4,8,20
2059800964 *1,AMORTIGUADOR CAJUELA 575 NEWTONS 498 MM (L/R) MERCEDES W205 (FREY),1484,0,1,0,1
2059801064 *1,AMORTIGUADOR CAJUELA 300 NEWTONS 523 MM (L/R) MERCEDES BENZ S205 (FREY),1331,7,7,7,21
2059801364 *1,AMORTIGUADOR COFRE FUERZA 430 NEWTONS 471 MM (L) MERCEDES W205 W213 (FREY),1986,2,1,0,3
2059801464 *1,AMORTIGUADOR COFRE FUERZA 430 NEWTONS 471 MM (R) MERCEDES W205 W213 (FREY),1910,2,1,1,4
2074602024 *1,MANGUERA DIRECCION ALTA PRECION MERCEDES W204 M271 2a GEN TURBO (FREY),1846,7,2,1,10
20930288 *C,COMPRESOR AIRE SUSPENSION AVALANCHE YUKON TAHOE ESCALADE (EMBLER) TECH,1989,2,9,2,13
2093300325,COJINETE DE CUBO DE RUEDA (FREY),1951,7,5,4,16
20946204,FILTRO ENTRADA AIRE MOTOR MERCEDES W123 MEYLE,1848,3,7,0,10
20953564 *A,AMORTIGUADOR CON SENSOR SUSPENSION DELANTERA (L) CADILLAC SRX 2010 A 2016 (EMBLER) TECH,1533,6,4,1,11
20953565 *A,AMORTIGUADOR CON SENSOR SUSPENSION DELANTERA (R) CADILLAC SRX 2010 A 2016 (EMBLER) TECH,1789,7,6,2,15
20953566 *A,AMORTIGUADOR CON SENSOR SUSPENSION TRASERA (L) CADILLAC SRX 2010 A 2016 (EMBLER) TECH,1267,6,1,1,8
20953567 *A,AMORTIGUADOR CON SENSOR SUSPENSION TRASERA (R) CADILLAC SRX 2010 A 2016 (EMBLER) TECH,1941,7,6,0,13
2095451908,MODULO PARA LLAVE MERCEDES  W204 ( ORIGINAL SEMINUEVO ),1406,3,8,9,20
2100011031 *5,FAN CLUTCH DE 3 TORNILLOS BMW MOTOR M54 SACHS (SSF),1276,1,3,0,4
2102400318 ,SOPORTE DE TRANSMISION MERCEDES W210 W202 CORTECO,1992,6,9,1,16
2103202130 *1,AMORTIGUADOR SUSPENSION DELANTERA (L/R) MERCEDES W210 (FREY),1545,5,1,5,11
2103203789,TORNILLO ESTABILIZADOR SUSPENSION DELANTERA (R) MERCEDES W210 MERCEDES (TOPRAN),1239,8,4,2,14
2103300035 *1,ROTULA INFERIOR DE SUSPENSION DELANTERA ( L-R ) MERCEDES W202-W210-W211 FREY,1927,4,8,3,15
2103308707,BRAZO DE CONTROL DELANTERO ( L ) MERCEDES W202 W210 MEISTERSATZ,1440,4,1,3,8
2103308707 *1,BRAZO DE CONTROL DELANTERO ( L ) MERCEDES W202 W210 FREY,1413,3,2,3,8
2103380415 *1,BIELETA DIRECCION SIN TERMINAL SUSPENSION DELANTERA (L/R) MERCEDES W210 (FREY),1707,6,2,9,17
2103380415-1,BIELETA DIRECCION SIN TERMINAL SUSPENSION DELANTERA (L/R) MERCEDES BENZ W210 (SIDEM),1429,6,3,2,11
2103380515 *1,TERMINAL DIRECCION SIN BIELETA SUSPENSION DELANTERA (L) MERCEDES W210 (FREY),1311,6,6,5,17
2103380615 *1,TERMINAL DIRECCION SIN BIELETA SUSPENSION DELANTERA (R) MERCEDES W210 (FREY),1286,5,2,3,10
2103501706,BRAZO DE SUSPENSION TRASERA R170 TOPRAN,1238,3,3,5,11
2103503306 *1,BRAZO DE SUSPENSION TRASERA  R170 MERCEDES FREY,1577,4,9,3,16
2104230612,DISCOS DE FRENO TRASEROS MERCEDES W203 ( FREMAX ),1619,9,6,2,17
2104230612 *3,DISCOS DE FRENO TRASEROS MERCEDES W203 (FRASLE),1744,3,9,7,19
2104230612-1,DISCOS DE FRENO TRASEROS MERCEDES W203 ( HELLA ),1610,5,2,5,12
2105000549,DEPOSITO DE ANTICONGELANTE MERCEDES W210 BMTR,1363,7,8,2,17
2105000549 *1,DEPOSITO DE ANTICONGELANTE MERCEDES W210-M112 FREY,1792,1,2,5,8
2105010515 *4,TAPON DEPOSITO ANTICONGELANTE ENFRIAMIENTO MOTOR MERCEDES (FEBI) SSF,1335,8,8,1,17
2105010615 *1,TAPON DEPOSITO ANTICONGELANTE ENFRIAMIENTO MOTOR MERCEDES W203 (FREY),1888,8,4,4,16
2105013182,MANGUERA DE RADIADOR REIN,1933,7,8,9,24
2106130000 *3,FILTRO ACEITE MOTOR MERCEDES C216 AMG M276-M278 (MAHLE OX116/2D),1340,6,7,0,13
2108300818 *3,FILTRO POLEN AIRE CABINA MERCEDES W202 M111 (MAHLE LAK37),1456,6,0,8,14
2108300818 *5,FILTRO POLEN AIRE CABINA MERCEDES W202-M111 (MAHLE LA37),1441,2,8,5,15
2108300818-1,FILTRO POLEN AIRE CABINA MERCEDES W202-M111 MANN CU2897,1334,7,7,3,17
2108690821 *1,BOMBA AGUA LIMPIAPARABRISAS CHISGUETEROS AUDI BMW MERCEDES SPRINTER PORSCHE (FREY),1972,8,1,2,11
2108691021 *1,BOMBA AGUA LIMPIAPARABRISAS CHISGUETERO MERCEDES W2160 ( FREY ),1606,1,2,5,8
2108800186,EMBLEMA DE COFRE MERCEDES ORIGINAL,1852,2,8,9,19
210902309 *K,JUEGO JUNTAS MOTOR AUDI SEAT VW TFSI 1.8 2.0 2a GEN (EMBLER),1497,8,1,7,16
2110000283,SENSOR DE PRESION DE AIRE ACONDICIONADO MERCEDES W203-W204 DENSO,1285,6,8,7,21
2110000283 *1,SENSOR DE PRESION DE AIRE ACONDICIONADO MERCEDES W203-W204 FREY,1690,3,2,1,6
2112400417 *2,SOPORTE DE MOTOR ( L / R ) MERCEDES W202 / W203 /  M112 / M113 / M272 / M273  ( FEBI ),1859,6,5,8,19
2112400417 *3,SOPORTE DE MOTOR ( L / R ) MERCEDES W202 / W203 / M112 / M113 / M272 / M273  ( CORTECO 80001823 ),1908,7,1,2,10
2112400417 *4,SOPORTE DE MOTOR ( L/R) MERCEDES W202-W203 M112-M113-M272-M273 (LEMFOLDER),1492,5,6,1,12
2112400417 *5,SOPORTE DE MOTOR ( L / R ) MERCEDES W202 / W203 /  M112 / M113 / M272 / M273  ( TOPRAN ),1558,3,1,3,7
2113200026,BASE DE AMORTIGUADOR DELANTERO MERCEDEZ W211 URO,1913,3,1,9,13
2113200026-1,BASE DE AMORTIGUADOR DELANTERO MERCEDEZ W211 VAICO,1337,3,3,8,14
2113200158 *V,BLOQUE VALVULAS AIRE SUSPENSION MERCEDES W211 (EMBLER) TECH,1991,6,9,1,16
2113200725 *B,BOLSA AIRE SUSPENSION TRASERA (L) MERCEDES W211 (EMBLER) TECH,1913,3,2,5,10
2113200825 *B,BOLSA AIRE SUSPENSION TRASERA (R) MERCEDES W211 (EMBLER) TECH,1936,7,9,6,22
2113200989 *1,TORNILLO ESTABILIZADOR SUSPENSIï¿½N DELANTERA (L) MERCEDES W211 W212 (FREY),1722,0,0,2,2
2113205413 *A,AMORTIGUADOR AIRE SUSPENSION DELANTERA (R) MERCEDES W211 (EMBLER) TECH,1884,2,3,6,11
2113205413 *B,BOLSA AIRE SUSPENSION DELANTERA (R) MERCEDES W211 (EMBLER),1335,8,9,0,17
2113205513 *A,AMORTIGUADOR AIRE SUSPENSION DELANTERA (L) MERCEDES W211 (EMBLER) TECH,1808,1,5,4,10
2113230000 *1,AMORTIGUADOR AIRE SUSPENSION DELANTERA (L/R) MERCEDES W211 (FREY),1677,0,3,5,8
2113230068 *1,ROTULA BRAZO SUSPENSION DELANTERA INFERIOR (L/R) MERCEDES W211 (FREY),1945,3,1,7,11
2113239300,AMORTIGUADOR DE SUSPENSION DELANTERA L-R MERCEDES W211 SACHS 312564,1545,9,9,4,22
2113239300 *1,AMORTIGUADOR DE SUSPENSION DELANTERA L-R MERCEDES W211 FREY,1451,5,7,7,19
2113239300 *3,AMORTIGUADOR DE SUSPENSION DELANTERA (L/R) MERCEDES W211 (SACHS 317348),1355,4,2,1,7
2113239300 *A,AMORTIGUADOR DE SUSPENSION DELANTERA (L/R) MERCEDES W211 (EMBLER) TECH,1574,2,9,4,15
2113260900 *1,AMORTIGUADOR SUSPENSION TRASERA (L/R) MERCEDES W211 (FREY),1509,8,8,0,16
2113300335,ROTULA INFERIOR DE SUSPENSION DELANTERA ( L / R ) MERCEDES W202 / W210 / W211 ( DELPHI ),1308,6,5,4,15
2113301511 *1,BRAZO ALUMINIO INFERIOR SUSPENSION DELANTERA (L) MERCEDES W211 (FREY),1806,6,7,8,21
2113301611 *1,BRAZO DE ALUMINIO INFERIOR SUSPENSION DELANTERA ( R ) MERCEDES BENZ W211 FREY,1268,5,2,9,16
2113302703 *1,TERMINAL DIRECCION SIN BIELETA SUSPENSION DELANTERA (L) MERCEDES W211 (FREY),1851,8,6,2,16
2113302803 *1,TERMINAL DIRECCION SIN BIELETA SUSPENSION DELANTERA (R) MERCEDES W211 (FREY),1623,5,8,0,13
2113304311,BRAZO INFERIOR DE SUSPENSION DELANTERA ( L ) MERCEDES W211 FRAP,1922,8,0,4,12
2113304411-6,BRAZO INFERIOR DE SUSPENSION DELANTERA ( R ) MERCEDES W211 VIKA,1626,7,8,3,18
2113305011,BRAZO DE ALUMINIO INFERIOR SUSPENSION DELANTERA ( R ) MERCEDES W211 KARLYN,1941,5,5,9,19
2113308107,BRAZO DE HIERRO INFERIOR DE SUSPENSION DELANTERA ( L ) MERCEDES W211 BMTR,1641,9,5,6,20
2113308107 *1,BRAZO DE SUSPENSION INFERIOR ANTERIOR DELANTERO ( L ) MERCEDES W211 FREY,1490,2,9,2,13
2113308207 *1,BRAZO DE SUSPENSION INFERIOR ANTERIOR DELANTERO ( R ) MERCEDES W211 FREY,1343,6,0,3,9
2113308907 *1,HORQUILLA SUPERIOR SUSPENSION DELANTERA (L) MERCEDES W211 W219 (FREY),1654,4,3,8,15
2113309007 *1,HORQUILLA SUPERIOR SUSPENSION DELANTERA (R ) MERCEDES W211 W219 (FREY),1329,0,9,8,17
2113332914 *1,BUJE DE BRAZO INFERIOR DE SUSPENSION DELANTERA L-R MERCEDES W211 FREY,1421,0,3,4,7
2113400336,SOPORTE DE MOTOR IZQUIERDO BMW E83 / N52N ( BMTSR),1852,0,9,3,12
2113570508 *1,BUJE DE RUEDA ( TRASERO-DELANTERO) MERCEDES BENZ FREY,1496,0,1,5,6
2114100181,SOPORTE CENTRAL DE CARDAN MERCEDES W210 / M112 ( BMTR ),1789,2,2,6,10
2114100181 *1,SOPORTE CENTRAL DE CARDAN MERCEDES W210 / M112 FREY,1336,5,7,3,15
2114230912,DISCO DE FRENOS TRASERO 300X168 MM MERCEDES X204 PAGID,1225,2,6,3,11
2114230912-1,PAR DISCO DE FRENOS TRASERO 300X22 MM. MERCEDES X204 PAGID,1331,1,7,6,14
2114702994,BOMBA DE GASOLINA MERCEDES W211-M272 BMTR,1475,3,6,1,10
2114703994 *1,FILTRO COMBUSTIBLE GASOLINA MERCEDES W211 (FREY),1989,0,9,1,10
2114704194 *1,BOMBA DE GASOLINA MERCEDES W211-M272 FREY,1631,4,8,8,20
2115000049,DEPOSITO DE ANTICONGELANTE MERCEDES W211-M112 BMTR,1638,2,4,9,15
2115000049 *1,DEPOSITO DE ANTICONGELANTE MERCEDES W211-M112 FREY,1802,3,5,8,16
2115000049-2,DEPOSITO DE ANTICONGELANTE MERCEDES W211-M272 BEHR,1871,8,6,3,17
2115000049-3,DEPOSITO DE ANTICONGELANTE MERCEDES W211-M112 TOPRAN,1779,7,4,7,18
2115000049-4,DEPOSITO DE ANTICONGELANTE MERCEDES W211-M112 HELLA,1699,4,6,5,15
2115000049-5,DEPOSITO DE ANTICONGELANTE MERCEDES W211-M112 (EMBLER),1984,2,2,7,11
2115001302 *1,RADIADOR ENFRIAMIENTO MOTOR 640X448 MM MERCEDES W211 M112 (FREY),1863,5,6,5,16
2115001693 *1,MOTOVENTILADOR ENFRIAMIENTO MOTOR 600W MERCEDES W211 W219 (FREY),1915,6,4,1,11
2115001893 *1,MOTOVENTILADOR ENFRIAMIENTO MOTOR 850W MERCEDES C16 W211 W221 (FREY),1875,1,6,1,8
2115003402 *1,RADIADOR ENFRIAMIENTO MOTOR 637X457 MM MERCEDES W211 C219 M112 M113 M272 (FREY),1837,9,2,3,14
2115010125 *1,MANGUERA RADIADOR MERCEDES W211 (FREY),1469,6,1,5,12
2115010625 *1,MANGUERA VENTILACION DEPOSITO ANTICONGELANTE MERCEDES  W211 M112 M272 (FREY),1368,0,5,3,8
2115010625-2,MANGUERA DE VENTILACION DE DEPOSITO DE ANTICONGELANTE MERCEDES  W211 MEISTERSATZ,1272,3,7,3,13
2115010682,MANGUERA INFERIOR DE RADIADOR MERCEDES  W211-M113 GENUINA,1441,0,0,5,5
2115010682 *1,MANGUERA INFERIOR DE RADIADOR MERCEDES  W211-M113 FREY,1964,0,9,2,11
2115401717 *1,SENSOR BALATAS FRENOS TRASERO (L/R) 0.94 MM MERCEDES W166 W203 W211 W220 W245 X166 (FREY),1843,7,7,7,21
2115401717-100,SENSOR DE BALATAS DE FRENOS DELANTERO - TRASERO MERCEDES W204  FREY INACTIVO,1442,1,6,5,12
2115401717-102,SENSOR BALATAS FRENOS TRASERO (L/R) MERCEDES W166 W203 W211 W220 W245 X166 INACTIVO,1684,6,1,2,9
2115402917,SENSOR DE FRENOS ABS DELANTERO MERCEDES W211 ( BMTR ),1910,7,4,1,12
2115402917 *1,SENSOR BALATAS FRENOS DELANTERO (L/R) 760 MM MERCEDES W211 (FREY),1838,1,7,9,17
2115402917-2,SENSOR DE FRENOS ABS DELANTERO MERCEDES W211 TOPRAN,1877,6,9,5,20
2115403017,SENSOR DE FRENOS ABS TRASERO MERCEDES W211 ( BMTR ),1484,5,3,9,17
2115403017 *1,SENSOR DE FRENOS ABS TRASERO MERCEDES W211 FREY,1291,9,4,9,22
2118300018 *1,FILTRO POLEN AIRE CABINA MERCEDES W211 (FREY),1357,0,2,3,5
2118300018 *3,FILTRO POLEN AIRE CABINA MERCEDES W211 (MAHLE LA156),1288,1,8,3,12
2118350264 *1,BOMBA AGUA AUXILIAR ELECTRICA ENFRIAMIENTO MOTOR MERCEDES  X164 W164 W166 W211 W251 W463 (FREY),1620,5,6,8,19
2119810227,BALERO TRASERO DE MERCEDES BENZ W204 BENDIX,1486,3,4,5,12
2119810227 *1,BALERO TRASERO DE MERCEDES BENZ W204 FREY,1776,8,1,2,11
21207531556 *1,CLUTCH PLATO DISCO Y COLLARIN BMW E46-M54 FREY,1911,4,1,8,13
21207531556-9,CLUTCH PLATO DISCO Y COLLARIN BMW E46-M54 (LUK),1701,7,3,7,17
21207531843,CLUTCH PLATO DISCO Y COLLARIN BMW E46-M54 LUK,1850,5,5,1,11
21207531843 *1,CLUTCH PLATO DISCO Y COLLARIN BMW E46-M54 ( FREY ),1848,2,0,8,10
21207551383 *1,KIT 3 PZ. CLUTCH PLATO DISCO 215 MM COLLARIN MINI R50  R53 W11 W17 TURBO (FREY),1986,0,1,2,3
21207551383 *5,KIT 3 PZ. CLUTCH PLATO DISCO 215 MM COLLARIN MINI R53 W11 TURBO (LUK) SSF,1271,8,0,3,11
21207551384 *1,KIT 3 PZ. CLUTCH PLATO DISCO 215 MM COLLARIN MINI R52  R53 W11 TURBO (FREY),1444,2,9,3,14
21207551384 *2,KIT 3 PZ. CLUTCH PLATO DISCO 215 MM COLLARIN MINI R53 W11 TURBO (EMBLER) NIT,1302,5,8,1,14
21207561754,CLUTCH MINI R50-W10 VALEO 826583,1309,0,3,8,11
21207561754 *1,KIT 3 PZ. CLUTCH PLATO DISCO 200 MM COLLARIN MINI R50 R52 W10 (FREY),1288,0,7,4,11
21207572842 *1,KIT 3 PZ. CLUTCH PLATO DISCO 200MM COLLARIN MINI R55 R56 R57 N12 R55 LCI A R57 LCI N16 R59 A R61 N16 (FREY),1311,4,9,7,20
21207572842 *5,KIT 3 PZ. CLUTCH PLATO DISCO 200MM COLLARIN MINI R55 R56 R57 N12 R55 LCI A R57 LCI N16 R59 A R61 N16 (LUK) SSF,1501,8,2,0,10
21207572842 *6,KIT 3 PZ. CLUTCH PLATO DISCO 200MM COLLARIN MINI R55 R56 R57 N12 R55 LCI A R57 LCI N16 R59 A R61 N16 (VALEO) SSF,1739,3,4,6,13
21207572842-100,KIT 3 PZ. CLUTCH PLATO DISCO 200MM COLLARIN MINI R55 R56 R57 N12 R55 LCI A R57 LCI N16 R59 A R6 INACTIVO,1407,4,6,8,18
21207576519 *1,CLUTCH PLATO DISCO Y COLLARIN BMW E87-N46N (FREY),1427,0,1,8,9
21207576519 *5,KIT 3 PZ. CLUTCH PLATO DISCO 228 MM COLLARIN BMW E87 N46N (SACHS),1674,7,4,2,13
21207587368 *5,KIT 4 PZ. CLUTCH PLATO DISCO 228 MM COLLARIN HORQUILLA BMW E85 E89 E90 N52N (LUK) SSF,1873,1,1,7,9
21208606067 *1,KIT 3 PZ. CLUTCH PLATO DISCO 235 MM COLLARIN MINI JCW R55 A R61 N16 N18 (FREY),1736,9,2,9,20
21208606067 *5,KIT 3 PZ. CLUTCH PLATO DISCO 235 MM COLLARIN MINI JCW R55 A R61 N16 N18 (VALEO) SSF,1896,7,6,5,18
21208607915 *1,KIT 3 PZ CLUTCH PLATO DISCO 228 MM COLLARIN MINI JCW R55 A R59 N14 TURBO (FREY),1968,1,6,9,16
21208607915 *2,KIT CLUTCH MINI MOTOR N14 TURBO 228 MM x 28 DIENTES (MECARM 10192),1387,6,7,8,21
21208607915 *5,KIT 3 PZ CLUTCH PLATO DISCO 228 MM COLLARIN MINI JCW R55 A R59 N14 TURBO (VALEO) SSF,1500,9,8,3,20
21208607915 *9,KIT 3 PZ CLUTCH PLATO DISCO 228 MM COLLARIN MINI JCW R55 A R59 N14 TURBO (ISU ITALY),1363,6,7,4,17
21208631873,CLUTCH PLATO DISCO COLLARIN MINI F56 GENUINO,1959,8,5,1,14
21208631873 *1,KIT 2 PZ CLUTCH PLATO DISCO 240 MM MINI F45 F46 F48 F54 F55 F56 F57 B37 B46 B48 (FREY),1363,0,4,4,8
21208676275 *1,KIT 3 PZ. CLUTCH PLATO DISCO 215MM COLLARIN MINI F55 F56 F57 B36 B38 (FREY),1820,6,1,2,9
21208676275 *5,KIT 3 PZ. CLUTCH PLATO DISCO 215MM COLLARIN MINI F55 F56 F57 B36 B38 (LUK) SSF,1221,1,4,0,5
21208676279 *2,KIT 3 PZ CLUTCH PLATO DISCO 240 MM COLLARIN BMW B46 MINI B37 B38 B48 (LUK),1224,5,3,8,16
21211223571,KIT DE CLUTCH BMW E36-Z3 SACHS 215 MM,1912,7,7,3,17
21211223571 *1,KIT DE CLUTCH BMW E36-Z3 FREY 215 MM,1819,4,2,7,13
21211223602 *2,KIT 3 PZ CLUTCH PLATO DISCO 240MM COLLARIN BMW E36 Z3 (EMBLER),1331,6,6,5,17
21211223602 *5,KIT 3 PZ CLUTCH PLATO DISCO 240MM COLLARIN BMW E36 Z3 (SACHS) SSF,1585,2,2,4,8
21217523620,CLUTCH PLATO DISCO Y COLLARIN BMW E46-M54 VALEO 821313,1627,9,4,1,14
21217523620 *1,CLUTCH PLATO DISCO Y COLLARIN BMW E46-M54 FREY 821313,1888,9,1,8,18
21217523622,CLUTCH PLATO DISCO Y COLLARIN BMW E46-M54  (LUK ),1253,1,1,8,10
21217523622-1,CLUTCH PLATO DISCO Y COLLARIN BMW E46-M54  (FREY ),1481,5,3,1,9
21217534150 *1,KIT 3 PZ. CLUTCH PLATO DISCO 200MM COLLARIN MINI COOPER R50 W10 NO TURBO (FREY),1547,8,9,1,18
21217534150 *5 ,KIT 3 PZ. CLUTCH PLATO DISCO 200MM COLLARIN MINI COOPER R50 W10 NO TURBO (VALEO) SSF,1458,0,9,5,14
21217534150 *6,KIT 3 PZ. CLUTCH PLATO DISCO 200MM COLLARIN MINI COOPER R50 W10 NO TURBO (LUK) SSF,1352,6,5,4,15
21217534150 *9,KIT 3 PZ. CLUTCH PLATO DISCO 200MM COLLARIN MINI COOPER R50 W10 NO TURBO (MECAR),1941,0,3,6,9
21217534150-100,CLUTCH DE MINI COOPER R50-W10 ASPIRACION NATURAL INACTIVO,1602,4,6,6,16
2122400418 *1,SOPORTE TRANSMISION MERCEDES W202 W203 W204 W210 W212 W211 X204 W463 (FREY),1840,4,1,7,12
2122400418-100,SOPORTE DE TRANSMISION MERCEDES W203-M271 CORTECO INACTIVO,1722,9,9,2,20
2122406317 *1,SOPORTE MOTOR HIDRAULICO (L) MERCEDES 212 M274 (FREY),1812,0,2,3,5
2122406417 *1,SOPORTE MOTOR HIDRAULICO (R) MERCEDES W212 M274 (FREY),1956,0,2,1,3
2122407217 *1,SOPORTE MOTOR (L/R) MERCEDES W212 W222 (FREY),1791,9,0,8,17
2123200104 *C,COMPRESOR AIRE SUSPENSION MERCEDES W212 (EMBLER) TECH,1858,5,7,2,14
2123200325 *B,BOLSA AIRE SUSPENSION TRASERA (L) MERCEDES W212 (EMBLER) TECH,1372,7,9,6,22
2123200358 *V,BLOQUE VALVULAS AIRE SUSPENSION MERCEDES W164 (EMBLER) TECH,1783,6,3,9,18
2123200625 *B,BOLSA AIRE SUSPENSION TRASERA (R) MERCEDES W212 (EMBLER) TECH,1910,0,5,3,8
2123200813 *A,AMORTIGUADOR AIRE ADS SUSPENSION DELANTERA SIN AMG (R) MERCEDES W212 (EMBLER) TECH,1899,5,8,7,20
2123200913 *A,AMORTIGUADOR AIRE ADS SUSPENSION DELANTERA SIN AMG (L) MERCEDES W212 (EMBLER) TECH,1902,9,3,7,19
2123201189 *1,TORNILLO BARRA ESTABILIZADORA DELANTERA (L) MERCEDES W212 (FREY),1687,4,8,9,21
2123201189-2,TORNILLO DE BARRA ESTABILIZADORA DELANTERA L MERCEDES W212-M272 TOPRAN,1803,6,1,6,13
2123201189-5,TORNILLO DE BARRA ESTABILIZADORA DELANTERA L MERCEDES W212-M272 LEMFOERDER,1417,3,9,4,16
2123201289,TORNILLO DE BARRA ESTABILIZADORA DELANTERA R MERCEDES W212-M272 LEMFOERDER,1907,0,9,7,16
2123201289 *1,TORNILLO DE BARRA ESTABILIZADORA DELANTERA R MERCEDES W212-M272 FREY,1693,7,6,1,14
2123201289-1,TORNILLO DE BARRA ESTABILIZADORA DELANTERA R MERCEDES W212-M272 BENDIX,1419,2,3,8,13
2123204630 *1,AMORTIGUADOR SUSPENSION TRASERA (L/R) MERCEDES W212 (FREY),1687,8,0,4,12
2123230020,BASE DE AMORTIGUADOR DELANTERO L-R MERCEDES W212 VAICO,1477,1,4,9,14
2123230020 *1,BASE AMORTIGUADOR SUSPENSION DELANTERA (L/R) MERCEDES W212 (FREY),1450,8,6,2,16
2123231300 *1,AMORTIGUADOR SUSPENSION DELANTERA (L/R ) MERCEDES W212 (FREY),1722,7,6,7,20
2123235300-1,AMORTIGUADOR SUSPENSION DELANTERA (L/R) MERCEDES W212 (SACHS),1381,7,1,0,8
2123300025 *1,BALERO MASA DELANTERO (L/R)  MERCEDES W212 (FREY),1954,9,4,0,13
2123302203 *1,TERMINAL DIRECCION SIN BIELETA SUSPENSION DELANTERA (R) MERCEDES W212 W218 (FREY),1478,3,9,5,17
2123302303 *1,TERMINAL DIRECCION SIN BIELETA SUSPENSION DELANTERA (L) MERCEDES W212 W218 (FREY),1458,5,8,7,20
2123302803 *1,BIELETA DIRECCION SIN TERMINAL SUSPENSION DELANTERA (L/R) MERCEDES W212 W218 W222 (FREY),1492,8,1,6,15
2123302811,BRAZO SUPERIOR (R) MERCEDES BENZ W212 BEMQW,1800,9,5,5,19
2123302911 *1,BRAZO DE CONTROL SUSPENSION DELANTERA (L) MERCEDES W212 (FREY),1244,7,5,8,20
2123303011 *1,BRAZO DE CONTROL SUSPENSION DELANTERA (R) MERCEDES W212 (FREY),1381,7,2,1,10
2123330014,BUJE DELANTERO MOTOR MERCEDES BENZ W212 URO,1232,3,1,2,6
2124211312,DISCO FRENOS DELANTEROS 295 MM MERCEDES W204 ( PAGID 355123701 ),1259,6,0,2,8
2124211312 *1,DISCO FRENOS DELANTEROS VENTILADO (L/R) 295 MM MERCEDES W204 W212 R172 (FREY),1925,6,2,2,10
2124211312-1,DISCO DE FRENOS DELANTEROS 295 MM MERCEDES W204 ( PAGID HELLA ),1893,3,5,3,11
2124701794,BOMBA DE GASOLINA MERCEDES W212 BMTR,1330,0,5,3,8
2125015782 *1,MANGUERA DE RADIADOR MERCEDES W212 FREY,1579,5,5,8,18
2127400045 *1,AMORTIGUADOR CAJUELA 580 NEWTONS 479 MM (L/R) MERCEDES BENZ W212 (FREY),1773,4,1,4,9
2128300318 *3,FILTRO POLEN AIRE CABINA MERCEDES W204 (MAHLE LAK413),1636,2,5,2,9
2128300318 *5,FILTRO POLEN AIRE CABINA CON CARBON ACTIVADO MERCEDES W204 X204 W212 W218 (MANN) SSF,1457,3,4,8,15
2128300318-100,FILTRO DE AIRE DE CABINA SIN CARBON MERCEDES W204 CORTECO INACTIVO,1858,2,7,5,14
2128300318B,FILTRO POLEN AIRE CABINA CON CARBON ACTIVADO MERCEDES W204 X204 W212 W218 (FREY),1659,9,4,8,21
2129003408,MODULO DE BOMBA DE GASOLINA MERCEDES W204  ( GENUINO ),1794,7,1,3,11
2129003408 *1,MODULO DE BOMBA DE GASOLINA MERCEDES W204 FREY,1593,9,4,0,13
2129050200 *1,SENSOR ABS FRENOS DELANTEROS (L) MERCEDES W212 (FREY),1503,9,3,0,12
2129050300,SENSOR DE FRENOS ABS DELANTERO ( R ) MERCEDES W212 ( BMTR ),1698,0,5,0,5
2129050300 *1,SENSOR FRENOS ABS DELANTERO (R) MERCEDES W212 (FREY),1533,5,9,6,20
2129050400 *1,SENSOR FRENOS ABS TRASERO MERCEDES W212 (FREY),1858,1,6,1,8
2129052002 *1 ,SENSOR FRENOS ABS DELANTERO (R ) MERCEDES W212 (FREY),1386,7,7,1,15
2129053603 *1,SENSOR FRENOS ABS TARSERO (L/R) MERCEDES W212 (FREY),1286,5,1,0,6
2129800564 *1,AMORTIGUADOR CAJUELA 290 NEWTONS 649 MM (L/R) MERCEDES BENZ W204 (FREY),1415,0,1,2,3
21300-JA06A,ENFRIADOR DE ACEITE DE MOTOR NISSAN ALTIMA 2.5L BMTRS,1425,6,5,5,16
21300-JA06A-1,ENFRIADOR DE ACEITE DE MOTOR NISSAN ALTIMA 2.5L CON FILTRO BMTRS,1556,5,6,9,20
21300JA06A,ENFRIADOR DE ACEITE DE MOTOR SENTRA 2.5L 2007 A 2013 TAIFA,1309,8,6,6,20
21305-5M301,ENFRIADOR DE ACEITE DE MOTOR NISSAN NP300 BMTRS,1617,4,2,2,8
2133200125 *1,BOLSA AIRE CON SENSOR SUSPENSION TRASERA (L) MERCEDES C238 C257 W213 W253 W257 X290 (FREY),1554,8,4,6,18
2133200125 *B,BOLSA AIRE CON SENSOR SUSPENSION TRASERA (L) MERCEDES C238 C257 W213 W253 W257 X290 (EMBLER) TECH,1726,1,2,4,7
2133200830 *1,AMORTIGUADOR AIRE SUSPENSION TRASERA (L/R) MERCEDES W176 W246 X156 (FREY),1446,0,8,3,11
2133202301 *A,AMORTIGUADOR AIRE SUSPENSION DELANTERA (L) MERCEDES AMG W213 X253 X290 (EMBLER) TECH,1264,7,4,8,19
2133203530 *5,AMORTIGUADOR AIRE SUSPENSION DELANTERA (L/R) MERCEDES W213 (BILSTEIN) SSF,1570,7,4,1,12
21430320 *5,DEPOSITO ANTICONGELANTE VOLVO S60 S80 V60 V70 XC60 LAND ROVER LR2 (PRO PARTS) SSF,1412,6,3,3,12
21432211 *5,SEPARADOR ACEITE MOTOR PCV VOLVO S60 S80 C70 V70 XC70 XC90 2.5 L 5 CIL (PRO PARTS) SSF,1905,2,8,7,17
21432683 *5,VALVULA SOLENOIDE VARIADOR ARBOL LEVAS SISTEMA VVT VOLVO S40 V40 1.9 L 4 CIL (PRO PARTS) SSF,1228,6,9,0,15
21433344 *5,CODO MANGUERA VENTILACION GASES MOTOR PCV VOLVO C30 C70 S40 S60 V50 V60 XC60 2.5 L 5 CIL (PRO PARTS) SSF,1357,6,8,1,15
21437026 *5,BAYONETA NIVEL ACEITE MOTOR VOLVO S40 V40 1.9 L 4 CIL (PRO PARTS) SSF,1355,0,7,1,8
21439642 *5 ,SEPARADOR ACEITE MOTOR VALVULA PCV VOLVO S80 V70 XC60 XC70 XC90  LAND ROVER LR2 (PRO PARTS) SSF,1722,4,7,4,15
21516777428 *5,CILINDRO DE CLUTCH ESCLAVO MINI COOPER R50 R52 R53 W10 W11 (FTE) SSF,1560,1,8,1,10
21516777428-100,CILINDRO DE CLUTCH ESCLAVO MINI COOPER R50-W10 FEBI INACTIVO,1430,0,7,5,12
21521159045,CILINDRO ESCLAVO BMW Z3  E36 TOPRAN,1831,0,0,4,4
21521159045 *3,CILINDRO ESCLAVO BMW E36 (OSSCA),1554,2,8,3,13
21526758829 *3,CILINDRO ENTRADA CLUTCH BMW E36 Z3 (TOPRAN),1930,2,7,9,18
21526758829B,BOMBA CLUTCH CILINDRO MAESTRO BMW E36 (FREY),1876,4,8,6,18
21526758829B-100,BOMBA CLUTCH CILINDRO MAESTRO BMW E36 INACTIVO,1892,7,4,9,20
21526758830,CILINDRO MAESTRO DE FRENOS BMW E36 AFTERMARKET,1956,6,4,9,19
21526774078 *5,BOMBA CLUTCH CILINDRO MAESTRO MINI R50 R52 R53 R55 R56 R57 R58 R59 R60 R61 (SACHS) SSF,1743,9,9,3,21
21526774078-100,CILINDRO DE CLUTCH MAESTRO ( PEDAL) MINI R56 TECNODELTA INACTIVO,1510,3,8,5,16
21526775924,CILINDRO DE CLUTCH BMW E39,1559,3,7,7,17
21526775924 *1,CILINDRO DE CLUTCH BMW E39 FREY,1318,8,4,5,17
21526785966,CILINDRO DE CLUTCH ESCLAVO BMW E46-M54 SACHS,1323,3,9,4,16
21526785966 *1,CILINDRO DE CLUTCH ESCLAVO BMW E46-M54 FREY,1804,1,1,6,8
21526798372,CILINDRO DE CLUTCH MAESTRO MINI COOPER R56 FTE,1208,8,2,2,12
21526798372 *5,BOMBA CLUTCH CILINDRO MAESTRO MINI R55 R56 R57 R58 R59 R60 R61 (TECNODELTA) SSF,1322,7,0,3,10
215448100,KIT DE VALVULA DE VENTILACION DE CARTER JETTA 2.5L FEBI,1970,4,1,2,7
21606-1XF0A,ENFRIADOR DE ACEITE DE TRANSMISION AUTOMATICA NISSAN SENTRA BMT,1936,6,4,1,11
2162400017 *1,SOPORTE DE MOTOR (L/R) MERCEDES W221 (FREY),1313,5,6,3,14
21652863,FILTRO POLEN AIRE CABINA MERCEDES W211- M72 CORTECO,1297,8,2,3,13
2183200130 *2,AMORTIGUADOR AIRE SUSPENSION TRASERA (L) MERCEDES W212 W218 (EMBLER),1459,7,5,3,15
2183200230 *2,AMORTIGUADOR AIRE SUSPENSION TRASERA (R) MERCEDES W212 W218 (EMBLER),1900,9,4,5,18
2183206513 *2,AMORTIGUADOR AIRE SUSPENSION DELANTERA (L) MERCEDES W218 (EMBLER),1546,1,7,9,17
2183206613 *2,AMORTIGUADOR AIRE SUSPENSION DELANTERA (R) MERCEDES W218 (EMBLER),1934,6,0,7,13
2184700094 *5,BOMBA GASOLINA ELECTRICA (R) MERCEDES X204 W212 C218 C204 (URO) SSF,1202,0,4,3,7
22-100,SENSOR  INACTIVO,1983,9,5,8,22
22-141705 *2,AMORTIGUADOR SUSPENSION DELANTERA (L/R) MERCEDES W203 SEDAN (BILSTEIN),1773,6,3,1,10
22-183750 *5,AMORTIGUADOR SUSPENSION DELANTERA (L/R) AUDI Q3 VW TIGUAN (BILSTEIN) SSF,1794,9,0,3,12
2202403317 *1,SOPORTE  MOTOR (L/R) MERCEDES W211 W220 W221 (FREY),1433,0,9,1,10
2202710380 *1,JUNTA CARTER TRANSMISION AUTOMATICA 722.9 MERCEDES W203 W204 W211 W212 W222 (FREY),1613,8,7,0,15
2202710380 *J,JUNTA CARTER PARA FITRO RECTAGULAR TRANSMISION MERCEDES 722.9 (ELRING),1683,9,6,8,23
2203200104 *C,COMPRESOR AIRE SUSPENSION MERCEDES W220 W211 (EMBLER) TECH,1299,5,7,3,15
2203202438 *A,AMORTIGUADOR AIRE SUSPENSION DELANTERA (L/R) MERCEDES W220 (EMBLER) TECH,1578,9,6,8,23
2203202438 *B,BOLSA AIRE SUSPENSION DELANTERA (L/R) MERCEDES W220 (EMBLER) TECH,1735,5,7,3,15
2203202438 *K,KIT CONVERSION SUSPESION AIRE A RESORTES MERCEDES W220 (EMBLER),1482,1,8,2,11
2203205013 *A,AMORTIGUADOR AIRE SUSPENSION TRASERO (L/R) MERCEDES W220 (EMBLER) TECH,1284,5,8,8,21
2203301407 *1,HORQUILLA SUPERIOR SUSPENSION DELANTERA (L) MERCEDES W220 C215  ( FREY ),1811,4,7,4,15
2203301507 *1,HORQUILLA SUPERIOR SUSPENSION DELANTERA (R) MERCEDES W220 C215 (FREY),1240,3,0,1,4
2203304311 *1,BRAZO INFERIOR DE SUSPENSION DELANTERA L MERCEDES W220 FREY,1784,0,1,5,6
2203304411 *1,BRAZO INFERIOR DE SUSPENSION DELANTERO R MERCEDES W220 FREY,1966,5,4,3,12
2203305711,BRAZO INFERIOR DE SUSPENSION DELANTERO L MERCEDES W220 DELPHI,1676,6,9,4,19
2203305811,BRAZO INFERIOR DE SUSPENSION DELANTERO R MERCEDES W220 DELPHI,1413,4,8,2,14
2203308907,BRAZO INFERIOR DE SUSPENSION DELANTERO L MERCEDES W220-M113 DELPHI,1335,0,1,0,1
2203308907 *1,BRAZO INFERIOR DE SUSPENSION DELANTERO L MERCEDES W220-M113 FREY,1996,8,3,3,14
2203309007,BRAZO INFERIOR DE SUSPENSION DELANTERO R MERCEDES W220-M113 DELPHI,1859,9,3,0,12
2203309007 *1,BRAZO INFERIOR SUSPENSION DELANTERA (R) MERCEDES W220 (FREY),1885,3,4,9,16
2203330327,ROTULA DE SUSPENSION DELANTERA INFERIOR EXTERIOR L-R MERCEDES W211 BMTR,1248,9,8,9,26
2203330327 *1,ROTULA DE SUSPENSION DELANTERA INFERIOR EXTERIOR L-R MERCEDES W211 FREY,1703,0,0,8,8
2203381315,TERMINAL DIRECCION SIN BIELETA SUSPENSION DELANTERA (L) MERCEDES W220-M112 (DELPHI),1867,2,9,7,18
2203381315 *1,TERMINAL DIRECCION SIN BIELETA SUSPENSION DELANTERA (L) MERCEDES W220-M112 (FREY),1479,4,5,9,18
2203381415,TERMINAL DIRECCION SIN BIELETA SUSPENSION DELANTERA (R) MERCEDES W220-M112 (DELPHI),1216,2,1,7,10
2203381415 *1,TERMINAL DIRECCION SIN BIELETA SUSPENSION DELANTERA (R) MERCEDES W220-M112 (FREY),1377,4,6,9,19
2203520227 *1,BUJE ROTULA BRAZO INFERIOR SUSPENSION TRASERA (L/R) MERCEDES X204 W202 W220 W212 (FREY),1975,7,7,0,14
2203520227-100,BUJE DE BRAZO INFERIOR DE SUSPENSION TRASERA INACTIVO,1275,9,3,6,18
2205000049,DEPOSITO DE ANTICONGELANTE MERCEDES W220 BMTR,1267,1,9,7,17
2205000049 *1,DEPOSITO DE ANTICONGELANTE MERCEDES W220 FREY,1277,8,4,9,21
2205000093 *1,MOTOVENTILADOR ENFRIAMIENTO MOTOR MERCEDES C15 W220 M113 (FREY),1972,8,5,5,18
2205000903,RADIADOR DE MOTOR MERCEDES W220 / M112 ( BMTRS ),1774,3,4,3,10
2205000903 *1,RADIADOR DE MOTOR MERCEDES W220 / M112 FREY,1245,3,5,4,12
2205010082,MANGUERA SUPERIOR DE RADIADOR MERCEDES W220 ( BMTR ),1886,8,0,3,11
2205010082 *1,MANGUERA SUPERIOR DE RADIADOR MERCEDES W220 FREY,1884,6,4,6,16
2205010182,MANGUERA DE AGUA MERCEDES W220 (FREY,1397,3,1,0,4
2205010382,MANGUERA INFERIOR DE RADIADOR MERCEDES W220 BMTR,1348,2,3,4,9
2205010382 *1,MANGUERA INFERIOR DE RADIADOR MERCEDES W220 FREY,1842,3,4,8,15
2205400117,SENSOR DE FRENOS ABS DELANTERO MERCEDES W215-W220 BMTR,1273,1,5,6,12
2205400117 *1,SENSOR DE FRENOS ABS DELANTERO MERCEDES W215-W220 FREY,1527,5,9,8,22
2205400417,SENSOR DE FRENOS ABS TRASERO L MERCEDES W215-W220 BMTR,1655,4,9,3,16
2205400417 *1,SENSOR DE FRENOS ABS TRASERO L MERCEDES W215-W220 FREY,1847,1,9,7,17
2205400517,SENSOR DE FRENOS ABS TRASERO R MERCEDES W215-W220 BMTR,1206,4,0,0,4
2205400517 *1,SENSOR FRENOS ABS TRASERO (R)  MERCEDES W215 W220 (FREY),1486,3,8,8,19
2205400617-101,SENSOR BALATAS FRENOS DELANTERO TRASERO (L/R) MERCEDES C190 W166 W204 W220 W245 INACTIVO,1900,2,5,8,15
2205401117,SENSOR DE FRENOS ABS DELANTERO ( L / R )  MERCEDES W215 / W220 ( BMTR ),1522,2,7,6,15
2205401117 *1,SENSOR DE FRENOS ABS DELANTERO ( L / R )  MERCEDES W215 / W220 FREY,1664,9,8,7,24
2205401517-100,SENSOR DE BALATAS DE FRENOS DELANTERO-TRASERO MERCEDES W164 TOPRAN INACTIVO,1902,5,7,7,19
2207500136 *1,AMORTIGUADOR CAJUELA 295 NEWTONS 397 MM (L/R) MERCEDES BENZ W220 (FREY),1602,7,6,5,18
22090 *5 ,1 LITRO ACEITE FLUIDO DIFERENCIAL VISCOSIDAD SAE 75W-90 (LIQUI MOLY) SSF,1345,6,5,1,12
220950001,JUNTA DE TAPA DE PUNTERIAS MERCEDES W203 VICTOR REINZ,1863,6,9,2,17
220950001-1,JUNTA DE TAPA DE PUNTERIAS MERCEDES W203 MAHLE,1768,3,8,3,14
22111094694 *1,BRAZO ALUMINIO PARA SOPORTE MOTOR (R) BMW M54 (FREY),1896,5,6,5,16
22111094697 *1,BRAZO ALUMINIO PARA SOPORTE MOTOR (L) BMW M54 (FREY),1428,6,2,2,10
22111097267 *1,SOPORTE MOTOR (L/R) BMW E39 (FREY),1555,2,7,9,18
2211195444-100,SOPORTE DE MOTOR ( R / L ) BMW E46 INACTIVO,1491,5,2,6,13
22113400336-9,SOPORTE MOTOR DERECHO BMW E83 N52N (BMTSR),1475,4,9,3,16
22113415176,SOPORTE DE MOTOR ( L ) BMW E83 / N52N ( SEMINUEVO ORIGINAL ),1989,8,0,2,10
22113415176 *1,SOPORTE MOTOR (L) BMW E83 N52N (FREY),1514,6,4,7,17
22113415176-2,SOPORTE DE MOTOR ( L ) BMW E83 / N52N KZR GERMANY,1717,2,9,3,14
22113421295 *1,SOPORTE MOTOR (L) BMW E83 M54 2003 A 2006 (FREY),1244,8,7,7,22
22113421296,SOPORTE DE MOTOR DERECHO BMW E83 / N52N ( BMTR ),1664,3,8,9,20
22113421296 *1,SOPORTE MOTOR DERECHO BMW E83 N52N (FREY),1932,0,0,5,5
22113421296-1,SOPORTE DE MOTOR DERECHO BMW E83 / N52N ( CORTECO ),1765,2,3,0,5
22113421296-3,SOPORTE DE MOTOR DERECHO BMW E83 / N52N ( LEMFORDER ),1994,3,1,5,9
22116754608-1,SOPORTE DE MOTOR L-R BMW E39 FEBI,1501,1,3,0,4
22116756405 *1,SOPORTE MOTOR TRASERO (R) MINI R50 W10 R53 W11 (FREY),1416,5,5,9,19
22116756406 *1,SOPORTE INFERIOR TRASERO MOTOR MINI R50 W10 R53 W11 (FREY),1235,9,7,5,21
22116756406-1,SOPORTE PENDULAR DE MOTOR MINI R50-R52-R53 HUTCHINSON,1615,0,8,5,13
22116756406-2,SOPORTE PENDULAR DE MOTOR MINI R50-R52-R53 REIN,1223,1,9,6,16
22116758430,SOPORTE DE MOTOR L-R BMW E53-M54 BMTR,1430,4,5,8,17
22116760330 *1,SOPORTE MOTOR (L/R) BMW E87 E90 N46N N52N (FREY),1656,3,5,1,9
22116760330 *2,SOPORTE MOTOR (L/R) BMW E90 N52N (CORTECO),1507,8,8,0,16
22116760448,SOPORTE DE MOTOR FRONTAL MINI R53 / W11 ( FRENDO ),1224,1,1,0,2
22116761089,SOPORTE DE MOTOR LADO L BMW E60-N52 BMTR,1351,2,2,0,4
22116761089 *1,SOPORTE MOTOR LADO (L) BMW E60 N52 (FREY),1552,0,1,4,5
22116761090,SOPORTE DE MOTOR LADO R BMW E60-N52 BMTR,1762,2,9,6,17
22116761090 *1,SOPORTE MOTOR LADO (R) BMW E60 N52 (FREY),1898,9,9,4,22
22116769185 *1,Motor Montaje izquierda FREY,1916,0,5,1,6
22116769186 *1,montaje del motor derecho FREY,1964,5,3,9,17
22116770793,SOPORTE DE MOTOR L-R BMW E53 M62-N62 BMTRS,1806,5,9,1,15
22116770793 *1,SOPORTE MOTOR (L/R) BMW E53 M62 N62 (FREY),1326,2,6,1,9
22116770793-1,SOPORTE DE MOTOR L-R BMW E53 M62-N62 CORTECO,1828,9,3,6,18
22116770794 *1,SOPORTE MOTOR (L/R) BMW E53 M54 (FREY),1716,7,4,6,17
22116777365 *1,SOPORTE MOTOR (L) BMW F01 N52N N54 F06 N55 F10 N52N N55 (FREY),1564,2,2,7,11
22116778610 *1,SOPORTE MOTOR MINI R50  R52 R53 FREY,1989,0,2,0,2
22116778610 *5,SOPORTE MOTOR MINI COOPER R50 W10 R52 R53 W10 W11 (CORTECO),1878,9,2,5,16
22116778645,SOPORTE DE MOTOR ( R ) MINI R56 / N12 ( FEBI ),1435,7,0,5,12
22116778645 *1,SOPORTE DE MOTOR ( R ) MINI R56 / N12 ( FREY ),1844,3,9,1,13
2211677997-100,SOPORTE DE MOTOR BMW E36 E46 INACTIVO,1672,2,6,1,9
22116780653,SOPORTE DE MOTOR L-R BMW E71 N63 EMBLER,1679,3,3,4,10
22116780653 *1,SOPORTOR MOTOR (L/R) BMW E70 E71 E72 F15 F16 N63 (FREY),1824,0,5,0,5
22116782374 *1,SOPORTE MOTOR SUPERIOR (R) MINI R55 R56 R57 R58 R59 R60 R61 N14 N16 N18 (FREY),1854,6,0,8,14
22116782374 *5,SOPORTE MOTOR SUPERIOR (R) MINI R55 R56 R57 R58 R59 R60 R61 N14 N16 N18 (LEMFFORDER) SFF,1415,5,9,5,19
22116783094 *1,SOPORTE MOTOR SUPERIOR (L) MINI N12 N14 N16 N18 (FREY),1816,3,6,5,14
22116783094 *5,SOPORTE MOTOR SUPERIOR (L) MINI N12 N14 N16 N18 (URO) SSF,1705,8,7,8,23
22116783094 *9,SOPORTE MOTOR SUPERIOR (L) MINI N12 N14 N16 N18 (FEBI) SSF,1427,4,8,8,20
22116785711 *1,SOPORTE MOTOR (L) BMW F25 F26 N52N N55 (FREY),1700,4,1,3,8
22116785711 *3,SOPORTE DE MOTOR ( L ) BMW F25-F26 N52N N55 (CORTECO),1548,9,1,1,11
22116785712 *1,SOPORTE MOTOR (R) BMW F25 F26 N52N (FREY),1841,2,5,3,10
22116785712 *5,SOPORTE MOTOR (R) BMW F25 F26 N52N (CORTECO) SSF,1456,4,2,5,11
22116786292 *1,SOPORTE DE MOTOR BMW N52 (FREY),1803,0,1,8,9
22116786528,SOPORTE DE MOTOR (R) BMW F10 CORTECO,1923,1,2,0,3
22116786528 *1,SOPORTE MOTOR (R) BMW F01 F06 F10 N55 (FREY),1963,0,3,3,6
22116787659,SOPORTE DE MOTOR ( L ) BMW F20 F30 CORTECO,1761,3,0,2,5
22116795416,SOPORTE DE MOTOR ( L / R ) BMW E70 / N52N ( FEBI ),1802,8,1,2,11
22116795416-100,SOPORTE DE MOTOR ( L / R ) BMW E70 / N52N FREY INACTIVO,1243,1,5,6,12
22116854251 *1,SOPORTE DE MOTOR (L) BMW F20 F30 N13  (FREY),1838,8,3,5,16
22116854251 *2,SOPORTE DE MOTOR (L) BMW F20 F30 N13 (CORTECO),1977,0,1,6,7
22116854252 *1,SOPORTE MOTOR (R ) BMW F20 F21 N13 F30 F31 N13 (FREY),1428,0,0,2,2
22116855456 *1,SOPORTE MOTOR (R) BMW F20-F23 F30-F34 F36 (FREY),1315,9,4,5,18
22116856183 *1,SOPORTE MOTOR (L) BMW F22 N20 N26 B46 F30 N20 N26 B46 B48 F32 N220 N26 B46 B48 (FREY),1941,6,2,9,17
22116856184 *1,SOPORTE MOTOR (R) BMW F20 N20 F22 N20 N26 B46 F30 N20 N26 B46 B48 F32 N220 N26 B46 B48 (FREY),1766,6,7,5,18
22116856184-6,SOPORTE DE MOTOR ( R ) BMW F30 / N20 ( CORTECO ),1751,1,8,5,14
22116859413 *1,SOPORTE HIDRAULICO MOTOR (L) BMW F20 F22 F30 F32 B46 B48 (FREY),1973,8,3,5,16
22116859414 *1,SOPORTE HIDRAULICO MOTOR (R) BMW F20 F22 F30 F32 B46 B48 (FREY),1966,1,4,6,11
22116859845 *1,SOPORTE MOTOR (L) BMW F02 F06 F07 F10 F11 F13 N55 (FREY),1672,4,6,3,13
22116859846 *1,SOPORTE MOTOR (R) BMW F02 F06 F07 F10 F11 F13 N55 (FREY),1201,9,9,1,19
22116860453 *1,SOPORTE MOTOR (L) BMW SERIE 7 G11 G12 MOTOR N63 (FREY),1408,4,8,8,20
22116860454 *1,SOPORTE MOTOR (R ) BMW SERIE 7 G11 G12 MOTOR N63 (FREY),1885,2,1,6,9
22116860463 *1,SOPORTE MOTOR (L) BMW G11 G12 G14 G30 G32 B58 (FREY),1842,2,0,4,6
22116860464 *1,SOPORTE MOTOR (R) BMW G11 G12 G14 G30 G32 B58 (FREY),1712,0,5,7,12
22116860471 *1,SOPORTE MOTOR (L) BMW G01 G02 G05 G07 G12 G14 G20 G30 G32 B58 (FREY),1757,9,8,9,26
22116860472 *1,SOPORTE MOTOR (R) BMW G01 G02 G05 G07 G12 G14 G20 G30 G32 B58 (FREY),1491,5,8,2,15
22116860487 *1,SOPORTE MOTOR (L)) BMW G11 G12 G30 G31 G32 (FREY),1593,4,9,1,14
22116860488 *1,SOPORTE MOTOR (R) BMW G11 G12 G30 G31 G32 (FREY),1828,0,7,9,16
22116860495 *1,SOPORTE MOTOR (L) BMW G01 G02 G05 G06 G30 G31 B46 B48 (FREY),1404,8,1,1,10
22116860496 *1,SOPORTE MOTOR (R) BMW G01 G02 G05 G06 G30 G31 B46 B48 (FREY),1931,3,0,5,8
22116862549 *1,SOPORTE MOTOR (L) BMW F30 F31 F32 F33 F34 F36 (FREY),1258,2,3,7,12
22116865145,SOPORTE DE MOTOR ( L / R ) BMW E70 / N52N ( BMTR ),1387,2,3,6,11
22116865145 *1,SOPORTE MOTOR (L/R) BMW E70 E71 N52N N55 N62N (FREY),1872,3,8,5,16
22116867441,SOPORTE DE MOTOR ( L ) BMW F30 - N20 ( LEMFOERDER ),1510,4,1,5,10
22116867441 *1,SOPORTE MOTOR (L) BMW F20 F22 F30 F32 N20 N26 (FREY),1558,4,8,1,13
22116869355 *1,SOPORTE MOTOR (L) BMW F15 F16 MOTOR N20 4CIL. (FREY),1530,9,4,2,15
22116869356 *1,SOPORTE MOTOR (R ) BMW F15 F16 MOTOR N20 4CIL. (FREY),1675,2,7,9,18
22116885778-100,SOPORTE MOTOR DELANTERO BMW F48 F45 F46 (FREY) INACTIVO,1332,5,1,9,15
22116885788 *1,SOPORTE TRANSMISION FRONTAL INFERIOR BMW F45 B38 B42 B48 F48 B32 B38 B42 B46 B48 MINI F56 B36 B38 B46 B48 (FREY),1956,5,1,1,7
22116885788 *5,SOPORTE TRANSMISION FRONTAL INFERIOR BMW F45 B38 B42 B48 F48 B32 B38 B42 B46 B48 MINI F56 B36 B38 B46 B48 (FEBI) SSF,1997,4,8,4,16
22116885934 *1,SOPORTE MOTOR SUPERIOR (R) BMW F39 F40 F45 F48 MINI F54 F55 F56 F57 F60 B32 B36 B38 (FREY),1909,9,3,1,13
22116885934 *3,SOPORTE MOTOR SUPERIOR (R) BMW F39 F40 F45 F48 MINI F54 F55 F56 F57 F60 B32 B36 B38 (ELRING),1691,7,8,9,24
22118482771 *1,SOPORTE MOTOR (L) BMW G01 G02 G05 G30 G31 G32 (FREY),1557,8,2,8,18
22118482772 *1,SOPORTE MOTOR (R) BMW G01 G02 G05 G30 G31 G32 (FREY),1786,2,1,1,4
22119806995 *2,SOPORTE INFERIOR IZQUIERDO MOTOR MINI R60 R61 N16 N18 (CORTECO),1700,6,1,0,7
2212400518 *1,SOPORTE TRANSMISION AUTOMATICA MERCEDES W204 X204 (FREY),1283,2,0,7,9
2212406417 *1,SOPORTE MOTOR (L) MERCEDES W221 M278 (FREY),1434,2,6,0,8
2212406517 *1,SOPORTE DE MOTOR (R ) MERCEDES W221 M273  (FREY),1548,5,8,5,18
2212770195 *1,FILTRO ACEITE TRANSMISION AUTOMATICA 722.9 MERCEDES (FREY),1246,1,0,1,2
2212770195-100,FILTRO ACEITE CON JUNTA TRANSMISION 722.9 MERCEDES (FREY) INACTIVO,1581,4,6,1,11
2213200704 *C,COMPRESOR AIRE SUSPENSION MERCEDES W221 (EMBLER) TECH,1698,1,5,2,8
2213200704 *C1,COMPRESOR AIRE SUSPENSION MERCEDES W221  (EMBLER) TECH,1470,9,6,4,19
2213204913 *A,AMORTIGUADOR AIRE SUSPENSION DELANTERA (L/R) MERCEDES W221 (EMBLER) TECH,1748,3,1,3,7
2213204913 *B,BOLSA AIRE SUSPENSION DELANTERA (L/R) MERCEDES W221 (EMBLER) TECH,1211,2,7,8,17
2213204913 *O,ORINGS BOLSA AIRE SUSPENSION DELANTERA (L/R) MERCEDES W221 (EMBLER),1934,1,0,2,3
2213205113 *A,AMORTIGUADOR AIRE SUSPENSION TRASERA (L/R) MERCEDES W221 (EMBLER) TECH,1201,3,3,3,9
2213205513 *A,AMORTIGUADOR AIRE SUSPENSION TRASERA (L) MERCEDES W221 (EMBLER) TECH,1861,4,9,3,16
2213205513 *B,BOLSA AIRE SUSPENSION TRASERA (L) MERCEDES W221 (EMBLER) TECH,1526,3,3,9,15
2213205613 *A,AMORTIGUADOR AIRE SUSPENSION TRASERA (R) MERCEDES W221 (EMBLER) TECH,1994,1,5,1,7
2213205613 *B,BOLSA AIRE SUSPENSION TRASERA (R) MERCEDES W221 (EMBLER) TECH,1335,8,1,7,16
2213207913 *A,AMORTIGUADOR AIRE ACTIVE BODY SUSPENSION DELANTERA MERCEDES (L) W221 (EMBLER) TECH,1673,5,9,1,15
2213208013 *A,AMORTIGUADOR AIRE ACTIVE BODY CONTROL SUSPENSION TRASERA (R) MERCEDES W221 (EMBLER) TECH,1889,6,3,3,12
2213208713 *A,AMORTIGUADOR AIRE SUSPENSION TRASERA (L) MERCEDES W221  (EMBLER) TECH,1282,4,5,4,13
2213300225 *1,BALERO INTERIOR DE RUEDA DELANTERA L-R MERCEDES W210 FREY,1554,3,5,2,10
2213302311 *1,BRAZO RECTO SUSPENSION DELANTERA (L) MERCEDES W221 (FREY),1969,0,2,0,2
2213302411 *1,BRAZO RECTO SUSPENSION DELANTERA (R) MERCEDES W221 (FREY),1551,2,2,5,9
2213307207-100,BRAZO DE CONTROL PARA S-CLASS INACTIVO,1739,3,6,7,16
2213308107 *1,BRAZO INFERIOR SUSPENSION DELANTERA (L) MERCEDES W221 (FREY),1645,9,3,7,19
2213308107-1,BRAZO INFERIOR DE SUSPENSION DELANTERA L MERCEDES W221 TOPRAN,1687,0,3,8,11
2213308207 *1,BRAZO INFERIOR SUSPENSION DELANTERA (R) MERCEDES W221 (FREY),1770,0,9,1,10
2213308707 *1,BRAZO INFERIOR DE SUSPENSION DELANTERA ( L ) MERCEDES W221 C216 ( FREY ),1898,3,0,1,4
2213308807 *1,BRAZO INFERIOR SUSPENSION DELANTERA (R) MERCEDES W221 C216 (FREY),1725,1,3,5,9
2213308907,HORQUILLO SUPERIOR (L) W221 LEMFORDER,1569,0,1,1,2
2214600184 *1,SOLENOIDE CONTROL PRESION ACEITE DIRECCION 2 PINES MERCEDES W204 M271 M272 (FREY),1400,7,4,8,19
2214660102 *1,DEPOSITO ACEITE DIRECCION HIDRAULICA MERCEDES W164 M272 W221 M275 W219 M273 (FREY),1720,2,3,1,6
2214700705 *1,TAPON DEPOSITO COMBUSTIBLE MERCEDES C209 A209 W212 (FREY),1706,2,1,8,11
2215000349 *1,DEPOSITO ANTICONGELANTE ENFRIAMIENTO MOTOR  MERCEDES W212 (FREY),1761,5,2,4,11
2215000493,MOTOVENTILADOR MERCEDES W211 FREY,1537,8,2,9,19
2215010725 *1,MANGUERA VENTILACION DEPOSITO ANTICONGELANTE MERCEDES W221 (FREY),1951,2,2,2,6
2215015584  *1,MANGUERA DE RADIADOR OM651 W221 FREY,1559,3,3,7,13
2215420417,SENSOR DE ESTACIONAMIENTO ( TRASERO / DELANTERO ) MERCEDES W204,1605,1,2,7,10
2215420417 *1,SENSOR DE ESTACIONAMIENTO ( TRASERO / DELANTERO ) MERCEDES W204  FREY,1696,8,3,4,15
22187156 *A,AMORTIGUADOR AIRE SUSPENSION TRASERA (L/R) ESCALADE AVALANCHE SUBURBAN TAHOE YUKON DENALI (EMBLER) TECH,1395,2,6,5,13
22187159 *A,AMORTIGUADOR AIRE SUSPENSION DELANTERA (L/R) ESCALADE SUBURBAN TAHOE YUKON 2000 A 2006 (EMBLER) TECH,1568,4,5,3,12
22187159-100,AMORTIGUADOR SIN SENSOR SUSPENSION DELANTERA (L/R) ESCALADE AVALANCHE SUBURBAN TAHOE YUKON DENALI 2003 A 2006 (EMBLER) inactivo,1844,8,9,2,19
2219050201 *1,SENSOR ABS FRENOS TRASEROS (L/R) MERCEDES C216 W221 (FREY),1698,1,1,2,4
2219055500,SENSOR DE FRENOS ABS DELANTERO MERCEDES W216-W221 BMTR,1575,7,7,7,21
2219055700 *1,SENSOR FRENOS ABS DELANTERO (L/R) MERCEDES C216 W221 (FREY),1631,0,1,1,2
2219056000,SENSOR DE FRENOS ABS TRASERO L-R MERCEDES W216-W221 BMTR,1982,5,6,4,15
2219056000-100,SENSOR DE FRENOS ABS TRASERO L-R MERCEDES W216-W221 INACTIVO,1805,9,1,0,10
2219056100 *1,SENSOR ABS FRENOS DELANTERO (L/R) MERCEDES W221 (FREY),1625,1,7,4,12
221951361879B,LLAVERO DE PIEL CAFï¿½ BMW,1563,0,7,5,12
221951361879BL,LLAVERO DE PIEL NEGRO BMW,1565,8,2,7,17
221965010,JUNTAS ENFRIADOR DE ACEITE DE MOTOR MERCEDES W203 M112 MEISTERSATZ,1785,6,2,7,15
221965010-1,JUNTAS ENFRIADOR DE ACEITE DE MOTOR MERCEDES W203 BACMIP,1432,4,7,8,19
2219810406,BALERO DE RUEDA DELANTERA L-R MERCEDES W204-M272 NTN,1591,3,4,9,16
2219810406 *1,BALERO DE RUEDA DELANTERA L-R MERCEDES W204-M272 FREY,1657,1,2,0,3
222040C020,SENSOR DE MASA DE AIRE MAF LAND ROVER LR2 ( BMTR ),1497,8,5,7,20
2222400000 *1,SOPORTE TRANSMISION AUTOMATICA TRASERO MERCEDES W205 W222 M274 M276 M278 (FREY),1384,5,7,8,20
2222407117 *1,SOPORTE MOTOR (L) MERCEDES W222 M276 (FREY),1281,1,5,3,9
2222407217 *1,SOPORTE DE MOTOR (R ) MERCEDES W222 M256 (FREY),1944,6,9,9,24
2222408017 *1,SOPORTE MOTOR (R) MERCEDES W222 M276 (FREY),1288,6,0,4,10
2223201900 *A,AMORTIGUADOR AIRE NO 4 MATIC SUSPENSION DELANTERA (L) MERCEDES W222 (EMBLER) TECH,1432,4,6,7,17
2223202000 *A,AMORTIGUADOR AIRE NO 4 MATIC SUSPENSION DELANTERA (R) MERCEDES W222 (EMBLER) TECH,1253,7,1,9,17
2223205213 *A,AMORTIGUADOR AIRE NO 4 MATIC SUSPENSION TRASERA (R) MERCEDES W222 (EMBLER) TECH,1612,2,5,0,7
2223205313 *A,AMORTIGUADOR AIRE NO 4 MATIC SUSPENSION TRASERA (L) MERCEDES W222 (EMBLER) TECH,1297,2,5,5,12
2223208113 *A,AMORTIGUADOR AIRE 4 MATIC SUSPENSION DELANTERA (L) MERCEDES W222 V222 X222 C217 (EMBLER),1334,4,8,4,16
2223208213 *A,AMORTIGUADOR AIRE 4 MATIC SUSPENSION DELANTERA (R) MERCEDES W222 V222 X222 C217 (EMBLER),1596,1,7,9,17
22249784,AMORTIGUADOR DE SUSPENSION DELANTERA R RANGE ROVER BILSTEIN,1276,4,5,9,18
2225000849 *1,DEPOSITO ANTICONGELANTE ENFRIAMIENTOï¿½MOTOR MERCEDES W222 (FREY),1680,2,6,0,8
2227500036,AMORTIGUADOR DE CAJUELA ( L-R ) MERCEDES W222 FREY,1938,7,6,5,18
2228170415,EMBLEMA DE LA PARRILA DELANTERA AMG MERCEDES ORIGINAL,1814,4,5,3,12
2228700789 *2,BALASTRA MODULO ELECTRONICO LUZ XENON MERCEDES (EMBLER) MLL,1592,2,4,6,12
2229800064,AMORTIGUADOR COFRE FUERZA 550 NEWTONS 345 MM (L) MERCEDES W222 FREY,1654,7,1,5,13
2229800164,AMORTIGUADOR COFRE FUERZA 550 NEWTONS 345 MM (R) MERCEDES W222 FREY,1245,2,4,3,9
22311096728 *2,SOPORTE TRANSFER TRANSMISION BMW E53 2000 A 2003 M62 (CORTECO),1906,8,3,7,18
22313422956,SOPORTE DE TRANSFER BMW E83 / N52N ( CORTECO ),1922,2,6,6,14
22313422956 *1,SOPORTE TRANSMISION AUTOMATICA TRANSFER BMW E83 N52N E84 N20 (FREY),1524,0,6,4,10
22313422956 *5,SOPORTE DE TRANSFER BMW E83-N52N LEMFORDER,1851,4,5,1,10
22316754088 *1,SOPORTE TRANSMISION AUTOMATICA TRANSFER BMW E53 M54 3.0 L 2000 A 2003 (FREY),1813,0,9,7,16
22316769848 *1,SOPORTE TRANSMISION AUTOMATICA BMW F10 F11 N20 (FREY),1695,3,5,6,14
22316770289 *1,SOPORTE TRANSMISION AUTOMATICA (L/R) BMW E60 E63 F01 F10 (FREY),1804,8,7,6,21
22316771130 *1,SOPORTE TRANSMISION AUTOAMTICA (L/R) BMW E38 E38 E65 E52 (FREY),1924,4,8,9,21
22316771219 *1,SOPORTE TRANSMISION (L/R) BMW E36 E46 E39 E81 E85 E86 E89 E90 F06 F10 (FREY),1766,2,6,0,8
22316771219 *2,SOPORTE TRANSMISION BMW E46 M54 (CORTECO),1458,4,2,1,7
22316771219-1,SOPORTE DE TRANSMISION BMW E46-M54 LEMFOERDER,1238,5,4,5,14
22316771741 *1,SOPORTE TRANSMISION AUTOMATICA (L/R) BMW E60 E63 (FREY),1981,5,3,6,14
22316771743 *1,SOPORTE TRANSFER TRANSMISION AUTOMATICA BMW E53 M54 3.0 L 2004 A 2006 (FREY),1384,7,0,3,10
22316773125 *1,SOPORTE TRANSMISION AUTOMATICA TRANSFER BMW X1 E84 2008 A 2015 X3 E83 2003 A 2006 (FREY),1944,1,4,3,8
22316773125 *2,SOPORTE DE TRANSFER BMW E83 / M54 ( TOPRAN ),1350,4,5,8,17
22316773125 *4,SOPORTE DE TRANSFER BMW E83 / M54 ( FEBI ),1413,9,9,2,20
22316773125 *5,SOPORTE TRANSMISION AUTOMATICA TRANSFER BMW X1 E84 2008 A 2015 X3 E83 2003 A 2006 (LEMFORDER ),1774,6,4,2,12
22316773825,SOPORTE DE TRANSMISION AUTOMATICA BMW E60/N62 GENUINO,1870,1,1,3,5
22316784357-1,SOPORTE DE TRANSMISION AUTOMATICA MINI R56 LEMFORDER,1600,8,6,2,16
22316784357-100,SOPORTE DE TRANSMISION MINI R56 INACTIVO,1689,5,5,3,13
22316784359 *1,SOPORTE TRANSMISION AUTOMATICA (R) MINI R56 R57 R58 R59 R60 R61 (FREY),1395,6,0,8,14
22316796617 *1,SOPORTE TRANSMISION AUTOMATICA (L/R) BMW F20 F22 F30 F32 G29 (FREY),1224,0,5,9,14
22316796617 *3,SOPORTE TRANSMISION AUTOMATICA BMW F20 F22 F30 F32 G29 (CORTECO),1888,5,6,7,18
22316796617-1,SOPORTE DE TRANSMISION BMW F30-N20 KZR GERMANY,1455,0,4,8,12
22316796619 *3,SOPORTE TRANSMISION AUTOMATICA BMW F20 F30 (CORTECO),1919,8,4,3,15
22316799331-3,SOPORTE DE TRANSMISION BMW E46-M54 TOPRAN,1978,9,9,5,23
22316850468 *1,SOPORTE TRANSMISION AUTOMATICA (L/R) BMW F32 F25 (FREY),1272,3,1,0,4
22316853449 *1,SOPORTE INFERIOR TRANSMISION (L) BMW F39 F45 E48 MINI F54 F55 F56 F57 F60 B46 B48 (FREY),1816,3,6,5,14
22316864675 *1,SOPORTE DE TRANSMISION BMW E70-F15 MOTOR N55-N52N-N63N FREY,1370,0,8,2,10
22321093906,SOPORTE TRANSMISION AUTOMATICA (ROMBO) BMW E39-M52,1800,4,4,2,10
22321093906 *1,SOPORTE TRANSMISION AUTOMATICA FREY,1972,0,1,1,2
22326775916 *1,SOPORTE TRANSMISION AUTOMATICA (L/R) BMW F10 (FREY),1397,7,5,0,12
22326780025,SOPORTE DE TRANSMISION BMW E70-F15 MOTOR N55-N52N-N63N,1322,6,6,1,13
22326788568 *1,SOPORTE DE MONTAJE PARA BMW (FREY),1215,3,2,4,9
22326860537 *1,SOPORTE TRANSMISION AUTOMATICA (L/R) BMW G01 G02 G05 G06 G20 G30 (FREY),1951,9,6,2,17
22326862577 *1,SOPORTE TRANSMISION AUTOMATICA (L/R) BMW G01 G11 G30 G32 (FREY),1679,7,7,7,21
22326862578 *1,SOPORTE TRANSMISION AUTOMATICA (L/R) BMW G11 G12 G30 (FREY),1310,0,2,6,8
22481 *5,TORNILLO ESTABILIZADOR SUSPENSION DELANTERA (L/R) MINI R50 A R59 (FEBI) SSF,1961,2,9,1,12
2249 *5 ,5 LITROS ACEITE MOTOR 100% SINTETICO 5W-30 ESPECIAL TEC LL (LIQUI MOLY) SSF,1541,0,1,3,4
2249-100,5 LITROS ACEITE MOTOR 100% SINTETICO 5W-30 ESPECIAL TEC LL (LIQUI MOLY) INACTIVO,1699,2,1,2,5
2290601108 *K,KIT 3 PZ. CLUTCH PLATO DISCO 240 MM COLLARIN SPRINTER 906 VITO W639 (FREY),1435,5,2,9,16
2303380015,BIELETA DIRECCION SIN TERMINAL SUSPENSION DELANTERA (L/R) MERCEDES W203 (BMTR),1515,2,5,5,12
2303380015 *1,BIELETA DIRECCION SIN TERMIANL SUSPENSION DELANTERA (L/R) MERCEDES W203 W211 W220 (FREY),1773,5,6,7,18
2303380015-1,BIELETA DIRECCION SIN TERMINAL SUSPENSION DELANTERA (L/R) MERCEDES W203 (LEMFOERDER),1236,1,5,8,14
2303380015-3,BIELETA DIRECCION SIN TERMINAL SUSPENSION DELANTERA (L/R) MERCEDES W203 (DELPHI),1325,4,2,0,6
2303380015-4,BIELETA DIRECCION SIN TERMINAL SUSPENSION DELANTERA (L/R) MERCEDES W203 (SIDEM),1644,6,0,3,9
2303380015-5,BIELETA DIRECCION SIN TERMINAL SUSPENSION DELANTERA (L/R) MERCEDES W203 (TOPRAN),1596,3,3,1,7
2305000149 *1,TANQUE DE EXPANSION R230 (FREY),1339,4,0,6,10
2309810127,COJINETE DE RUEDA (NTN),1382,7,0,4,11
23117518633,RETEN CANDELERO COLLARIN TRANSMISION MINI R50 R53  CORTECO,1497,5,8,6,19
23117545082 *1,RETEN FLECHA TRANSMISION STANDAR GS6-53BG/DG (L/R) COOPER R50 R55 A R61 (GETRAG) SSF,1939,0,8,3,11
23151122 *A,AMORTIGUADOR AIRE ELECTRONICO SUSPENSION TRASERA (L/R) SUBURBAN YUCON ESCALADE 2015 A 2019 (EMBLER) TECH,1894,2,5,1,8
23193-1 *1,PINZA FRENO DE DISCO-DESCARGADO CALIPER CON SOPORTE DELANTERO SPRINTER 901 902 903 904 906 (FREY),1725,7,5,6,18
23427571297,BOMBA HIDRAULICA DE EMBRAGUE BMW MOTOR M54-N62-N62N DENSO ORIGINAL,1323,1,6,2,9
23431424 *5,BOMBA GASOLINA ELECTRICA VOLVO S40 V50 2.4 L 2.5 L 5 CIL (PRO PARTS) SSF,1839,8,7,0,15
23487282,AMORTIGUADOR DE SUSPENSION TRASERA CHEVROLET ORIGINAL GMC,1876,7,8,8,23
2385016-1,KIT DE MANGUERAS DE VENTILACION PCV BMW E90-N52 EMBLER,1649,1,3,4,8
239971245,RETEN DE CIGUEï¿½AL TRASERO MERCEDES W203,1724,3,6,2,11
239978447,RETEN DE CIGï¿½Eï¿½AL DELANTERO 45X67X8 MERCEDES W203 ELRING,1981,7,7,5,19
24007614277 *3,TRANSMISION AUTOMATICA BMW E82 E88 E90 E93 (USADO),1927,7,6,2,15
2404110115 *1,ARTICULACION ARBOL LONGITUDINAL MERCEDES W205 (FREY),1653,1,3,9,13
2404110115B,JUNTA GOMA CARDAN MERCEDES W203 W205 W221 (FREY),1286,3,5,0,8
24101423380,JUNTA DE CARTER DE TRANSMISION BMW E46-M54 5HP19,1394,7,6,2,15
24101423380 *1,JUNTA DE CARTER DE TRANSMISION BMW E46-M54 5HP19 FREY,1597,0,4,9,13
24101423380 *5,JUNTA CARTER TRANSMISION AUTOMATICA 5HP19 BMW Z4 E85 E38 E39 E46 (ELRING) SSF,1718,4,0,1,5
24107507818,SENSOR DE RANGO DE TRANSMION AUTOMATICA BMW E46 / M54 ( ZF ),1389,9,8,6,23
24107507818 *1,SENSOR DE RANGO DE TRANSMION AUTOMATICA BMW E46 / M54 FREY,1206,1,6,1,8
24117510012 *1,FILTRO ACEITE TRANSMISION AUTOMATICA A5S360R/390R BMW Z3 E36 E39 E46 E83 (FREY),1686,2,2,9,13
24117510012 *5,FILTRO ACEITE TRANSMISION AUTOMATICA A5S360R/390R BMW Z3 E36 E39 E46 E83 (REIN) SSF,1834,8,3,6,17
24117518741,FILTRO ACEITE TRANSMISION AUTOMATICA (CAJA GACVT16Z) MINI R50-R52 FAG,1226,7,7,2,16
24117524707 *1,JUNTA CARTER TRANSMISION AUTOMATICA A5S360R BMW E36 E39 E46 E53 E83 (FREY),1520,8,4,2,14
24117524707-9,JUNTA DE CARTER DE TRANSMISION AUTOMATICA BMW E53-M54 REIN,1724,8,0,0,8
24117543484,EMPAQUE DE TRANSMISION,1820,1,1,7,9
24117543550 *1,FILTRO ACEITE TRANSMISION AUTOMATICA GA6HP26Z BMW E83 E53 E70 E71 (FREY),1965,5,4,1,10
24117551079,CARTER DE TRANSMISION AUTOMATICA MINI R53-W11 FAG,1968,1,7,4,12
24117566354 *1,CARTER TRANSMISION AUTOMATICA GA6F21WA MINI R55 A R61 (FREY),1276,3,9,1,13
24117566356 *1,JUNTA CARTER TRANSMISION AUTOMATICA MINI R52 R53 R55 R56 R57 R58 R59 R60 R61 GA6F21WA (FREY),1902,0,5,2,7
24117571217 *3,FILTRO ACEITE TRANSMISION AUTOMATICA BMW E60 E70 E71 E81 E84 E85 E90 6HP19 (MAHLE HX154),1375,4,9,2,15
24117571235,JUNTA DE CARTER DE TRANSMISION AUTOMATICA ZF 6HP19 BMW E90,1333,5,3,9,17
24117571235 *1,JUNTA DE CARTER DE TRANSMISION AUTOMATICA ZF 6HP19 BMW E90 FREY,1621,6,7,0,13
24117572618,JUNTA DE CARTER DE TRANSMISION AUTOMATICA GA6L45R BMW MEISTERSATZ,1200,1,9,5,15
24117572618 *1,JUNTA CARTER DE TRANSMISION AUTOMATICA GA6L45R BMW (FREY),1439,9,9,0,18
24117572618-1,JUNTA DE CARTER DE TRANSMISION AUTOMATICA GA6L45R BMW TRANSTAR,1424,9,5,3,17
2411759356-100,FILTRO DE ACEITE DE TRANSMISION AUTOMATICA INACTIVO,1395,5,9,1,15
24117593565 *1,KIT 2 PZ. FILTRO JUNTA ACEITE TRANSMISION AUTOMATICA GA6L45R BMW E81 E83 E84 E90 (FREY),1913,2,9,5,16
24117613253-100,FILTRO DE ACEITE TRANSMISION GA8HP45Z BMW F20 F30 F32 F10 INACTIVO,1284,8,0,5,13
24117613253B,JUNTA CARTER TRANSMISION AUTOMATICA BMW GA8HP45Z (FREY),1374,1,8,5,14
24118612901 *1,CARTER FILTRO ACEITE TRANSMISION AUTOMATICA BMW GA8HP45Z (FREY),1767,0,2,5,7
24119812996 *1,ENFRIADOR ACEITE TRANSMISION AUTOMATICA GA6F21WA MINI R52 A R61 (FREY),1201,7,1,1,9
24121423529,RETEN DE TURBINA BMW E53 CORTECO,1575,8,4,1,13
24121423529 *1,RETEN DE TURBINA BMW E53 FREY,1626,0,6,5,11
24121423529-1,RETEN DE TURBINA BMW E53 ( SKF ),1500,9,2,3,14
24148627861 *1,ENFRIADOR ACEITE TRANSMISION AUTOMATICA GA6F21AW BMW F39 F43 F48 MINI F54 F55 F56 F57 F60 (FREY),1303,3,9,4,16
24148699905 *1,ENFRIADOR ACEITE MOTOR BMW F39 F40 F44-F48 MINI F54 F55-F57 F60 (FREY),1531,7,4,0,11
24152333903 *1,FILTRO ACEITE TRANSMISION AUTOMATICA GA6HP26Z BMW E60 E65 E70 E83 E90 (FREY),1240,2,2,8,12
24152333907 *1,FILTRO ACEITE TRANSMISION AUTOMATICA BMW E60 E70 E71 E81 E84 E85 E90 6HP19 (FREY),1788,5,2,6,13
24157551089 *3,SWICH PALANCA SELECTORA VELOCIDADES TRANSMISION AUTOMATICA MINI R55 R56 (GENUINO) SEMINUEVO,1513,9,5,2,16
24201423382,RETEN DE BOMBA DE ACEITE DE TRANSMISION BMW E46-ZF 5HP19 CORTECO,1226,5,5,6,16
24201423382 *1,RETEN DE BOMBA DE ACEITE DE TRANSMISION BMW E46-ZF 5HP19 FREY,1562,6,5,9,20
24220578,FILTRO ACEITE TRANSMISION VOLVO S40 KAIZZER ALEMAN,1525,5,6,0,11
24317519352 *1,RETEN DE TURBINA DE TRANSMISION AUTOMATICA BMW E90 6HP19 FREY,1567,6,5,2,13
24317519352 *5,RETEN BOMBA ACEITE TURBINA TRANSMISION AUTOMATICA 45X58X7 BMW 6HP19 // 6HP26 (CORTECO) SSF,1687,9,2,7,18
24341219316 *1,SENSOR DE VELOCIDAD DE TRANSMISION AUTOMATICA BMW E46 ZF CAJA 5HP19 FREY,1433,9,8,0,17
24341219316 *5,SENSOR VELOCIDAD TRANSMISION AUTOMATICA BMW 5HP19 // A5S325Z (ZF) SSF,1452,5,3,0,8
24341219316-1,SENSOR DE VELOCIDAD DE TRANSMISION AUTOMATICA BMW E46 ZF CAJA 5HP19 VEMO,1952,3,0,6,9
24341422673 *5,FILTRO ACEITE TRANSMISION AUTOMATICA A5S440Z BMW E39 E53 (MEISTERSATZ) SSF,1839,2,8,1,11
24341423376 *5,FILTRO ACEITE TRANSMISION AUTOMATICA BMW 5HP19 // A5S325Z (MEISTERSATZ) SSF,1683,4,0,0,4
24347551087,FILTRO ACEITE TRANSMISION AUTOMATICA (CAJA GA6F21WA) MINI F56-R52-R56 FAG,1944,6,5,2,13
24347566358,FILTRO ACEITE TRANSMISION AUTOMATICA GA6F21WA MINI R55 A R61 N12 A N18 (FREY),1305,4,9,3,16
24347566358 *1,KIT 2 PZ FILTRO ACEITE JUNTA CARTER TRANSMISION GA6F21WA MINI R55 A R61 N12 A N18 (FREY),1941,9,1,1,11
24348671617,SOLENOIDE DE TRANMISION AUTOMATICA BMW E90 (1 PIEZA),1909,0,0,2,2
24348671617 *1,SOLENOIDE DE TRANMISION AUTOMATICA BMW E90 (1 PIEZA) FREY,1456,1,0,4,5
24607548312,COMPUTADORA TRANSMISION AUTOMATICA 325i (7548312) E46/E85/E39,1904,9,6,2,17
24607552700,COMPUTADORA TRANSMISION 325i 330i (7544721) E46/E83/E53,1614,1,8,9,18
2462400617 *1,SOPORTE TRANSMISION LATERAL SUPERIOR (L) MERCEDES W176 W246 X156 M270 M274 (FREY),1805,0,2,8,10
2462401209 *1,SOPORTE MOTOR TRASERO INFERIOR (L) W176 W246 X156 M274 M271 M274 (FREY),1903,2,2,9,13
2462401209 *5,SOPORTE DE MOTOR W176 HUTCHINSON,1410,2,6,4,12
2462401209-1 ,SOPORTE DE MOTOR MERCEDES W176 X156 W246 CORTECO,1697,4,7,4,15
2462401709 *1,SOPORTE MOTOR TRASERO SUPERIOR (R) MERCEDES W176 W246 (FREY),1903,1,1,5,7
2462401709* 2,SOPORTE MOTOR TRASERO SUPERIOR (R) MERCEDES W176 W246 (CORTECO),1438,8,6,4,18
2462402517 *1,SOPORTE MOTOR LATERAL SUPERIOR (R) MERCEDES W176 W246 X156 M270 M274 (FREY),1779,1,2,6,9
2463200689,TORNILLO ESTABILIZADOR SUSPENSION DELANTERA (L/R) MERCEDES W176 (SIDEM),1310,7,3,3,13
2463200689 *1,TORNILLO ESTABILIZADOR SUSPENSION DELANTERA (L/R) MERCEDES W176 W246 (FREY),1435,8,7,8,23
2463200789 *1,TORNILLO ESTABILIZADOR SUSPENSION TRASERA (L/R) MERCEDES W246 (FREY),1310,5,2,2,9
2463201831 *1,AMORTIGUADOR SUSPENSION TRASERA (L/R) MERCEDES W176 W246 (FREY),1969,3,7,9,19
2463201831-9,AMORTIGUADOR DE SUSPENSION TRASERA ( L-R ) MERCEDES W176 ( ORIGINAL ),1633,9,0,4,13
246323002-100,BASE AMORTIGUADOR DELANTERO (L/R) MERCEDES W246 W176 TM (BMTR) INACTIVO,1934,9,9,7,25
2463230020 *1,BASE AMORTIGUADOR SUSPENSION DELANTERA (L/R) MERCEDES W176 W246 (FREY),1267,8,4,9,21
2463230020 *2,BASE DE AMORTIGUADOR SUSPENSION DELANTERA (L/R) MERCEDES W176 W246 (EMBLER),1844,4,9,8,21
2463230020 *3,BASE DE AMORTIGUADOR DELANTERO L-R MERCEDES W246-W176 FEBI,1458,5,8,0,13
2463230020-100,BASE DE AMORTIGUADOR DELANTERO L-R MERCEDES W246-W176 OEM INACTIVO,1946,3,1,7,11
2463230020-101,BASE DE AMORTIGUADOR DELANTERO L-R MERCEDES W246-W176 TM GENUINO INACTIVO,1865,0,6,0,6
2463230020-103,BASE DE AMORTIGUADOR DELANTERO L-R MERCEDES W246-W176 TM TROPAN INACTIVO,1893,7,7,6,20
2463232900 *1,AMORTIGUADOR SUSPENSION DELANTERA (L) MERCEDES W176 W246 (FREY),1611,6,2,7,15
2463233000 *1,AMORTIGUADOR SUSPENSION DELANTERA (R) MERCEDES W176 W246 (FREY),1255,7,1,1,9
2463260064-1,BASE DE AMORTIGUADOR TRASERO L-R MERCEDES W246 FREY 3675201,1383,6,0,9,15
2463260064-9,BASE DE AMORTIGUADOR TRASERO L-R MERCEDES W246 (VERMO),1257,4,2,4,10
2463301700 *1 ,TERMINAL DIRECCION SIN BIELETA SUSPENSION DELANTERA (L) MERCEDES W176 W246 (FREY),1529,4,5,6,15
2463301800 *1 ,TERMINAL DIRECCION SIN BIELETA SUSPENSION DELANTERA (R) MERCEDES W176 W246 (FREY),1785,8,7,0,15
2463304700,HORQUILLA DE SUSPENSION DELANTERA L MERCEDES W176 BMTR,1804,6,4,7,17
2463304700 *1,HORQUILLA SUSPENSION DELANTERA (L) MERCEDES W176 W246 (FREY),1734,3,3,9,15
2463304800 *1,HORQUILLA SUSPENSION DELANTERA (R) MERCEDES W176 W246 (FREY),1507,3,3,5,11
2463330014 *1,BUJE HORQUILLA DE SUSPENSION DELANTERA (L) MERCEDES W176 W246 (FREY),1925,6,4,0,10
2463330100-2,BUJE DE HORQUILLA DE SUSPENSION DELANTERA L MERCEDES W176 SIDEM,1599,4,1,3,8
2463330100-9,BUJE DE HORQUILLA DE SUSPENSION DELANTERA L MERCEDES W176 BMTR,1291,8,4,2,14
2463330200-9,BUJE DE HORQUILLA DE SUSPENSION DELANTERA R MERCEDES W176 BMTR,1238,9,0,2,11
2463330214 *1,BUJE HORQUILLA SUSPENSION DELANTERA (R) MERCEDES W176 W246 (FREY),1658,4,9,6,19
2463340006 *2,BALERO DE RUEDA TRASERA L/R MERCEDES CLA250 CLA200 B200 (EMBLER),1944,4,4,9,17
2463370145 *1,BALERO MASA RUEDA DELANTERA (L/R) MERCEDES W176 W246 (FREY),1462,9,0,4,13
2463380000 *1,BIELETA DIRECCION SIN TERMINAL SUSPENSION DELANTERA (L/R) MERCEDES W176 W246 X156 (FREY),1721,3,0,9,12
2463380000 *2,BIELETA DIRECCION SIN TERMINAL SUSPENSION DELANTERA (L/R) MERCEDES W176 W246 X156 (EMBLER),1360,9,6,4,19
2463500053 *1,BRAZO DE CONTROL SUSPENSION TRASERA (L/R) MERCEDES W176 W246 X156 (FREY),1247,2,9,2,13
2463772400 *1,FILTRO LIQUIDO TRANSMISION AUTOMATICA MERCEDES W176 W177 C117 C118 X156 (FREY),1996,2,0,5,7
2464210012,DISCO DE FRENO MERCEDES BENZ W264,1482,2,6,3,11
2464210112 *1,DISCO FRENOS DELANTERO 295 MM MERCEDES W176 W246 (FREY),1841,8,4,8,20
2464212512 *1,DISCO FRENOS DELANTEROS HIPERVENTILADOS 295 X 165 MM (L/R) MERCEDES C117 W176 W246 X117 X156 (FREY),1428,8,0,8,16
2464212712 *1,DISCO FRENOS DELANTEROS HIPERVENTILADOS 320 X 165 MM (L/R) MERCEDES C117 W176 W246 X117 X156 (FREY),1369,6,4,0,10
2464212712 *5,DISCO FRENOS DELANTEROS HIPERVENTILADOS 320 X 165 MM (L/R) MERCEDES C117 W176 W246 X117 X156 (ATE) SSF,1317,1,1,8,10
2464230012 *1  ,DISCO FRENO TRASERO 276X44.2X163 MM MERCEDES W176 W246 (FREY),1893,2,0,8,10
2464230012 *2,DISCO FRENO TRASERO 276X44.2X163 MM MERCEDES W176 W246 (BREMBO),1642,5,7,5,17
2464230112 *1,DISCO DE FRENOS TRASERO MERCEDES W246 (FREY),1227,8,2,4,14
2464230112 *2,DISCO FRENOS TRASEROS SOLIDO (L/R) 295 MM MERCEDES C117 W176 W246 X156 (EMBLER),1789,0,2,8,10
2464230112 *5,DISCO FRENOS TRASEROS SOLIDO (L/R) 295 MM MERCEDES C117 W176 W246 X156 (ATE) SSF,1377,0,4,5,9
2464230112-100,DISCO FRENOS TRASEROS SOLIDO (L/R) 295 MM MERCEDES C117 W176 W246 X156 (FREY) INACTIVO,1774,6,6,3,15
2464700994 *1,BOMBA COMBUSTIBLE GASOLINA MERCEDES W176 W246 X156 (FREY),1898,2,2,8,12
2464701694 *3,BOMBA COMBUSTIBLE GASOLINA MERCEDES X156 W176 (VERMO),1889,6,7,1,14
2465000049 *1,DEPOSITO ANTICONGELANTE ENFRIAMIENTO MOTOR MERCEDES C117 W156 W176 W246 X156 (FREY),1880,5,8,6,19
2465000049 *5,DEPOSITO ANTICONGELANTE ENFRIAMIENTO MOTOR MERCEDES C117 W156 W176 W246 X156 (FEBI) SSF,1602,9,9,0,18
2465000049 *6,DEPOSITO ANTICONGELANTE ENFRIAMIENTO MOTOR MERCEDES C117 W156 W176 W246 X156 (REIN) SSF,1400,7,7,2,16
2465000049-100,DEPOSITO DE ANTICONGELANTE MERCEDES W176 (EMBLER) INACTIVO,1556,2,2,1,5
2465000093 *1 ,MOTOVENTILADOR ENFRIAMIENTO MOTOR MERCEDES W176 W246 M270 (FREY),1780,6,9,5,20
2465001303 *1,RADIADOR ENFRIAMIENTO MOTOR MERCEDES W176 W246 WX156 M270 (FREY),1924,1,9,1,11
2465001403 *1,RADIADOR DE MOTOR MERCEDES BENZ W246 W176 X156 FREY,1735,9,8,9,26
2465010058 *1,MANGUERA DEPOSITO DE ANTICONGELANTE A RADIADOR MERCEDES C117 W176 W246 X156 M270 (FREY),1289,3,3,4,10
2465010101 *1,BASE FILTRO ACEITE MOTOR CON ENFRIADOR MERCEDES W176 W246 X117 X156 (FREY),1626,5,1,8,14
2465010282 *2,MANGUERA DE RADIADOR MERCEDES W176 W246 X156 (EMBLER),1611,3,7,7,17
2465010325 *1,TUBO VENTILACION DEPOSITO ANTICONGELANTE MERCEDES C117 W176 W246 X156 M266 (FREY),1266,0,4,0,4
2465010325 *2,TUBO VENTILACION DEPOSITO ANTICONGELANTE MERCEDES C117 W176 W246 X156 M266 (EMBLER),1331,5,3,4,12
2465402510,SENSOR DE FRENOS ABS DELANTERO MERCEDES W246 BMTR,1421,5,7,3,15
2465402510 *1,SENSOR DE FRENOS ABS DELANTERO MERCEDES W246 FREY,1368,6,0,9,15
2468300018 *1,FILTRO POLEN AIRE CABINA MERCEDES W176 W246 X156 (FREY),1959,9,2,6,17
2468300018 *3,FILTRO POLEN AIRE CABINA MERCEDES W176 W276 X156 (MAHLE LAK879),1886,4,4,9,17
2468300018 *5,FILTRO POLEN AIRE CABINA MERCEDES W176 W276 X156 (HENGST) SSF,1804,1,7,6,14
2468300018-2,FILTRO POLEN AIRE CABINA MERCEDES W176 CORTECO,1770,2,0,1,3
2468690020,DEPOSITO AGUA LIMPIAPARABISAS CHISGUETEROS MERCEDES W176 W246 (FREY),1262,4,7,9,20
2469059402,SENSOR DE FRENOS ABS TRASERO MERCEDES W246 ( BMTR ),1371,7,8,4,19
2469059402 *1,SENSOR DE FRENOS ABS TRASERO MERCEDES W246 FREY,1657,4,3,6,13
2469800664 *1,AMORTIGUADOR CAJUELA 540 NEWTOS 519 MM (L/R) MERCEDES W246 (FREY),1514,6,3,5,14
2469810006 *1,BALERO DOBLE RUEDA DELANTERO (L/R) MERCEDES W176 W246 (FREY),1644,8,8,0,16
2469810006 *3,BALERO DOBLE RUEDA DELANTERO (L/R) MERCEDES W176 W246 (OSSCA),1399,2,6,4,12
24701142019,SOPORTE TRANSMISION AUTOMATICA (CILINDRO) BMW E39-M52,1656,5,7,7,19
24701142019 *1,SOPORTE TRANSMISION AUTOMATICA ( FREY ),1440,5,3,0,8
2472400600-100,SOPORTE DE MOTOR DELANTERO MERCEDES C118 W177 W247 INACTIVO,1289,8,0,7,15
2472402800 *1,SOPORTE SUPERIOR DE MOTOR (L) MERCEDES  C118 H247 W177 W247 X118 X247 (FREY),1563,5,3,3,11
2473207603 *1,TORNILLO  BARRA ESTABILIZADORA SUSPENSION DELANTERA (L/R) MERCEDES C118 H247 W177 W247 X247 (FREY),1795,3,0,6,9
2473209703 *A,AMORTIGUADOR AIRE SUSPENSION TRASERA MERCEDES   X247   (EMBLER) TECH,1203,6,3,0,9
2473230020 *1,BASE AMORTIGUADOR SUSPENSION DELANTERA (L/R) MERCEDES W177 W247 C118 (FREY),1272,4,0,4,8
2474210412 *2,DISCO DE FRENOS DELANTERO 305X28MM MERCEDES W177 X118 H247 (EMBLER) NIT,1486,4,9,0,13
2474230212 *2,DISCO DE FRENOS TRASERO 295X12MM MERCEDES W177 X118 H247 (EMBLER) NIT,1957,1,2,8,11
2475006100 *1,RADIADOR ENFRIAMIENTO MOTOR MERCEDES W177 W247 (FREY),1244,9,1,0,10
2478301702 *1,FILTRO AIRE CABINA MERCEDES W177 H247 X118 (FREY),1645,2,8,4,14
2478307203 *5,FILTRO POLEN AIRE CABINA MERCEDES H247 W177 X247 (HENGST) SSF,1838,2,0,4,6
25101801,MOTOCICLETA HONDA GL150 MODELO 2021,1387,7,2,6,15
2512401818 *1,SOPORTE TRANSMISION AUTOMATICA TRASERO MERCEDES W164 M113 M272 (FREY),1249,6,7,5,18
2512403017,SOPORTE DE MOTOR MERCEDES W164 TOPRAN,1722,2,0,0,2
2512403217,SOPORTE DE MOTOR MERCEDES X204 ( TOPRAN ),1897,4,3,7,14
2512404417 *1,SOPORTE DE MOTOR MERCEDES X204 FREY,1994,1,7,8,16
2512404417-100,SOPORTE DE MOTOR DELANTERO ( L- R ) MERCEDES BENZ W164 FREY INACTIVO,1648,1,9,5,15
2512404417-9,SOPORTE DE MOTOR DELANTERO ( L- R ) MERCEDES BENZ W164 TOPRAN,1700,4,8,0,12
2512800900,TRANSFER SEMINUEVO MERCEDES W164 3.5L GENUINO,1971,7,9,1,17
2512800900 *1,TRANSFER  MERCEDES W164 3.5L FREY,1282,2,0,7,9
2513200330 *1,AMORTIGUADOR SUSPENSION DELANTERO (L/R)  MERCEDES W251  (FREY),1981,4,9,2,15
2513200425 *B,BOLSA AIRE SUSPENSION TRASERA (L/R) MERCEDES W251 (EMBLER) TECH,1593,1,3,9,13
2513200631 *A,AMORTIGUADOR SIN ADS SUSPENSION TRASERA (L/R) MERCEDES W251 (EMBLER) TECH,2000,3,5,8,16
2513203013 *B,BOLSA AIRE SUSPENSION DELANTERA (L/R) MERCEDES W251 (EMBLER) TECH,1906,2,9,5,16
2513203113 *A,AMORTIGUADOR AIRE SUSPENSION DELANTERA (L/R) MERCEDES W251 (EMBLER) TECH,1860,7,8,9,24
2513300707 *1,HORQUILLA SUPERIOR SUSPENSION DELANTERA (L) MERCEDES W164 X164 (FREY),1206,1,7,5,13
2513300707-100,HORQUILLA SUPERIOR DE SUSPENSION DELANTERA ( L)  MERCEDES W164  ( FREY ) INACTIVO,2000,3,2,2,7
2513300743 *1,BUJE HORQUILLA INFERIOR SUSPENSION DELANTERA (L) MERCEDES W251 (FREY),1312,2,9,2,13
2513300807 *1,HORQUILLA SUPERIOR DE SUSPENSION DELANTERA (R) MERCEDES W164 X164 (FREY),1339,2,4,7,13
2513300843 *1,BUJE HORQUILLA INFERIOR SUSPENSION DELANTERA (R) MERCEDES W251 (FREY),1865,3,5,9,17
2513330114,BUJE DE HORQUILLA SUPERIOR DELANTERA MERCEDES W164 LEMFORDER,1841,2,4,1,7
2514408113 *1,SENSOR FRENOS ABS DELANTERO (L/R) MERCEDES W251 (FREY),1919,4,6,9,19
2514600024 *1 ,MANGUERA DIRECCION ALTA PRECION MERCEDES W164 W251 M113 (FREY),1741,9,6,5,20
251470009-100,FILTRO REGULADOR GASOLINA FLOTADOR MERCEDES W164 W251 INACTIVO,1283,5,5,1,11
2514700894,BOMBA DE GASOLINA MERCEDES W251 BMTR,1531,2,1,1,4
2514700894 *1,BOMBA DE GASOLINA MERCEDES W251 FREY,1233,7,8,1,16
2515000003 *1,RADIADOR ENFRIAMIENTO MOTOR MERCEDES W164 W251 (FREY),1883,0,9,9,18
2515000049,DEPOSITO ANTICONGELANTE ENFRIAMIENTO MOTOR MERCEDES 1900 A 2023  (FEBI) SSF,1725,8,4,5,17
2515000049 *1,DEPOSITO ANTICONGELANTE MERCEDES W251 FREY,1634,1,0,6,7
2517400045,AMORTIGUADOR CAJUELA 1450 NEWTONS 312 MM (L) MERCEDES BENZ W251 FREY,1836,4,8,7,19
2518200100,LIMPIAPARABRISAS DELANTERO MERCEDES  W164 BOSCH,1593,8,9,8,25
2518200845 *1,LIMPIAPARABRISAS DELANTERO MERCEDES  W164 FREY,1928,6,7,1,14
2518300090 *1,CONTROLADOR VENTANA 4 BOTONES MERCEDES W164 4.6 L V8 (FREY),1946,8,9,8,25
2518300590,CONTROLADOR DE VENTANA 4 BOTONES MERCEDES X204 3.5 L V6 BMTR,1210,0,1,0,1
2518300590 *1,CONTROL ELECTRICO PRINCIPAL CRISTALES ESPEJOS (L) MERCEDES W164 W251 (FREY),1904,8,5,8,21
2518300590-9051 *1,CONTROLADOR DE VENTANA 9 BOTONES MERCEDES W251 W164 (FREY),1996,1,0,4,5
2518800129 *1,AMORTIGUADOR CAJUELA 400 NEWTONS 453 MM (L) MERCEDES W251 FREY,1892,1,6,8,15
2518800229,AMORTIGUADOR COFRE FUERZA 400 NEWTONS 453 MM (R) MERCEDES W251 FREY,1854,4,6,6,16
2519055700,SENSOR DE FRENOS ABS DELANTERO MERCEDES W251 BMTR,1516,3,8,0,11
2519055700 *1,SENSOR DE FRENOS ABS DELANTERO MERCEDES W251 FREY,1858,3,7,7,17
25193519,RETEN DE CIGUEï¿½AL DELANTERO SAAB 9-3 ( CORTECO 42 X 55 X 7 MM ),1493,6,0,4,10
2519800564-100,AMORTIGUADOR DE COFRE ( L ) MERCEDES X164-W251 FREY INACTIVO,1942,1,1,7,9
2519800664 *1,AMORTIGUADOR COFRE (R) MERCEDES W251 (FREY),1509,3,5,2,10
2519801064 *1,AMORTIGUADOR CAJUELA 1400 NEWTONS 312 MM (R) MERCEDES BENZ W251 FREY,1981,1,8,8,17
2532400300 *1,SOPORTE MOTOR (R) MERCEDES W213 W253 (FREY),1641,9,6,8,23
2533200401 *A,AMORTIGUADOR AIRE SUSPENSION DELANTERA (R) MERCEDES W251 AMG X253 (EMBLER) TECH,1779,9,0,1,10
2533200501 *A,AMORTIGUADOR AIRE SUSPENSION DELANTERA CON AMG (L) MERCEDES X253 (EMBLER) TECH,1497,1,0,7,8
2533200701 *A,AMORTIGUADOR AIRE SUSPENSIï¿½N DELANTERA (L) MERCEDESï¿½AMGï¿½X290 (EMBLER) TECH,1484,5,8,1,14
2533200801 *A,AMORTIGUADOR AIRE SUSPENSION DELANTERA (R) MERCEDESï¿½AMGï¿½X290 (EMBLER) TECH,1699,6,9,0,15
2533201101 *1,AMORTIGUADOR SUSPENSION DELANTERA (L) MERCEDES X253 (FREY),1204,7,2,3,12
2533201101 *2,AMORTIGUADOR SUSPENSION DELANTERA (L) MERCEDES X253 (EMBLER),1997,7,5,9,21
2533201201 *1,AMORTIGUADOR SUSPENSION DELANTERA (R) MERCEDES X253 (FREY),1475,6,7,9,22
2533201201 *2,AMORTIGUADOR SUSPENSION DELANTERA (R) MERCEDES X253 (EMBLER),1204,2,6,2,10
2533201530 *1,AMORTIGUADOR SUSPENSION TRASERA (L/R) MERCEDES X253 (FREY),1837,9,6,1,16
2533207600 *A,AMORTIGUADOR AIRE CON ADS SUSPENSION TRASERA (L/R) MERCEDES W253 (EMBLER) TECH,1689,0,6,3,9
2533230117 *1,TORNILLO ESTABILIZADOR SUSPENSION DELANTERA (L) MERCEDES X253 (FREY),1290,3,6,8,17
2533230217 *1,TORNILLO ESTABILIZADOR SUSPENSION DELANTERA (R) MERCEDES X253 (FREY),1674,7,9,6,22
2539052400 *1 ,SENSOR FRENOS ABS TRASERO (R) MERCEDES X253 (FREY),1347,3,8,9,20
2539052500 *1,SENSOR FRENOS ABS TRASERO (L) MERCEDES X253 (FREY),1770,3,5,7,15
2539053400 *1 ,SENSOR FRENOS ABS DELANTERO (R ) MERCEDES X253 (FREY),1468,4,3,1,8
2539053500 *1,SENSOR FRENOS ABS DELANTERO (L) MERCEDES X253 (FREY),1648,4,3,2,9
2539800064 *1,AMORTIGUADOR CAJUELA 560 NEWTONS 613 MM (L/R) MERCEDES X253 (FREY),1708,7,2,9,18
2539801164 *1,AMORTIGUADORE COFRE FUERZA 270 NEWTONS 682 MM (L) MERCEDES BENZ X253 FREY,1668,2,0,9,11
2539801264 *1,AMORTIGUADOR COFRE FUERZA 240 NEWTONS 682 MM (R) MERCEDES BENZ X253 FREY,1764,1,6,3,10
2560700187,INYECTOR DE GASOLINA DE BOQUILLA MERCEDES A200 BOSCH,1688,3,9,1,13
2560705600 *5,INYECTOR COMBUSTIBLE GASOLINA ALTA PRESION MERCEDES W205 W222 W246 W463 X253 (BOSCH) SSF,1478,1,2,8,11
259971647,RETEN INTERIOR DE RUEDA DELANTERA ( L / R ) MERCEDES W210 ( BMTRS ),1549,0,6,1,7
26107526116 *1 ,FLECHA CARDAN CON TRASMISION AUTOMATICA 147 MM BMW E81 E82 E87 E88 N46N (FREY),1600,0,3,3,6
26111225624,JUNTA DE GOMA CARDAN BMW E81 78X110 MM URO,1682,9,8,7,24
26111225624 *1,JUNTA GOMA CARDAN 78X28X10 BMW E36 E46 E60 E81 E84 E85 E90 MINI R60 R61 (FREY),1309,1,9,9,19
26111227410 *1 ,JUNTA GOMA CARDAN 78X32X12 MM BMW E36 E46 Z3 (FREY),1974,2,1,7,10
26111227410 *5,JUNTA GOMA CARDAN 78X32X12 MM BMW E36 E46 Z3 (FEBI) SSF,1205,1,2,3,6
26111227410 *6,JUNTA GOMA CARDAN 78X32X12 MM BMW E36 E46 Z3 (SGF) SSF,1491,3,4,9,16
26111229065,JUNTA DE GOMA CARDAN 105 MM BMW E38-M62 BMTR,1566,6,2,7,15
26111229065-1,JUNTA DE GOMA CARDAN 105 MM BMW E38-M62 FREY,1636,4,1,8,13
26111229360 *2,JUNTA GOMA CARDAN 96X30X12 MM BMW E36 E46 E53 E70 E81 E84 E85 E89 E90 F10 F15 F16 F22 F25 F26 F30 F32 (EMBLER),1255,1,1,7,9
26111229564,FLECHA CARDAN TRANSMISION AUTOMATICA BMW 1418 MM SEMINUEVO ORIGINAL,1980,0,7,3,10
26111229564 *1,FLECHA CARDAN TRANSMISION AUTOMATICA BMW 1418 MM (FREY),1257,6,7,2,15
26117503159,JUNTA DE GOMA CARDAN DELANTERO BMW E53-E70-E71 BMTRS,1409,8,0,5,13
26117503159-1,JUNTA DE GOMA CARDAN DELANTERO BMW E53-E70-E71 FEBI,1496,0,2,8,10
26117503159-2,JUNTA DE GOMA CARDAN DELANTERO BMW E53-E70-E71 FREY,1463,5,6,5,16
26117511454 *1,JUNTA GOMA CARDAN 96X30X12 MM BMW E36 E46 E53 E70 E81 E84 E85 E89 E90 F10 F15 F16 F22 F25 F26 F30 F32 (FREY),1537,3,5,2,10
26117511454 *2,JUNTA DE GOMA CARDAN 96 MM BMW E46-M54 GENUINO,1522,9,1,9,19
26117522027 *1,JUNTA GOMA CARDAN 96X32X12 MM BMW E60 E63 F10 F30 F30 G01 G11 G20 G29 (FREY),1377,9,1,0,10
26117526611 *1,BUJE CENTRAL DE GOMA CARDAN BMW E46-M54 FREY,1385,7,3,5,15
26117526611 *2,BALERO BUJE DE PUNTA DE FLECHA CARDAN BMW E46 (CORTECO),1364,7,7,2,16
26117542238 *1,JUNTA DE GOMA CARDAN BMW E60 (FREY),1922,9,1,5,15
26117546425,JUNTA DE GOMA CARDAN 105 MM BMW E90-N54 GENUINA,1676,1,9,2,12
26117610061 *1,JUNTA DE GOMA CARDAN 105 MM BMW E90-N54 FREY,1911,9,2,5,16
26121226731 *1,SOPORTE CHUMACERA BALERO CARDAN BMW E36 (FREY),1444,0,3,9,12
26121226731-9,SOPORTE CENTRAL DE CARDAN BMW E36-M52 BMTR,1242,9,7,2,18
26121229089,SOPORTE DE CARDAN  BMW E36  (TOPRAN),1803,5,7,7,19
26121229317 *1,SOPORTE CHUMACERA BALERO CARDAN BMW E36 E46 (FREY),1435,8,2,1,11
26121229492-4,SOPORTE DE CARDAN  BMW E46-M54 (TOPRAN),1627,4,2,3,9
26121229726 *1,SOPORTE CENTRAL BALERO FLECHA CARDAN TRASERA BMW E53 (FREY),1927,2,0,5,7
26121229726-100,SOPORTE CENTRAL DE FLECHA CARDAN BMW E53 BMTR INACTIVO,1266,0,7,4,11
26127501257 *1,SOPORTE CENTRAL BALERO FLECHA CARDAN BMW E39 E46 E85 E86 (FREY),1929,3,3,2,8
26127521855,SOPORTE CENTRAL DE CARDAN BMW E83-M54 BMTR,1903,1,4,3,8
26127521855 *1,SOPORTE CENTRAL BALERO FLECHA CARDAN BMW E83-M54 (FREY),1922,0,6,1,7
26127521855-3,SOPORTE CENTRAL DE CARDAN BMW E83-M54 URO,1431,9,2,3,14
26127558745,BALERO CARDAN BMW E70 E71 E72 F15 F16 F25 F26 (VERMO),1343,9,5,2,16
26127558745-1,BALERO CARDAN BMW E71 (FREY),1427,8,7,6,21
26128615621,SOPORTE CENTRAL DE CARDAN BMW F30 / N20 ( BMTR ),1485,2,8,6,16
26128615621 *1,SOPORTE CARDAN BALERO BMW E84 E87 E90 F20 F25 F30 F32 (FREY),1868,7,9,0,16
26128615621 *2,SOPORTE CENTRAL DE CARDAN BMW F30 / N20 TOPRAN,1328,3,2,2,7
26198491,METALES DE CENTRO AUDI A3 / A4 / 2.0 ( BMTR ),1890,1,7,6,14
26198491-1,METALES DE CENTRO AUDI A3-A4-2.0 KOLBENSCHMIDT,2000,7,8,0,15
26207589985 *1,EJE TRANSMISION DELANTERO (L/R) BMW F25 F26 (FREY),1955,2,9,6,17
26207597649 *1,FLECHA CARDAN DELANTERO 709 MM BMW E70 E71 E72 F15 F16 F85 F86 (FREY),1348,2,8,5,15
2640380100,METALES DE BIELA DE MERCEDES W170 M270 W203 M271 KOLBENSCHMIDT,1270,3,1,6,10
2640940100 *1,FILTRO ENTRADA AIRE MOTOR MERCEDES W205 X253 W213 M274 (FREY),1839,0,6,5,11
2640940100 *2,FILTRO ENTRADA AIRE MOTOR MERCEDES W205 X253 W213 M274 (EMBLER),1811,8,5,5,18
2640940100 *3,FILTRO ENTRADA AIRE MOTOR 173 X 355 MM MERCEDES W205 W213 (MAHLE LX4872) DGO,1245,4,8,7,19
2642000301 *1,BOMBA AGUA ENFRIAMIENTO MOTOR MERCEDES C257 W167 W205 W213 W253 W463 (FREY),1926,7,6,6,19
2642001501 *1,TERMOSTATO ELECTRONICO ENFRIAMIENTO MOTOR MERCEDES M264 2.0 L (FREY),1269,4,0,6,10
2642008600 *1,TUBO AGUA TERMOSTATO MERCEDES W213 W167 M264 (FREY),1813,4,0,2,6
2649061200 *1,BOBINA ENCENDIDO IGNICION MOTOR MERCEDES M177 M256 M264 M274 M276 (FREY),1496,9,3,7,19
2660940004 *3,FILTRO ENTRADA AIRE MOTOR MERCEDES W245 (MAHLE LX1652),1546,1,4,8,13
2660940004-2,FILTRO ENTRADA AIRE MOTOR MERCEDES W245 MANN C2287,1963,8,3,1,12
2661410525 *2,CUERPO DE ACELERACIï¿½N DE TRANSMISION AUTOMATICA MERCEDES W245 (EMBLER),1341,6,7,3,16
2661410525-1,CUERPO DE ACELERACIï¿½N DE TRANSMISION AUTOMATICA MERCEDES W245 FREY,1981,8,8,6,22
2661500218 *3,KIT 4 PZ CABLES BUJIA IGNICION MERCEDES W245 W169 M266 TURBO (WALKER) ML,1842,6,3,9,18
2661500218-1,KIT DE CABLES PARA BUJIA MERCEDES W245-W169 CAMBIARE,1810,1,2,5,8
2661500218-2,KIT DE CABLES PARA BUJIA MERCEDES W245-W169 FREY,1625,6,5,6,17
2661800009 *1,FILTRO ACEITE MOTOR MERCEDES 60X90 MM M266 (FREY),1492,6,1,8,15
2661800009 *3,FILTRO ACEITE MOTOR MERCEDES 60X90 MM M266 (MAHLE) DGO,1926,7,2,6,15
2661800009-1,FILTRO ACEITE MOTOR MERCEDES W245 MANN HU612/1X,1959,8,4,4,16
2662000820,BOMBA AGUA MECANICA ENFRIAMIENTO MOTOR MERCEDES W169 W245 M266 (BMTR),1589,4,2,7,13
2662000820-1,BOMBA AGUA MECANICA ENFRIAMIENTO MOTOR MERCEDES W169 W245 M266 (METELLI ALEMAN),1876,1,7,4,12
2662000820-2,BOMBA AGUA MECANICA ENFRIAMIENTO MOTOR MERCEDES W169 W245 M266 (GRAF),1784,3,8,9,20
2662030575 *3,TERMOSTATO DE MOTOR MERCEDES W245-W169 2.0L (MAHLE TI1487) DGO,1405,8,6,4,18
2662030675 *1,TERMOSTATO ENFRIAMIENTO MOTOR MERCEDES M266 (FREY),1883,5,6,4,15
268533001 *6,KIT 4 PZ CABLES IGNICION BUJIAS DE SILICON A 7MM MINI R50 R52 R53 W10 W11 (KARLYN) SSF,1208,2,0,5,7
2700100113 *1,CARTER ALUMINIO ACEITE MOTOR MERCEDES W270 (FREY),1693,6,8,9,23
2700160020,JUNTA CABEZA MOTOR MEDIDA STANDAR 0.85 MM MERCEDES M270 ELRING,1340,8,1,1,10
2700160020 *1,JUNTA CABEZA MOTOR MEDIDA STANDAR 0.85 MM MERCEDES M270 (FREY),1262,1,0,6,7
2700300024C,KIT ANILLOS DE MOTOR STD 83 MM PARA 4 PISTONES MERCEDES W176 W204 W205 W212 W246 X156 X204 (FREY),1832,9,7,2,18
2700300124,KIT DE AROS DE PISTON MB W176 W205 C117 X156 KOLBENSCHMIDT,1422,0,1,7,8
2700380110 *1,KIT 8 PZ METALES BIELA MEDIDA ESTANDAR MERCEDES W176 W205 W246 X156 (FREY),1613,6,0,4,10
2700500100 *3,1 PZ VALVULA ESCAPE GASES CABEZA MOTOR 25X6 MM MERCEDES W205 W212 X204 (BGA),1990,9,1,1,11
2700500111 *5,TENSOR DE CADENA DE DISTRIBUCION MERCEDES W176-M270 (FEBI) SSF,1793,7,0,4,11
2700500111-1,TENSOR DE CADENA DE DISTRIBUCION MERCEDES W176-M270 FREY,1974,5,9,5,19
2700501100 *5,GUIA CADENA DISTRIBUCION MOTOR (L) MERCEDES M270 (GENUINA),1565,9,2,7,18
2700506100 *1,ENGRANE VARIADOR VVT ARBOL LEVAS ADMISION MERCEDES W205 W212 W213 (FREY),1779,3,2,2,7
2700506200 *1,ENGRANE VARIADOR ARBOL LEVAS VVT ESCAPE MERCEDES M270 (FREY),1624,4,9,0,13
2700700501 *2,BOMBA GASOLINA ALTA PRESION CONECTOR ANCHO MERCEDES C117 W176 W246 X156 (EMBLER),1519,5,0,0,5
2700900282 *1,MANGUERA DE ENTRADA DE AIRE MERCEDES W117 W246 M270 ( FREY),1465,8,6,1,15
2700900382 *1,MANGUERA ENTRADA AIRE MOTOR MERCEDES W176 W246 (FREY),1224,3,4,7,14
2700940004 *1,FILTRO ENTRADA AIRE MOTOR MERCEDES W176 (FREY),1302,4,6,6,16
2700940004 *3,FILTRO ENTRADA AIRE MOTOR MERCEDES W176 (MAHLE LX3477),1453,2,4,5,11
2700940004-1,FILTRO ENTRADA AIRE MOTOR MERCEDES W176 MANN C27004,1845,8,1,9,18
2700940004-2,FILTRO ENTRADA AIRE MOTOR MERCEDES W176 PERFORMANCE,1336,2,2,4,8
2701800109 *1,FILTRO ACEITE MOTOR MERCEDES M270 M274 (FREY),1434,2,6,0,8
2701800109 *5,FILTRO ACEITE MOTOR MERCEDES M270 M274 (MANN HU7044Z) SSF,1295,9,4,6,19
2701800109 *6,FILTRO ACEITE MOTOR MERCEDES M270 M274  (HENGST) SSF,1992,9,0,7,16
2701800109 *7,FILTRO ACEITE MOTOR MERCEDES M270 M274 (UFI) SSF,1919,8,0,5,13
2701800810 *1,ENFRIADOR CON TOMA ACEITE MOTOR MERCEDES 270 M274 (FREY),1330,1,1,2,4
2701800810 *2,ENFRIADOR CON TOMA ACEITE MOTOR MERCEDES 270 M274 (CALIDAD ORIGINAL),1918,2,1,8,11
2701800810 *3,ENFRIADOR CON TOMA ACEITE MOTOR MERCEDES 270 M274 (METZGER),1251,0,3,3,6
2701800810-100,ENFRIADOR DE ACEITE DE MOTOR MERCEDES M270 INACTIVO,1771,6,8,9,23
2701800810B,ENFRIADOR SIN TOMA ACEITE MOTOR MERCEDES M270 M274 (FREY),1375,2,1,0,3
2701800901 *2,BOMBA REFORZADORA VACIO FRENOS MERCEDES W176 W205 W212 W213 W448 X204 X253 X156 (EMBLER),1819,5,4,4,13
2701840280 *3,3 PZ JUNTA ENFRIADOR FILTRO ACEITE MOTOR MERCEDES M112 M113 (SORTECH),1722,6,1,2,9
2702000000 *1,BOMBA AGUA MECANICA ENFRIAMIENTO MOTOR MERCEDES W176 W246 M270 (FREY),1317,5,8,6,19
2702000370 *1,TENSOR BANDA ACCESORIOS MOTOR MERCEDES M133 M139 M260 M270 M282 (FREY),1534,6,5,6,17
2702000600 *1,BOMBA AGUA ENFRIAMIENTO MOTOR MERCEDES W176 W246 X156 (FREY),1771,6,8,2,16
2702000615-100,TERMOSTATO DE MOTOR MERCEDES W246 INACTIVO,1867,3,9,0,12
2702001600 *1,VALVULA CONTROL AGUA MOTOR MERCEDES W176 W246 X156 (FREY),1360,2,5,4,11
2702002200 *1,TERMOSTATO ENFRIAMIENTO MOTOR MERCEDES W176 W246 C117 X156 M270 (FREY),1466,6,1,9,16
2702030800 *1,MANGUERA RADIADOR ENFRIAMIENTO MOTOR MERCEDES W176 W246 X156 (FREY),1894,9,2,0,11
2702031682 *1,MANGUERA DE RADIADOR MERCEDES C117 W176 W246 X156 (FREY),1944,2,9,4,15
2709050400 *1,SENSOR ARBOL LEVAS MOTOR MERCEDES M270 M274 (FREY),1438,3,2,5,10
2709050600 *1,SENSOR CIGUEï¿½AL MOTOR MERCEDES M133 M139 M260 M264 M270 M264 M274 M282 (FREY),1783,1,3,9,13
2709060500 *1,BOBINA IGNICION ENCENDIDO MERCEDES M270 (FREY),1935,7,0,7,14
2709060500 *5,BOBINA IGNICION ENCENDIDO MERCEDES M270 (BOSCH) SSF,1513,2,9,1,12
2709060500-100,BOBINA DE IGNICION MERCEDES W176 BOSCH INACTIVO,1675,0,2,2,4
2710101730 *1,TAPA PUNTERIAS MOTOR MERCEDES W204 W212 (FREY),1825,0,4,1,5
2710140004,RETEN TRASERO DE CIGUEï¿½AL CON BRIDA MERCEDES W203 / M271 ( ORIGINAL ),1544,5,5,7,17
2710140004 *1,RETEN TRASERO DE CIGUEï¿½AL CON BRIDA MERCEDES W203-M271 FREY,1412,8,5,2,15
2710140004-1,RETEN TRASERO DE CIGUEï¿½AL CON BRIDA MERCEDES W203 / M271 ( BMTR ),1673,6,6,0,12
2710160121 *1,JUNTA TAPA PUNTERIAS MOTOR MERCEDES M271 (FREY),1791,4,5,7,16
2710160321,JUNTA DE TAPA DE PUNTERIAS MERCEDES W203-W211 M271,1261,7,9,1,17
2710160921,JUNTA DE TAPA DE PUNTERIAS MERCEDES W203-W211 M271 CORTECO,1931,6,2,5,13
2710160921 *1,JUNTA TAPA PUNTERIAS MERCEDES M271 1a GEN. (FREY),1867,5,3,8,16
2710161120 *1,JUNTA CABEZA MOTOR MEDIDA STANDAR 0.60 MM MERCEDES M271 1a GEN KOMPRESSOR (FREY),1523,0,8,6,14
2710161221,JUNTA DE TAPA DE PUNTERIAS MERCEDES W204 TOPRAN,1966,7,1,1,9
2710161221 *1,JUNTA TAPA PUNTERIAS MOTO MERCEDES M271 2a GEN. TURBO (FREY),1765,7,2,9,18
2710161221-1,JUNTA DE TAPA DE PUNTERIAS MERCEDES W204 (EMBLER),1399,0,8,8,16
2710161520-1,JUNTA CABEZA MOTOR MEDIDA STANDAR 0.85 MM MERCEDES M271 (ELRING),1867,1,1,9,11
2710161520-3,JUNTA CABEZA MOTOR MEDIDA STANDAR 0.85 MM MERCEDES M271 (BGA),1491,2,6,5,13
2710181282,MANGUERA DE VENTILACION DE CARTER MERCEDES W203-M271 VAICO,1486,7,7,9,23
2710181282-1,MANGUERA DE VENTILACION DE CARTER MERCEDES W203-M271 FREY,1610,7,5,1,13
2710300003,POLEA DE CIGUEï¿½AL DAMPER MERCEDES W203 ( CORTECO ),1288,5,2,6,13
2710300003 *1,POLEA DE CIGUEï¿½AL DAMPER MERCEDES W203 FREY,1828,1,4,9,14
2710300040 *2,KIT 10 PZ. METALES BIELA MOTOR MEDIDA + 0.25 EN 10 MERCEDES W204 W211 (EMBLER),1950,8,5,5,18
2710300062,KIT 4 PZ MEDIAS LUNAS METALES MERCEDES W245 W203 W212 (KOLBENSCHMIDT),1804,5,9,6,20
2710300324,ANILLOS DE MOTOR STD X PISTON MERCEDES MOTOR 271 (KOLBENSCHMIT),1393,2,9,9,20
2710300324C,ANILLOS DE MOTOR STD 82 MM PARA 3 PISTONES MERCEDES W204 W212 (FREY),1516,8,8,4,20
2710300963 *1,GUIA INFERIOR CADENA DISTRIBUCION MERCEDES M271 (FREY),1515,8,8,0,16
27103455139,CAJA DE TRANSFERENCIA SIN MOTOR ACTUADOR BMW E83 (EMBLER) EBY,1477,4,2,7,13
2710500177,SENSOR MAGNETICO DE ARBOL DE LEVAS MERCEDES MOTOR 271 DORMAN ALEMAN,1936,6,4,9,19
2710500427,VALVULA DE ESCAPE MERCEDES W203 ORIGINAL,1261,3,7,4,14
2710500427-1,VALVULA DE ESCAPE MERCEDES W203 BGA,1483,3,5,9,17
2710500427-2,VALVULA DE ESCAPE MERCEDES W203 FREY,1739,8,8,3,19
2710500611 *1,TENSOR CADENA DISTRIBUCION TIEMPO IGNICION MERCEDES M271 1a GEN. (FREY),1259,3,9,3,15
2710500611 *2,TENSOR CADENA DISTRIBUCION TIEMPO IGNICION MERCEDES M271 1a GEN (EMBLER),1269,8,4,3,15
2710500611 *5,TENSOR CADENA DISTRIBUCION TIEMPO IGNICION MERCEDES M271 1a GEN (FEBI),1853,3,6,1,10
2710500800 *1,ENGRANE ARBOL LEVAS ADMISION MERCEDES M271 1a GEN KOMPRESSOR (FREY),1427,8,6,4,18
2710500900 *1,ENGRANE ARBOL LEVAS ESCAPE MERCEDES M271 1a GEN KOMPRESSOR (FREY),1958,3,4,3,10
2710500911 *1,TENSOR HIDRAULICO CADENA DISTRIBUCION MERCEDES M271 TURBO 2a GEN (FREY),1435,0,8,9,17
2710500911 *2,TENSOR CADENA DISTRIBUCION MERCEDES M271 TURBO 2a GEN (EMBLER),1205,5,7,5,17
2710500947,ENGRANE DE ARBOL DE LEVAS DE ADMISION MERCEDES W203-M271 BMTR,1511,8,8,1,17
2710500947-2,ENGRANE DE ARBOL DE LEVAS DE ADMISION MERCEDES W203-M271 DORMAN ALEMAN,1271,5,8,2,15
2710501047 *9,ENGRANE ARBOL LEVAS ADMISION MERCEDES M271 1a GEN KOMPRESSOR (BMTSR),1316,9,1,2,12
2710501047-2,ENGRANE DE ARBOL DE LEVAS DE ESCAPE MERCEDES W203-M271 DORMAN ALEMAN,1625,2,3,1,6
2710501127,VALVULA DE ESCAPE MERCEDES BENZ W204 BGA,1741,2,1,8,11
2710501127 *1,1 PZ VALVULA ESCAPE GASES CABEZA MOTOR 109.30X28 MM MERCEDES M271 TURBO 1.8 L (FREY),1606,8,5,8,21
2710501400 *1,ENGRANE ARBOL LEVAS ADMISION AIRE MOTOR VVT TURBO MERCEDES M271 2a GEN (FREY),1347,1,7,7,15
2710501400 *2,ENGRANE ARBOL LEVAS ADMISION AIRE MOTOR VVT MERCEDES M271 2a GEN TURBO (EMBLER) HPS,1962,9,1,1,11
2710501400-100,ENGRANE DE ARBOL DE LEVAS DE ADMISION MERCEDES W203-W204-M271 BEMQW INACTIVO,1523,4,2,9,15
2710501500 *1,ENGRANE ARBOL LEVAS ESCAPE GASES MOTOR VVT MERCEDES M271 2a GEN TURBO (FREY),1355,7,1,9,17
2710501500 *2,ENGRANE ARBOL LEVAS ESCAPE GASES MOTOR VVT MERCEDES M271 2a GEN TURBO (EMBLER) HPS,1576,8,6,2,16
2710510177,SENSOR MAGNETICO DE ARBOL DE LEVAS MERCEDES W204 - M271 ( GENUINO ),1482,3,6,8,17
2710510177 *1,SENSOR MAGNETICO DE ARBOL DE LEVAS MERCEDES W204 - M271 ( FREY ),1445,9,1,3,13
2710510177-2,SENSOR MAGNETICO DE ARBOL DE LEVAS MERCEDES W204-M271 ( PIERBUG ),1895,5,7,9,21
2710521416,GUIA DE CADENA MERCEDES L-R W204-W205 M271 GENUINA,1914,3,9,4,16
2710521416-1,GUIA DE CADENA MERCEDES L-R W204-W205 M271 FREY,1714,2,8,6,16
2710521616,GUIA DE CADENA MERCEDES SUPERIOR W204-W205 M271 GENUINA,1987,3,3,5,11
2710521616 *1,GUIA DE CADENA MERCEDES SUPERIOR W204-W205 M271 FREY,1408,2,9,3,14
2710530001,VALVULAS DE ADMISION MERCEDES W203  ORIGINAL,1914,9,6,1,16
2710530001*1,VALVULAS DE ADMISION MERCEDES M271  CORTECO,1453,3,0,2,5
2710530001-1,VALVULAS DE ADMISION MERCEDES W203 BGA,1873,7,6,6,19
2710530001-2,VALVULAS DE ADMISION MERCEDES W203 FREY,1413,2,0,6,8
2710530001-3,VALVULAS DE ADMISION MERCEDES W203 KZR,1700,4,7,8,19
2710531001,VALVULA DE ADMISION  MERCEDES  W204 C204 BGA,1569,2,9,5,16
2710531001 *1,1 PZ VALVULA ADMISIO AIRE CABEZA MOTOR 105.5X32 MM MERCEDES M271 TURBO 1.8 L (FREY),1804,5,3,5,13
27107535718,RETEN DE TRANSFER ( NV125 ) BMW E53  ( ORIGINAL ),1323,8,6,6,20
27107535718-1,RETEN DE TRANSFER ( NV125 ) BMW E53  FREY,1833,1,9,6,16
27107539265 *5,RETEN FLECHA TRASERA CAJA TRANSFERENCIA BMW E83 E53 E70 E71 (CORTECO) SSF,1276,2,8,1,11
27107539266 *5,RETEN FLECHA DELANTERA CAJA TRANSFERENCIA BMW F20 F22 E90 F32 E60 F06 F01 E84 E83 (CORTECO) SSF,1789,7,6,4,17
27107555297,ATC 500 TRANSFER(VTG),1310,4,1,2,7
2710756625-100,ENGRANE SERVOMOTOR NEGRO 55 DIENTES BMW E53 E83 E70 (EMBLER) INACTIVO,1793,8,2,5,15
27107566250 *B,ENGRANE BLANCO MANDO SERVOMOTOR BMW E53 E70 E71 E83 (EMBLER) GKA,1254,1,7,5,13
27107566250 *N,ENGRANE NEGRO SERVOMOTOR 55 DIENTES BMW E53 E70 E71 E83 (EMBLER) EBY,1962,8,9,4,21
27107566250 *S,SERVOMOTOR CAJA TRANSFERENCIA BMW E53 E70 E71 E83 (EMBLER) HPS,1709,8,7,3,18
27107566250-100,ENGRANE NEGRO SERVOMOTOR 55 DIENTES BMW E53 E83 E70 INACTIVO,1447,6,6,5,17
27107566250-101,ENGRANE DE SERVOMOTOR NEGRO 55 DIENTES BMW E53 E83 E70 (EMBLER) INACTIVO,1761,3,6,5,14
27107599889,ATC 700   TRANSFER (VTG),1779,5,2,7,14
2710780023,INYECTOR DE GASOLINA MERCEDES M271 OSSCA,1810,8,7,2,17
2710900282 *1,TUBO ENTRADA AIRE MOTOR MERCEDES W203 M271 KOMPRESSOR (FREY),1586,7,1,0,8
2710900382 *1,MANGUERA DE ENTRADA DE AIRE DE MOTOR MERCEDES BENZ W203 C230 03-05 FREY,1245,9,0,6,15
2710900582 *1,MANGUERA DE ENTRADA DE AIRE DE MOTOR MERCEDES W204-M272 FREY,1213,9,5,0,14
2710900982 *1,MANGUERA ENTRADA DE AIRE MOTOR MERCEDES W204 W212 (FREY),1410,0,1,4,5
2710903680B *1,CARTUCHO TURBO CARGADOR AIRE MOTOR MERCEDES M271 (FREY),1217,9,8,7,24
2710940204 *1,FILTRO ENTRADA AIRE MOTOR MERCEDES W203 1.8 L KOMPRESSOR (FREY TEGNOLOGIA ALEMANA),1280,4,0,0,4
2710940204 *3,FILTRO ENTRADA AIRE MOTOR MERCEDES W203 1.8 L L4  (MAHLE LX1277),1273,2,0,0,2
2710940204 *5,FILTRO ENTRADA AIRE MOTOR MERCEDES W203 1.8 L KOMPRESSOR (MANN ALEMAN) SSF,1226,1,3,1,5
2710940248 *1,SENSOR DE MASA DE AIRE MAF MERCEDES W203-M271 FREY,1874,7,2,8,17
2710940248 *5,SENSOR DE MASA DE AIRE MAF MERCEDES W203-271 (BREMI) SSF,1887,1,9,7,17
2710940248-1,SENSOR DE MASA DE AIRE MAF MERCEDES W203-M271 BMTR,1955,8,6,2,16
2710940248-2,SENSOR DE MASA DE AIRE MAF MERCEDES W203-M271 GENERICO,1879,5,7,2,14
2710940248-3,SENSOR DE MASA DE AIRE MAF MERCEDES W203-M271  (GENERICO ),1639,7,3,2,12
2710940304 *1,FILTRO ENTRADA AIRE MOTOR MERCEDES R172 W204 M271 2a GEN TURBO (FREY),1655,8,9,3,20
2710940304 *5,FILTRO ENTRADA AIRE MOTOR MERCEDES R172 W204 M271 2a GEN TURBO (MANN) SSF,1518,8,1,6,15
2710941382 *1,TUBO ENTRADA AIRE MOTOR MERCEDES R171 (FREY),1328,1,7,5,13
2711410783,MANGUERA DE AIRE DE MOTOR M271,1632,7,6,3,16
2711410880,JUNTA DE MULTIPLE DE ADMISION MERCEDES M271 VICTOR REINZ,1279,1,6,0,7
2711420380,JUNTA DE ESCAPE DE MOTOR MERCEDES W204-M271 VICTOR REINZ,1638,2,2,5,9
2711420380 *1,JUNTA ESCAPE MOTOR MERCEDES M271 (FREY),1231,8,9,9,26
2711500156,ARNES DE SENSOR MAGNETICO DE ARBOL DE LEVAS MERCEDES W164 GENUINO,1210,2,2,1,5
2711500156-1,ARNES DE SENSOR MAGNETICO DE ARBOL DE LEVAS MERCEDES W164 FREY,1416,7,2,2,11
2711550115,POLEA DE SOBREGIRO PARA ALTERNADOR MERCEDES W204 / M271 ( URO ),1485,6,8,6,20
2711550115-1,POLEA DE SOBREGIRO PARA ALTERNADOR MERCEDES W204 / M271 FREY,1968,9,4,6,19
2711560090 *1,SENSOR MAGNETICO DE ARBOL DE LEVAS MERCEDES W204 W212 (FREY),1568,5,5,9,19
2711560090-9,VARIADOR ELECTROIMAN DE ARBOLDE LEVAS CLASE W204 C204,1952,8,5,3,16
2711800109 *1,FILTRO ACEITE MOTOR MERCEDES M271 KOMPRESSOR 1a GEN (FREY),1710,8,3,3,14
2711800109 *5,FILTRO ACEITE MOTOR MERCEDES W203 1.8 L4 (MANN HU514X) SSF,1480,3,2,8,13
2711800238,CARCASA DE FILTRO DE ACEITE DE MOTOR MERCEDES W203 GENUINA,1957,5,3,6,14
2711800238 *1,CARCASA DE FILTRO DE ACEITE DE MOTOR MERCEDES W203 FREY,1587,5,8,1,14
2711800338,TAPA DE CARCASA FILTRO ACEITE MOTOR MERCEDES W204 - M271 2a GEN. TURBO ( GENUINO ),1258,9,1,7,17
2711800338 *1,TAPA CARCASA FILTRO ACEITE MOTOR MERCEDES M271 2a GEN. TURBO (FREY),1428,2,2,4,8
2711800338-100,TAPA DE CARCASA FILTRO DE ACEITE MERCEDES W204 - M271 2a GEN. TURBO ( OSSCA ) INACTIVO,1385,3,9,8,20
2711800409 *1,FILTRO ACEITE MOTOR MERCEDES M271 TURBO 2a GEN (FREY),1521,0,1,4,5
2711800509 *3,FILTRO ACEITE MOTOR MERCEDES M271 TURBO 2a GEN. (MAHLE OX183/5D1),1923,5,7,3,15
2711800509 *5,FILTRO ACEITE MOTOR MERCEDES M271 TURBO 2a GEN (HENGST) SSF,1325,3,3,2,8
2711800710 *1,BASE FILTRO ACEITE MOTOR MERCEDES M271 W212 W204 W211 (FREY),1403,4,5,8,17
2711801410 *1,BASE FILTRO ACEITE MOTOR MERCEDES M271 2a GEN TURBO (FREY),1863,1,3,1,5
2711801410B ,BASE ALUMINIO TOMA FILTRO ACEITE MOTOR MERCEDES M271 2a GEN TURBO (FREY),1333,2,9,5,16
2711840080,JUNTA DE ENFRIADOR DE ACEITE DE MOTOR MERCEDES W203-M271 VICTOR REINZ,1753,7,7,4,18
2711840080 *1,JUNTA ENFRIADOR ACEITE MOTOR MERCEDES M271 1a GEN KOMPRESSOR (FREY),1784,2,3,8,13
2711840180,EMPAQUE DE BASE DE FILTRO M271 ELRING,1870,1,6,8,15
2711840180 *1,EMPAQUE DE BASE DE FILTRO MERCEDES M271 (FREY),1800,5,8,6,19
2711840280 *1,KIT 5 PZ JUNTAS BASE FILTRO ACEITE MOTOR MERCEDES M271 2a GEN TURBO (FREY),1903,3,4,8,15
2711880301-100,ENFRIADOR DE ACEITE DE MOTOR MERCEDES W212-S212 FREY INACTIVO,1778,8,3,1,12
2711880401,ENFRIADOR DE ACEITE DE MOTOR MERCEDES W203 EMBLER,1910,6,7,9,22
2711880401 *1,ENFRIADOR ACEITE MOTOR MERCEDES M271 2a GEN TURBO (FREY),1573,8,2,4,14
2712000015 *1,TERMOSTATO MOTOR ENFRIAMIENTO MOTOR MERDECES M271 (FREY),1486,2,3,9,14
2712000015 *3,TERMOSTATO MOTOR ENFRIAMIENTO MOTOR MERDECES M271 (MAHLE TX10690D) DGO,1912,5,1,7,13
2712000015 *5,TERMOSTATO DE MOTOR MERCEDES W203-W204 M271 (WAHLER) SSF,1661,2,9,6,17
2712000270,TENSOR DE BANDA DE ACCESORIOS MERCEDES W203-M271 BMTR,1533,6,0,0,6
2712000270 *1,TENSOR DE BANDA DE ACCESORIOS MERCEDES W203-M271 FREY,1276,5,0,8,13
2712000315,TERMOSTATO DE MOTOR MERCEDES W205 / M271 ( BMTR ),1244,8,2,9,19
2712000315 *1,TERMOSTATO ENFRIAMIENTO MOTOR MERCEDES M271 (FREY),1934,0,4,8,12
2712000315-1,TERMOSTATO DE MOTOR MERCEDES W205 / M271 ( WAHLER ),1382,9,7,3,19
2712000315-2,TERMOSTATO DE MOTOR MERCEDES W204 - M271 VAICO,1610,6,2,1,9
2712000315-3,TERMOSTATO DE MOTOR MERCEDES W204 - M271 BORG WARNER,1257,7,7,9,23
2712000315-5,TERMOSTATO DE MOTOR MERCEDES W204 - M271 BEMWQ,1314,9,5,2,16
2712000315-6,TERMOSTATO DE MOTOR MERCEDES MOTOR M271 OSSCA,1367,8,6,2,16
2712000570 *1,POLEA RE ENVIO LISA 76X28X17 MM MERCEDES M271 KOMPRESSOR 1a GEN FREY,1555,6,4,4,14
2712000570-1,POLEA DE REENVIO MERCEDES W203-M271 FEBI,1397,4,9,1,14
2712001001 *1,BOMBA AGUA ENFRIAMIENTO MOTOR MERCEDES M271 1a GEN KOMPRESSOR (FREY),1312,6,5,2,13
2712001001 *2,BOMBA ENFRIAMIENTO MOTOR MERCEDES M271 1a GEN KOMPRESSOR (EMBLER),1210,7,0,4,11
2712001001 *3,BOMBA AGUA ENFRIAMIENTO MOTOR MERCEDES M271 1a GEN KOMPRESSOR (SALLERI),1625,1,2,4,7
2712001001 *4,BOMBA AGUA ENFRIAMIENTO MOTOR MERCEDES M271 1a GEN KOMPRESSOR (GRAF),1923,1,2,6,9
2712001256 *1,TOMA AGUA TERMOSTATO MERCEDES MOTOR M271 (FREY),1490,3,0,5,8
2712001256 *2,TOMA AGUA TERMOSTATO MERCEDES M271 (EMBLER),1293,9,6,4,19
2712001256 *3,TOMA DE AGUA DE TERMOSTATO MERCEDES MOTOR M271 (TOPRAN),1718,6,0,3,9
2712001352,TOMA DE AGUA DE CABEZA / ENFRIADOR DE ACEITE MERCEDES W203 / M271 ( VAICO ),1946,8,6,7,21
2712001352 *1,TOMA DE AGUA DE CABEZA/ENFRIADOR DE ACEITE MERCEDES W203-M271 FREY,1709,1,2,7,10
2712001352 -4,TOMA DE AGUA DE CABEZA/ENFRIADOR DE ACEITE MERCEDES W203-M271 EMBLER,1333,0,0,1,1
2712001352-1,TOMA DE AGUA DE CABEZA / ENFRIADOR DE ACEITE MERCEDES W203 / M271 ( REIN ),1484,5,6,4,15
2712001352-3,TOMA DE AGUA DE CABEZA/ENFRIADOR DE ACEITE MERCEDES W203-M271 TOPRAN,1523,6,6,7,19
2712001552,TUBO DE ALIMENTACION PARA LA CABEZA DE MOTOR MERCEDES W203 / M271 FEBI,1862,6,7,4,17
2712001552 *1,TUBO AGUA ENFRIAMIENTO CABEZA MOTOR CON SENSOR MERCEDES M271 (FREY),1827,2,1,4,7
2712001552-1,TUBO DE ALIMENTACION PARA LA CABEZA DE MOTOR MERCEDES W203-M271 GENUINO,1974,8,0,2,10
2712001552-2,TUBO DE ALIMENTACION PARA LA CABEZA DE MOTOR MERCEDES W203-M271 AFTERMARKET,1399,0,4,0,4
2712001552-4,TUBO DE ALIMENTACION PARA LA CABEZA DE MOTOR MERCEDES W203-M271 MEISTERSATZ,1377,7,5,3,15
2712001552-5,TUBO DE ALIMENTACION PARA LA CABEZA DE MOTOR MERCEDES W203-M271 TOPAZ,1437,4,8,9,21
2712002056 *1,MANGUERA DE AGUA CABEZA TERMOSTATO MERCEDES W204 W212 (FREY),1748,3,1,4,8
2712002352 *1,TUBO CURVO VENTILACION CARTER MOTOR SISTEMA PCV MERCEDES M271 (FREY),1440,1,5,7,13
2712002452,TUBO DE AGUA DE DISTRIBUCION MERCEDES C250 W204-R172 (EMBLER),1542,3,6,3,12
2712002452 *1,TUBO BOMBA AGUA ENFRIAMIENTO MERCEDES W204 R172 M271 (FREY),1574,9,3,4,16
2712002452-2,TUBO DE AGUA DE DISTRIBUCION MERCEDES C250 W204-R172 OSSCA,1874,3,3,7,13
2712020210 *1,POLEA BOMBA AGUA MECANICA ENFRIAMIENTO MOTOR MERCEDES W204 M271 (FREY),1823,8,1,1,10
2712020210 *9,POLEA DE BOMBA DE AGUA MERCEDES W204 M271 (GENUINA ),1558,9,6,9,24
2712030575-100,TERMOSTATO DE MOTOR MERCEDES W203-W204 M271 WAHLER INACTIVO,1874,5,4,6,15
2712030602,TUBO DE ALIMENTACION AGUA AL MONOBLOCK MERCEDES W203-M271  VAICO,1685,5,0,1,6
2712030602-1,TUBO DE ALIMENTACION AGUA AL MONOBLOCK MERCEDES W203-M271  FREY,1474,9,6,5,20
2712060019,POLEA DE REENVIO MERCEDES W203 M271 OPTIMAL,1372,3,5,1,9
2712060019 *1,POLEA DE REENVIO MERCEDES W203 M271 ( FREY ),1939,8,3,8,19
27127531519,RETEN DE TRANSFER ( NV125 ) BMW E53  ( ORIGINAL,1835,1,2,4,7
27127531519-1,RETEN DE TRANSFER ( NV125 ) BMW E53 ( FREY ),1352,6,4,1,11
27147531520,RETEN DE TRANSFER NV125 BMW E53 ORIGINAL,1393,4,6,3,13
27147531520-1,RETEN DE TRANSFER NV125 BMW E53 FREY,1828,1,5,4,10
271664,TERMOSTATO VOLVO OSSCA 850,1922,0,5,6,11
27166492,TERMOSTATO MAHLE,1261,6,3,6,15
2720100631,VALVULA PCV MERCEDES W203 - M272  BMTR,1299,1,9,4,14
2720100631 *1,VALVULA PCV MERCEDES W203 - M272  FREY,1800,4,0,8,12
2720100631-2,SEPARADOR DE ACEITE PCV MERCEDES M272 273 (EMBLER),1724,2,2,4,8
2720100814,RETEN DE CIGUEï¿½AL TRASERO MERCEDES MOTOR M272 ELRING,1940,3,8,5,16
2720100814 *1,RETEN DE CIGUEï¿½AL TRASERO MERCEDES MOTOR M272 FREY,1936,6,1,6,13
2720160120B,JUEGO JUNTAS MOTOR MERCEDES W203 W211 W251 R171 (FREY),1472,1,9,2,12
2720160720 *1,JUNTA CABEZA MOTOR (R) STANDAR 0.75 CILINDRO 89 MM MERCEDES M272 3.0 L (FREY),1819,7,6,2,15
2720160820 *1,JUNTA CABEZA MOTOR (L) STANDAR 0.75 CILINDRO 89 MM MERCEDES M272 3.0 L (FREY),1862,8,1,7,16
2720161320B,KIT 67 PZ JUEGO JUNTAS MOTOR SUPERIOR MEDIDA STD MERCEDES W204 W212 W221 (FREY),1638,2,7,5,14
2720161420 *9,JUNTA CABEZA MOTOR (R) STANDAR 0.75 CILINDRO 89 MM MERCEDES M272 3.0 L (GOETZE),1269,2,2,9,13
2720161520 *1,JUNTA CABEZA MOTOR (L) STANDAR 1.70 CILINDRO 94 MM MERCEDES M272 3.5 L (FREY),1782,7,7,7,21
2720161620,JUNTA CABEZA MOTOR (R) MEDIDA STANDAR 1.70 MM MERCEDES M272 BMTR,1361,0,0,4,4
2720161620 *1,JUNTA CABEZA MOTOR (R) STANDAR 1.70 CILINDRO 94 MM MERCEDES M272 3.5 L (FREY),1826,5,0,5,10
2720161620-2,JUNTA CABEZA MOTOR (R) MEDIDA STANDAR 1.70 MM MERCEDES M272 ELRING,1370,6,0,2,8
2720300003,POLEA DE CIGUEï¿½AL DAMPER MERCEDES W203 (VERMO),1676,2,9,4,15
2720300003-1,POLEA DE CIGï¿½Eï¿½AL DAMPER MERCEDES BENZ W203-W204/M272 FREY,1676,4,0,8,12
2720500111,TENSOR DE LA CADENA MERCEDES W204 / M72 ( FEBI ),1435,1,5,4,10
2720500111-1,TENSOR DE LA CADENA MERCEDES W204 / M72 FREY,1488,7,9,1,17
2720500578 *1,VALVULA SOLENOIDE  MERCEDES M272 SOLENOIDE FREY,1419,8,1,9,18
2720500811,TENSOR DE CADENA MERCEDES W203-M272 FEBI,1210,8,8,9,25
2720500811 *1,TENSOR CADENA SUPERIOR DISTRIBUCION MERCEDES M272 M273 (FREY),1741,8,5,9,22
2720500811-1,TENSOR DE CADENA MERCEDES W203-M272 DORMAN ALEMAN,1912,5,9,9,23
2720505247 *1,ENGRANE ARBOL LEVAS ADMISION AIRE MOTOR VVT (L) MERCEDES M272 (FREY),1852,2,4,7,13
2720505247 *2,ENGRANE ARBOL LEVAS ADMISION AIRE MOTOR VVT (L) MERCEDES M272 (EMBLER) HPS,1763,6,6,6,18
2720505347 *1,ENGRANE ARBOL LEVAS ADMISION AIRE MOTOR VVT (R) MERCEDES M272 (FREY),1334,7,8,6,21
2720505347 *2,ENGRANE ARBOL LEVAS ADMISION AIRE MOTOR VVT (R) MERCEDES M272 (EMBLER) HPS,1897,6,2,9,17
2720506847 *1,ENGRANE ARBOL LEVAS ESCAPE GASES MOTOR VVT (L/R) MERCEDES M272 (FREY),1595,8,4,0,12
2720506847 *2,ENGRANE ARBOL LEVAS ESCAPE GASES MOTOR VVT (L/R) MERCEDES M272 (EMBLER) HPS,1374,7,1,5,13
2720506847-100,ENGRANE ARBOL LEVAS ADMISION (R) MERCEDES M272 INACTIVO,1405,5,3,5,13
2720510177,SENSOR MAGNETICO DE ARBOL DE LEVAS MERCEDES MOTOR M272V V6 GENUINO,1850,0,9,7,16
2720510177 *1,SENSOR MAGNETICO ARBOL LEVAS MERCEDES M272 (FREY),1681,4,7,7,18
2720902882 *1,DUCTO MANGUERA ENTRADA AIRE MOTOR (R) MERCEDES X204 (FREY),1294,0,8,3,11
2720902982 *1,DUCTO MANGUERA ENTRADA AIRE MOTOR (L) MERCEDES X204 (FREY),1436,7,5,5,17
2720903582 *1,TUBO ENTRADA AIRE MOTOR IZQUIERDO MERCEDES W204 M72 M273 (FREY),1547,6,9,7,22
2720903682 *1,MANGUERA ENTRADA AIRE MOTOR MERCEDES W204 W212 (FREY),1750,9,1,4,14
2721402401 *1,MULTIPLE ADMISION AIRE MOTOR CON SELENOIDES SERVOS VACIO MERCEDES MOTOR M272 6 CIL FREY,1299,3,5,2,10
2721412280,JUNTA DE MULTIPLE DE ADMISION L MERCEDES W204 VICTOR REINZ,1745,0,8,5,13
2721412280-1,JUNTA DE MULTIPLE DE ADMISION L MERCEDES W204 ELRING,1929,9,7,6,22
2721412280-2,JUNTA DE MULTIPLE DE ADMISION L MERCEDES W204 FREY,1451,1,2,3,6
2721412380,JUNTA DE MULTIPLE DE ADMISION R MERCEDES W204 VICTOR REINZ,1663,6,1,5,12
2721412380 *1,JUNTA MULTIPLE ADMISION (R) MERCEDES M272 (FREY),1203,4,4,1,9
2721412380-1,JUNTA DE MULTIPLE DE ADMISION R MERCEDES W204-M272 BGA,1868,6,3,6,15
2721412380-2,JUNTA DE MULTIPLE DE ADMISION R MERCEDES W204-M272 ELRING,1819,4,6,0,10
2721530232 *1,SENSOR TEMPERATURA AIRE MULTIPLE ADMISION MERCEDES M272 M273 (FREY),1782,6,6,5,17
2721800038 *1,TAPA DE FILTRO ACEITE MOTOR MERCEDES W164 FREY,1493,7,8,4,19
2721800510 *1,ENFRIADOR BASE FILTRO ACEITE MOTOR MERCEDES M272 (FREY),1750,4,3,7,14
2721840080 *1,JUNTA CARCASA TOMA FILTRO ACEITE MOTOR MERCEDES M272 (FREY),1516,3,6,5,14
2721840080 *5,JUNTA CARCASA BASE FILTRO ACEITE MOTOR MERCEDES M272 (VICTOR REINZ) SSF,1728,5,4,9,18
2721840080 *9,JUNTA DE BASE DE FILTRO ACEITE MOTOR MERCEDES W204-M272  (ELRING ),1978,8,5,5,18
2721840280,JUNTA DE ENFRIADOR DE ACEITE DE MOTOR MERCEDES W203-M72 VICTOR REINZ,1574,9,7,5,21
2721840280 *1,JUNTA DE ENFRIADOR DE ACEITE DE MOTOR MERCEDES W203-W204 M272 FREY,1949,9,9,7,25
2721840280-1,JUNTA DE ENFRIADOR DE ACEITE DE MOTOR MERCEDES W203-W204 M272 ELRING,1671,6,8,9,23
2721840280-3,JUNTA DE ENFRIADOR DE ACEITE DE MOTOR MERCEDES W203-W204 M272 OSSCA,1721,4,6,8,18
2721840280-4,JUNTA DE ENFRIADOR DE ACEITE DE MOTOR MERCEDES W203-W204 M272 TOPRAN,1591,0,2,3,5
2721880001 *1,ENFRIADOR ACEITE MOTOR MERCEDES M272 (FREY),1265,1,5,2,8
2721880001-100,ENFRIADOR DE ACEITE DE MOTOR MERCEDES W203-M272 FREY INACTIVO,1788,3,1,3,7
2722000114,AMORTIGUADOR PARA BANDA DE TENSOR MERCEDES MOTOR M272 FEBI,1665,1,8,7,16
2722000114 *1,AMORTIGUADOR PARA BANDA DE TENSOR MERCEDES MOTOR M272 FREY,1454,5,3,3,11
2722000270 *1,TENSOR BANDA ACCESORIOS POLEA 76X26X17 MM MERCEDES M272 M273 (FREY),1743,6,0,5,11
2722000270-100,TENSOR DE BANDA DE ACCESORIOS MERCEDES W204-M272 ( FREY ) INACTIVO,1953,7,3,5,15
2722000270B,POLEA LISA BANDA ACCESORIOS 76X26X17 MM MERCEDES M272 M273 (FREY),1290,5,4,8,17
2722000415 *1,TERMOSTADO ENFRIAMIENTO MOTOR MERCEDES M272 M273 (FREY),1874,0,9,9,18
2722000415-100,TERMOSTATO DE MOTOR MERCEDES W204 - M272 INACTIVO,1845,8,7,7,22
2722000901 *1,BOMBA AGUA MECANICA ENFRIAMIENTO MOTOR MERCEDES M272 M273 (FREY),1704,6,9,5,20
2722000901 *2,BOMBA AGUA MECANICA ENFRIAMIENTO MOTOR MERCEDES MOTOR M272 (EMBLER) HT,1268,7,4,5,16
2722020000,POLEA DE RE ENVIO RAYADA MERCEDES W203 / M272 ( URO ),1292,4,4,9,17
2722020000-1,POLEA DE RE ENVIO RAYADA MERCEDES W203 - M272 INA,1628,2,5,3,10
2722020119,POLEA INVERSION INA,1541,3,7,2,12
2722021019 *1,POLEA DE RE ENVIO RAYADA 64X23X17 MM MERCEDES W163 W204 W221 W251 SPRINTER W901-W906 (FREY),1487,1,7,5,13
2722021419,POLEA DE REENVIO LISA DE UN CANAL MERCEDES W203 / M272 ( INA ),1993,7,6,4,17
2722021419 *1,POLEA LISA UN CANAL RE ENVIO 70X22X8 MM MERCEDES M272 M273 (FREY),1664,1,9,3,13
2722021419-1,POLEA DE REENVIO LISA DE UN CANAL MERCEDES W203 / M272 ( URO ),1989,5,6,7,18
272395,JUEGO DE JUNTAS DE ESCAPE VOLVO S80 VICTOR REINZ,1833,3,4,6,13
272461 *5,KIT 4 JUNTAS MULTIPLE ESCAPE MOTOR VOLVO C70 S60 S70 S80 V70 XC70 XC90 (VICTOR REINZ) SSF,1598,6,1,7,14
2729050043,SENSOR DE ARBOL DE LEVAS MERCEDES W204-M272 BOSCH,1360,4,3,2,9
2729050043 *1,SENSOR ARBOL LEVAS (L/R) MERCEDES M271 M272 M273 SPRINTER OM611 (FREY),1791,9,0,7,16
2729050043 *2,SENSOR DE ARBOL DE LEVAS MERCEDES W204 - M272 FAE,1664,0,9,0,9
2729060060 *2,BOBINA DE IGNICION MERCEDES W204-M272 BMTR,1762,5,4,1,10
2729060060-1,BOBINA DE IGNICION MERCEDES W204-M272 BERU ZSE140,1518,9,3,8,20
2729060060-100,BOBINA ENCENDIDO IGNICION MERCEDES BENZ M272 M273 INACTIVO,1333,8,8,9,25
2730940404 *1,KIT 2 PZ FILTRO ENTRADA AIRE MOTOR MERCEDES M112 M113 M272 M273 (FREY),1646,0,4,1,5
2730940404 *3,KIT 2 PZ FILTRO ENTRADA AIRE MOTOR MERCEDES M112 M113 M272 M273 (MAHLE LX804/S),1372,5,8,0,13
2730940404 *5,KIT 2 PZ FILTRO ENTRADA AIRE MOTOR MERCEDES M112 M113 M272 M273 (HENGST) SSF,1481,5,5,6,16
2730940404 *6,FILTRO ENTRADA AIRE MOTOR 2 PZS MERCEDES W203 (MANN C3698/3-2) SSF,1202,5,5,2,12
2730940404-3,FILTRO ENTRADA AIRE MOTOR MERCEDES W203 VALEO,1512,5,3,6,14
2730940404-6,FILTRO ENTRADA AIRE MOTOR MERCEDES W203 (MULLER),1976,2,4,0,6
2730940848,SENSOR DE MASA DE AIRE MAF MERCEDES W204-M272 V6 BMTR,1227,3,5,5,13
2730940848-1,SENSOR DE MASA DE AIRE MAF MERCEDES W204-M272 V6 BOSCH,1368,5,2,9,16
2730940848-2,SENSOR DE MASA DE AIRE MAF MERCEDES W204-M272 V6 BREMI,1555,2,3,2,7
2730940948 *1,SENSOR DE MASA DE AIRE MAF MERCEDES W204-M272 V6 FREY,1576,3,4,8,15
2731400701,KIT SERVOS DE VACIO PARA MULTIPLE DE ADMISION MERCEDES M273 BMTR,1676,8,6,8,22
2731400701 *1,MODULO COLECTOR DE ADMISION MERCEDES M273 (FREY),1919,3,8,8,19
2731400701B,KIT SERVOS DE VACIO PARA MULTIPLE DE ADMISION MERCEDES M273 (FREY),1844,6,6,5,17
2732000201 *1,BOMBA AGUA ENFRIAMIENTO MOTOR MERCEDES MOTOR M273 (FREY),1206,2,9,5,16
2732000201 *2,BOMBA AGUA MECANICA ENFRIAMIENTO MOTOR MERCEDEZ M273 (EMBLER) HT,1244,7,3,9,19
2740700501,BOMBA DE GASOLINA DE ALTA PRESION REMANUFACTURADA MERCEDES C300 GENUINA,1706,3,9,3,15
2740700501 *1,BOMBA GASOLINA COMBUSTIBLE ALTA PRESION MERCEDES M274 (FREY),1977,9,2,7,18
2740903280B,CARTUCHO TURBO CARGADOR AIRE MOTOR MERCEDES M274 (FREY),1732,8,1,7,16
2740940004 *1,FILTRO ENTRADA AIRE MOTOR MERCEDES W204 MANN C14006 REDONDO FREY),1272,4,5,8,17
2740940004 *3,FILTRO ENTRADA AIRE MOTOR MERCEDES W204 (MAHLE LX3775),1445,7,8,1,16
2740940104 *3,FILTRO ENTRADA AIRE MERCEDES MOTOR W205 M274  (MAHLE LX3811) DAG,1763,0,7,7,14
2740940104 *5,FILTRO ENTRADA AIRE MOTOR MERCEDES W205 M274 (MANN) SSF,1466,4,4,9,17
2740940204 *1,FILTRO ENTRADA AIRE MOTOR MERCEDES W205 M274 (FREY),1318,2,9,9,20
2742000256 *1,MANGUERA DE BOMBA DE AGUA MERCEDES W205 W212 W213 X253 W448 (FREY),1355,0,6,3,9
2742000256 *3,MANGUERA DE BOMBA DE AGUA MERCEDES W205 W212 W213 X253 W448 (VERMO),1304,4,3,2,9
2742000701 *1,BOMBA AGUA MECANICA ENFRIAMIENTO MOTOR MERCEDES W204 W205 W212 W213 R172 X253 M274 (FREY),1495,6,5,6,17
2742000900 *1,BOMBA AGUA MECANICA ENFRIAMIENTO MOTOR MERCEDES W204 W205 W212 R172 X253 M274 (FREY),1586,4,7,6,17
2742001270 *1,TENSOR DE BANDA DE ACCESORIOS MERCEDES X204-M274 FREY,1863,3,9,3,15
2742001270-9,TENSOR DE BANDA DE ACCESORIOS MERCEDES X204-M274 BMTR,1769,3,4,7,14
2742002700 *1,BOMBA AGUA ELECTRICA ENFRIAMIENTO MOTOR MERCEDES W204 W205 W212 W213 R172 X253 M274 (FREY),1716,4,6,7,17
2742003100 *1,TERMOSTATO ENFRIAMIENTO MOTOR MERCEDES M274 (FREY),1858,1,2,3,6
2742003300 *1,TERMOSTATO ENFRIAMIENTO DE MOTOR MERCEDES W204 W205 M274 (FREY),1282,9,6,7,22
2742020019 *1,POLEA CIGUEï¿½AL DAMPER MOTOR MERCEDES W176 W204 W205 W212 W246 X156 X204 (FREY),1435,9,0,1,10
2742020019 *3,POLEA CIGUEï¿½AL DAMPER MOTOR MERCEDES W176 W204 W205 W212 W246 X156 X204 (SORTECH),1333,8,8,8,24
2749061400 *1,BOBINA ENCENDIDO IGNICION MOTOR MERCEDES M274 (FREY TECNOLOGIA ALEMANA),1524,5,2,2,9
2749061400-100,BOBINA DE IGNICION MERCEDES W205-M274 GENUINA INACTIVO,1744,5,4,0,9
2751800009,FILTRO ACEITE MOTOR MERCEDES W220 MANN HU7213X,1595,9,3,6,18
2752000101,BOMBA AGUA ENFRIAMIENTO MOTOR MERCEDES M137 V12 5.8L M275 V12 6.0 M279 V12 6.0L (BMTR),1779,1,4,9,14
2752000101 *1,BOMBA AGUA ENFRIAMIENTO MOTOR MERCEDES M137 V12 5.8L M275 V12 6.0 M279 V12 6.0L (FREY),1967,6,4,4,14
2759050000,SENSOR DE NIVEL DE ACEITE MERCEDES W203 / W215 / W208 / W210 / W163 ( GENUINO ),1969,0,1,5,6
2759050000 *1,SENSOR DE NIVEL DE ACEITE MERCEDES W203 / W215 / W208 / W210 / W163 (FREY),1379,2,9,9,20
2760500278 *1,VALVULA ARBOL LEVAS ADMISION Y ESCAPE (L/R) MERCEDES W166 W205 W212 W221 X156 X166 X204 (FREY),1451,8,0,2,10
2760501347 *1,ENGRANE VARIADOR VVT ARBOL LEVAS MERCEDES M276 (FREY),1756,1,0,1,2
2760501447 *1,Actuador De Ajuste Del ï¿½rbol De Levas De Escape FREY,1873,7,9,9,25
2760501547 *1,ENGRANE ARBOL LEVAS ADMISION AIRE (L) MERCEDES W166 W204 W212 W221 W251 X204  (FREY),1811,0,7,5,12
2760501647 *1,ENGRANE ARBOL LEVAS ADMISION AIRE (R) MERCEDES W166 W204 W212 W221 W251 X204  (FREY),1343,7,3,1,11
2760503600 *1,ENGRANE ARBOL LEVAS ADMISION AIRE MOTOR VVT (L) MERCEDES C292 W166 W204 W205 W212 W213 W221 W222 X166 (FREY),1205,1,5,7,13
2760503800 *1,Salida De Escape Ajustador del ï¿½rbol de levas para Mercedes-Benz E400 ( FREY ),1757,6,3,8,17
2760503900 *1,Salida De Escape Ajustador del ï¿½rbol de levas (FREY,1387,3,4,8,15
27607569969,MODULO DE TRANSFER BMW E70-N52N,1512,1,6,5,12
27607569969-1,MODULO DE TRANSFER BMW E70-N52N FREY,1940,4,2,9,15
2760940004 *1 ,FILTRO ENTRADA AIRE MOTOR (L/R) MERCEDES W251 M272 W204 X204 M276 W166 W212 M278 (FREY),1624,4,5,8,17
2760940004 *3,FILTRO ENTRADA AIRE MOTOR MERCEDES W204 3.5 L V6 (MAHLE LX3140),1895,6,5,5,16
2760940004 *5,FILTRO ENTRADA AIRE MOTOR MERCEDES MOTOR M276 (MANN C43139) SSF,1201,7,8,3,18
2760940504 *1,FILTRO ENTRADA AIRE MOTOR MERCEDES W205-M276 (FREY),1260,1,5,8,14
2760940504 *3,FILTRO ENTRADA AIRE MOTOR MERCEDES W205-M276 (MAHLE LX2841/7),1642,9,5,7,21
2761410180 *1,KIT 6 PZ JUNTAS MULTIPLE ADMISION AIRE MOTOR MERCEDES W276 3.0 L V6 (FREY),1689,2,2,2,6
2761530128 *1,SENSOR POSICION CIGï¿½Eï¿½AL MOTOR MERCEDES M271 M276 (FREY),1644,6,4,9,19
2761800009 *1,FILTRO ACEITE MOTOR MERCEDES M276 M278 (FREY),1339,5,9,3,17
2761800009 *3,FILTRO ACEITE MOTOR MERCEDES M276 M278 (MAHLE OX814D),1751,3,5,8,16
2761800009 *5,FILTRO ACEITE MOTOR MERCEDES M276 M278 (MANN ALEMAN) SSF,1336,3,4,9,16
2761880001,RADIADOR DE ACEITE MB C204,1210,4,9,0,13
2762000370,TENSOR DE BANDA DE ACCESORIOS MERCEDES R172 / W204 / W212 / W166 X204 / ( INA ),1996,5,6,8,19
2762000370 *1,TENSOR DE BANDA DE ACCESORIOS MERCEDES R172-W204-W212-W166-X204 FREY,1550,1,1,1,3
2762000515 *1,TERMOSTATO ENFRIAMIENTO MOTOR MERCEDES M276 (FREY),1954,0,1,5,6
2762001301 *1,BOMBA AGUA ENFRIAMIENTO MOTOR MERCEDES M276 (FREY),1718,1,5,1,7
2762001301 *2,BOMBA AGUA ENFRIAMIENTO MOTOR MERCEDES M276 (EMBLER),1825,8,1,3,12
276905070028,SENSOR DE CIGUEï¿½AL BREMI,1647,5,6,9,20
2769051200-100,SENSOR DE CIGUEï¿½AL M271 INACTIVO,1291,0,2,4,6
2769060260,BOBINA DE IGNICION MERCEDES W204-W212-W166 BREMI,1761,9,3,0,12
2769060501 *1,BOBINA ENCENDIDO IGNICION MOTOR MERCEDES M276 M278 (FREY TECNOLOGIA ALEMANA),1583,9,2,2,13
2769062300,MOTOR DE ARRANQUE MERCEDES W204 FREY,1866,3,5,2,10
2769062400 *1,MARCHA MOTOR ARRANQUE MERCEDES W204 W212 W221 R172 X204 M276 (FREY),1576,4,4,8,16
2769062400 *5,MARCHA MOTOR ARRANQUE MERCEDES W204 W212 W221 R172 X204 M276 (SEG AUTOMATIVE),1887,8,0,5,13
2780501947 *2,ENGRANE VVT VARIADOR ARBOL DE LEVAS MERCEDES  M278 (EMBLER),1652,1,5,2,8
2780902482 *1,MANGUERA ENTRADA AIRE MOTOR (R) MERCEDES M157 M278 (FREY),1454,6,3,4,13
2780940004 *5,FILTRO ENTRADA AIRE MOTOR MERCEDES W166 M278 (MAHLE) SSF,1643,6,3,6,15
2780940004-100,FILTRO ENTRADA AIRE MOTOR MERCEDES W166-M278 (MAHLE LX4205) INACTIVO,1997,0,6,9,15
2781500060 *1,POLEA SOBREGIRO ALTERNADOR 6 CANALES 55 MM SPRINTER OM651 MERCEDES M278 (FREY ),1553,6,9,9,24
2781800009 *1,FILTRO ACEITE MOTOR MERCEDES M270 M278 (FREY),1613,2,3,2,7
2781800009-1,FILTRO ACEITE MOTOR MERCEDES C216 AMG M276 - M278 ML63 MANN HU6008Z,1607,4,9,0,13
2781800415 *1,VALVULA SOLENOIDE BOMBA ACEITE MERCEDES W166 W205 W212 W221 W463 (FREY),1232,4,1,5,10
2781800415 *2,VALVULA SOLENOIDE BOMBA ACEITE MERCEDES W166 W205 W212 W221 W463 (EMBLER),1262,3,6,8,17
2781800415 *3,VALVULA SOLENOIDE BOMBA ACEITE MERCEDES W166 W205 W212 W221 W463 (GENUINO),1777,2,8,8,18
2782000400 *1,MANGUERA ENFRIAMIENTO TURBO COMPRESOR (L) MERCEDES C292 X166 (FREY),1571,7,5,7,19
2782000701 *1,BOMBA AGUA ENFRIAMIENTO MOTOR MERCEDES M278 (FREY),1362,5,7,0,12
2782000701 *2,BOMBA AGUA ENFRIAMIENTO MOTOR MERCEDES M278 (EMBLER) HT,1901,7,0,1,8
2782000815 *1,TERMOSTATO ENFRIAMIENTO MOTOR MERCEDES OM278 W222 W166 W221 (FREY),1953,8,3,3,14
2782000900 *1,MANGUERA ENFRIAMIENTO TURBO COMPRESOR (L) MERCEDES W221 W222 (FREY),1778,4,8,6,18
2782002551 *2,MANGUERA ENFRIAMIENTO TURBO COMPRESOR (L) MERCEDES X166 (EMBLER),1220,7,5,9,21
2789060700,MOTO DE ARRANQUE MERCEDES W221 FREY,1831,6,4,7,17
28107842828 *1,FILTRO TRANSMISION BMW E82 E88 E89 E90 E92 E93 (FREY),1371,5,1,9,15
28108070791 *1,CARTER TRANSMISION BMW E82 E88 E89 E90 E92 E93 F06 F10 F12 F13 F80 F82 F83 F87 (FREY),1590,9,2,0,11
2810900901,FILTRO ENTRADA AIRE MOTOR SMART TOPRAN,1208,9,9,7,25
2810940000 *3,FILTRO ENTRADA AIRE MOTOR SMART (MAHLE LX4067),1679,5,6,4,15
2811624196,TENSOR DE CORREA DE TRANSMICION ( GENUINO ),1942,3,9,8,20
28117070,JUNTA DE ENFRIADOR DE ACEITE DE MOTOR 73 MM AUDI A4-V6 GENUINO,1410,1,3,3,7
2811800210 *1,FILTRO ACEITE MERCEDES W177 H247 X118 (FREY),1386,7,9,8,24
2820940004 *1,FILTRO ENTRADA AIRE MOTOR MERCEDES W177 X118 X247 H247 M282 (FREY),1564,5,3,1,9
2822030175 *1,TERMOSTATO ENFRIAMIENTO MOTOR MERCEDES M282 (FREY),1902,5,0,6,11
2923200600 *A,AMORTIGUADOR CON SENSOR SUSPENSION TRASERA (R) MERCEDES W292 2016 A 2019 (EMBLER) TECH,1639,3,4,4,11
2923201600 *A,AMORTIGUADOR CON SENSOR SUSPENSION TRASERA (L) MERCEDES W292 2016 A 2019 (EMBLER) TECH,1357,1,3,0,4
2923202500 *A,AMORTIGUADOR AIRE CON ADS SUSPENSION DELANTERA AWD (L) MERCEDES C292 (EMBLER) TECH,1856,0,4,6,10
2923202600 *A,AMORTIGUADOR AIRE CON ADS SUSPENSION DELANTERA (R) MERCEDES C292 (EMBLER) TECH,1241,5,0,6,11
29806502,BALERO EXTERIOR DE RUEDA DELANTERA L-R MERCEDES W210 BMTRS,1780,9,8,5,22
29930896,BANDA MB W202 W210 HUTCHINSON,1635,9,9,1,19
29935496 *5,BANDA DE ALTERNADOR MERCEDES W204 C350 (CONTINENTAL) SSF,1612,3,7,4,14
2Q0615601H *2,DISCO FRENOS TRASEROS SOLIDO (L/R) 230X135X39.5 MM AUDI VW SEAT (EMBLER) EMB,1646,2,0,0,2
2Q0698151 *3,BALATAS FRENOS DELANTERO 146 X 55 MM AUDI A1 SEAT VW (TRW),1994,1,5,4,10
2W939601AC,FILTRO ENTRADA AIRE MOTOR JAGUAR MANN C30115,1485,3,2,2,7
2ab,1.,1302,1,1,8,10
3000951109 *1,KIT 2 PZ CLUTCH PLATO DISCO SPRINTER W901 W905 (FREY),1917,8,8,9,25
30308724,ANILLOS DE MOTOR STD X 1 PISTON MERCEDES W202 - M111 GOETZE 0810910000,1371,0,3,1,4
30335A-100,KIT CADENA DE DISTRIBUCION BMW N46 N46 INACTIVO,1873,6,6,7,19
30611465 *5,SOPORTE MOTOR INFERIOR TRASERO VOLVO S40 V40 1.9 L 4 CIL (URO) SSF,1998,1,0,2,3
30611702,FLECHA HOMOCINETICA LADO RUEDA VOLVO S40 ( LUZAN ),1755,6,7,6,19
30613400,SENSOR DE VELOCIDAD VOLVO S40 FAE,1886,8,1,9,18
30620512 *3,FILTRO COMBUSTIBLE GASOLINA VOLVO S40 C70 (MAHLE KL196),1685,1,7,5,13
30622090,ENFRIADOR DE ACEITE DE MOTOR VOLVO S80-Xc90 2.5L 2.8L 2.9L BMTRS,1441,5,8,9,22
30630752 *3,FILTRO POLEN AIRE CABINA VOLVO S60 S70 S80 (MAHLE LA54),1498,8,3,0,11
30630754 *3,FILTRO ENTRADA AIRE MOTOR CARBON ACTIVO VOLVO S60 S80 (MAHLE LAK54),1525,0,3,3,6
30636551 *3,FILTRO ENTRADA AIRE MOTOR VOLVO XC90 (MAHLE LX1219),1981,8,2,2,12
30637339 *5,JUNTA SELLO ENFRIADOR ACEITE MOTOR VOLVO C30 C70 S40 S60 S70 S80 V40 V50 V60 V70 XC70 XC90 (PRO PARTS) SSF,1785,6,9,0,15
30637955,TENSOR DE BANDA DE BOMBA DE AGUA VOLVO S40 / S60 / S80 ( NORDIC ),1981,3,1,1,5
30637955-1,TENSOR DE BANDA DE BOMBA DE AGUA VOLVO S40-S60-S80 INA,1936,7,7,4,18
30637966 *2,ENFRIADOR ACEITE MOTOR VOLVO C30-C40-V50 2.4L (EMBLER) GOG,1551,0,4,9,13
30638277,TENSOR DE BANDA DE DISTRIBUCION VOLVO S40 / T5 2a GEN ( INA ),1581,4,6,0,10
30650074,JUNTA DE ADMISION VOLVO S40 2a GEN VICTOR REINZ,1821,0,8,2,10
30650074-1,JUNTA DE ADMISION VOLVO S40 2a GEN (MAHLE),1866,5,1,8,14
30650752 *5,SENSOR TEMPERATURA ANTICONGELANTE MOTOR VOLVO T5 2.4 2.5 LITROS (FACET) SSF,1225,9,3,3,15
30650957 *5,TENSOR DE BANDA DE ALTERNADOR VOLVO S40  ( URO ) SSF,1578,5,2,9,16
30650957 *6,TENSOR DE BANDA DE ALTERNADOR VOLVO S40 (INA) SSF,1993,5,2,2,9
30666433,SOPORTE DE MOTOR VOLVO S40 HUTCHISON,1616,4,6,8,18
30666626,SOPORTE DE MOTOR INFERIOR TRASERO VOLVO S40 T5 HUTCHINSON,1935,9,6,0,15
30680002,TAPON DE DEPOSITO DE ANTICONGELANTE VOLVO S40 2a GEN (EMBLER),1691,8,9,1,18
30680002 *5,TAPON DEPOSITO ANTICONGELANTE ENFRIAMIENTO MOTOR 1.5 BARES VOLVO C30 C70 S40 V50 (EUROSPARE) SSF,1207,1,0,9,10
30680002 *6 ,TAPON DEPOSITO ANTICONGELANTE ENFRIAMIENTO MOTOR 1.5 BARES VOLVO C30 C70 S40 V50 (PROPARTS) SSF,1677,3,1,2,6
30680293 *3,FILTRO ENTRADA AIRE MOTOR VOLVO XC90 MAHLE LX1607/1,1540,9,9,8,26
30680708 *5,SOPORTE MOTOR SUPERIOR (R) VOLVO XC90 3.2 L 2007 A 2014 (HUTCHINSON) SSF,1372,8,9,1,18
30680770,SOPORTE DE MOTOR SUPERIOR VOLVO S60 URO,1820,9,5,1,15
30680923 *5,MANGUERA INFERIOR RADIADOR ENFRIAMIENTO MOTOR VOLVO S69 S80 V70 XC70 2.4 2.5 (URO) SSF,1655,4,6,8,18
30681546 *5,BASE AMORTIGUADOR SUSPENSION DELANTERA SIN BALERO VOLVO C30 C70 S40 V50 (SACHS) SSF,1595,8,6,7,21
30684245 *5,BOBINA IGNICION VOLVO S60 S80 V60 V70 XC60 XC70 XC90 V60 LAND ROVER LR2 (EUROSPARE) SSF,1647,6,4,5,15
30684245 *6,BOBINA IGNICION VOLVO S60 S80 V60 V70 XC60 XC70 XC90 V60 LAND ROVER LR2 (BREMI) SSF,1813,7,6,5,18
30684245 *7,BOBINA IGNICION VOLVO S60 S80 V60 V70 XC60 XC70 XC90 V60 LAND ROVER LR2 (BERU) SSF,1914,8,5,8,21
30713370,SENSOR DE POSICION DE ARBOL DE LEVAS VOLVO C70 / S60 / S80 ( FAE ),1691,3,9,5,17
30713370-1,SENSOR DE POSICION DE ARBOL DE LEVAS VOLVO C70 / S60 / S80 ( GENUINO ),1367,9,3,6,18
30713416 *5,BOBINA IGNICION VOLVO C30 C70 S40 S60 S80 V50 V60 V70 XC60 XC70 XC90 (BREMI) SSF,1467,3,9,0,12
30713416 *6,BOBINA IGNICION VOLVO C30 C70 S40 S60 S80 V50 V60 V70 XC60 XC70 XC90 (BOSCH) SSF,1200,8,8,2,18
30713512 *5,SENSOR MASA AIRE MOTOR MAF VOLVO S40 S80 V50 V70 (BREMI) SSF,1711,9,4,9,22
30714088,AMORTIGUADOR TRASERO VOLVO S40  KONI,1768,5,5,9,19
30714128,BUJE CHICO DE LA HORQUILLA INF,1624,4,2,7,13
30714968 *5,BASE SUPERIOR AMORTIGUADOR SUSPENSION DELANTERA VOLVO S60 S80 V70 XC70 XC90 (LEMFOERDER) SSF,1827,3,9,5,17
30714968 *6,BASE SUPERIOR AMORTIGUADOR SUSPENSION DELANTERA VOLVO S60 S80 V70 XC70 XC90 (NORDIC) SSF,1855,6,7,5,18
30720087 *5,JUNTA CABEZA MOTOR (R) MEDIDA STANDAR 0.45 MM VOLVO XC90 2005 A 2011 4.4 LITROS (VICTOR REINZ) SSF,1869,0,9,7,16
30723082 *2,MANGUERA SUPERIOR DE RADIADOR VOLVO S40 2.4 2.5 TURBO 5 CILINDROS (EMBLER) GOG,1686,0,5,4,9
30723082 *5,MANGUERA SUPERIOR RADIADOR ENFRIAMIENTO MOTOR VOLVO S40 (REIN) SSF,1650,1,0,0,1
30723129,ENFRIADOR DE ACEITE DE TRANSMISION AUTOMATICA VOLVO C30 C70 S40 V50 BMTRS,1974,2,6,8,16
30723129-1,ENFRIADOR DE ACEITE DE TRANSMISION AUTOMATICA VOLVO C30 C70 S40 V50 (EMBLER),1628,9,2,7,18
30731384 *5,BOMBA AGUA MECANICA ENFRIAMIENTO MOTOR VOLVO S80 CX90 (GRAF) SSF,1232,0,8,0,8
30731512 *5,KIT 3 PZ ANILLOS PARA UN PISTON VOLVO C30 C70 S40 S60 S70 S80 V40 V50 V70 XC70 XC90 (MAHLE) SSF,1719,2,4,1,7
30731727,"KIT DE DISTRIBUCION, BANDA, TENSOR Y POLEA VOLVO S40 2a GEN CONTINENTAL",1829,6,8,7,21
30733894 *3,FILTRO POLEN AIRE CABINA VOLVO S60 V60 V70 XC60 XC70 LAND ROVER (MAHLE LA387),1689,2,9,1,12
30741155 *5,SENSOR NIVEL ANTICONGELANTE ENFRIAMIENTO MOTOR VOLVO C70 S60 S70 S80 XC70 XC90 (URO PARTS) SSF,1642,4,1,6,11
30741973 *2,DEPOSITO DE ANTICONGELANTE VOLVO S60 S80 2.5T (EMBLER) GOG,1878,4,9,9,22
30741973 *5,DEPOSITO ANTICONGELANTE ENFRIAMIENTO MOTOR S60 S80 V70 XC70 XC90 (MAHLE) SSF,1488,7,2,5,14
30742030-3,BALATAS FRENOS DELANTEROS VOLVO S40 II BREMBO CERAMICA  P24061N,1253,7,6,5,18
30745344 *3,FILTRO ENTRADA AIRE MOTOR VOLVO S60 S80 (MAHLE LX1593/2),1480,3,1,4,8
30748212 *3,FILTRO ENTRADA AIRE MOTOR VOLVO S80  (MAHLE LX1591/2),1515,3,4,9,16
30748360,AMORTIGUADOR DELANTERO (R) VOLVO S40 SACHS,1223,8,3,8,19
30748361,AMORTIGUADOR DELANTERO (L) VOLVO S40 SACHS,1222,2,5,7,14
30750013 *3,FILTRO ACEITE MOTOR LAND ROVER LR2 (MAHLE OX433D),1299,2,3,6,11
30750783 *5,KIT 16 PZ JUNTAS CARTER ACEITE MOTOR VOLVO C30 C70 S40 S60 S70 S80 S90 V40 V50 V60 V70 V90 XC60 XC70 XC90 (REINZ) SSF,1529,2,9,9,20
30751700 *2,BOMBA AGUA MECANICA ENFRIAMIENTO MOTOR VOLVO C30 C70 S40 S60 S70 S80 V40 V50 V60 V70 XC70 XC90 (EMBLER) GOG,1958,6,9,9,24
30751700 *5,BOMBA AGUA MECANICA ENFRIAMIENTO MOTOR VOLVO C30 C70 S40 S60 S70 S80 V40 V50 V60 V70 XC70 XC90 (GRAF) SSF,1608,8,3,4,15
30751700 *6,BOMBA AGUA MECANICA ENFRIAMIENTO MOTOR VOLVO C30 C70 S40 S60 S70 S80 V40 V50 V60 V70 XC70 XC90 (HEPU) SSF,1413,0,2,2,4
30751806 *5,BUJIA IGNICION DOBLE PLATINO VOLVO 2.5L 2.4L T5 (BOSCH) SSF,1325,2,5,7,14
30757155 *3,FILTRO ENTRADA AIRE MOTOR VOLVO C70 C30 (MAHLE LX1605),1586,3,1,6,10
30757620,ENFRIADOR DE TRANSMISION AUTOMATICA LAND ROVER FREELANDER (EMBLER),1236,6,4,5,15
30758261 *5,KIT 3 PZ. BANDA DISTRIBUCION TENSOR BALERO RODILLO VOLVO C70 S40 S60 S70 S80 V40 V70 XC70 XC90 (INA) SSF,1437,0,4,0,4
30758270,"KIT DE DISTRIBUCION, BANDA, TENSOR Y POLEA VOLVO S80 T6 1a GEN INA",1636,0,5,0,5
30761742 *5,BOMBA GASOLINA ELECTRICA VOLVO S60 S80 V70 XC70 XC90 (PRO PARTS) SSF,1411,0,3,9,12
30776151 *2,DEPOSITO ANTICONGELANTE ENFRIAMIENTO MOTOR VOLVO C30 C70 S40 V50 (EMBLER) GOG,1599,8,0,9,17
30776151 *5,DEPOSITO ANTICONGELANTE ENFRIAMIENTO MOTOR VOLVO C30 C70 S40 V50 (PRO PARTS) SSF,1928,6,5,8,19
30777500,VARILLA DE NIVEL DE ACEITE VOLVO S40 2a GEN.  PRO PARTS,1969,3,2,2,7
30777530 *5,BANDA ACCESORIOS COMPRESOR AIRE ACONDICIONADO VOLVO C30 C70 S40 V50 (CONTINENTAL) SSF,1791,5,9,6,20
30777531 *5,BANDA ACCESORIOS MOTOR MEDIDA 5PK 890 MM VOLVO C30 C70 S40 V50 (CONTITECH) SSF,1921,0,6,4,10
30778170,TERMINAL DIRECCION SIN BIELETA SUSPENSION DELANTERA (L) VOLVO S40 (SIDEM),1883,4,2,1,7
30778953,SOPORTE DE MOTOR DELANTERO / TRASERO VOLVO S80 / V8 ( HUTCHINSON ),1910,0,1,1,2
30780376 *3,FILTRO ENTRADA AIRE MOTOR VOLVO (MAHLE LA220),1783,9,9,0,18
30792231,ENFRIADOR DE ACEITE DE MOTOR VOLVO  S60-S80-V70-Xc60-Xc70 BMTRS,1991,9,6,2,17
30792231 *2,ENFRIADOR DE ACEITE DE MOTOR VOLVO  S60-S80-V70-XC60-XC70 (EMBLER),1476,5,5,8,18
30793618,BALATAS FRENOS DELANTEROS VOLVO S40 II BREMBO P10012N,1389,5,1,7,13
30804963 *2,DEPOSITO ANTICONGELANTE ENFRIAMIENTO MOTOR VOLVO S40 V40 (EMBLER) GOG,1255,9,0,1,10
30804963 *5,DEPOSITO ANTICONGELANTE ENFRIAMIENTO MOTOR VOLVO S40 V40 (PRO PARTS) SSF,1452,3,7,1,11
30817997 *3,FILTRO COMBUSTIBLE GASOLINA VOLVO S40 S60 (MAHLE KL71),1847,2,6,9,17
30822040 *5,MANGUERA SUPERIOR RADIADOR ENFRIAMIENTO MOTOR VOLVO S40 V40 1.9 L 4 CIL  (FEBI) SSF,1428,1,1,0,2
3094020271 *1,TORNILLO RUEDA BIRLO 64.5 MM LAGO SPRINTER W906 (FREY),1586,1,7,6,14
31102283577-1,BRAZO RECTO DE SUSPENSION DELANTERA BMW M3 FREY,1772,0,9,1,10
31103438623,ROTULA INFERIOR DE SUSPENSION DELANTERA BMW E83-M54 BMTR,1290,9,9,5,23
31103438623 *1,ROTULA INFERIOR SUSPENSION DELANTERA BMW E83 M54 N52N ( FREY),1840,5,9,4,18
31103443127,BRAZO CURVO DE SUSPENSION DELANTERA L BMW E83 BMTR,1375,0,3,8,11
31103443127 *1,BRAZO CURVO DE SUSPENSION DELANTERA L BMW E83 FREY,1357,3,8,3,14
31103443128,BRAZO CURVO DE SUSPENSION DELANTERA R BMW E83 BMTR,1754,4,1,6,11
31103443128 *1,BRAZO CURVO DE SUSPENSION DELANTERA (R)  BMW E83 FREY,1850,0,0,6,6
31103451881,BRAZO RECTO DE SUPENSION DELANTERA ( L ) BMW E83 ( BMTR ),1703,2,9,2,13
31103451881 *1,BRAZO RECTO INFERIOR SUSPENSION DELANTERA (L) BMW E83 (FREY),1525,0,2,8,10
31103451882,BRAZO RECTO DE SUPENSION DELANTERA ( R ) BMW E83 / M54 ( BMTR ),1630,0,7,2,9
31103451882 *1,BRAZO RECTO INFERIOR SUSPENSION DELANTERA (R) BMW E83 (FREY),1404,5,7,7,19
31103453881,FORRO DE CUERO PUERTA TRASERA L BMW E83,1748,6,8,4,18
31103453882,FORRO DE CUERO PUERTA TRASERA R BMW E83,1352,2,7,9,18
31106771897 *5,BUJE BRAZO INFERIOR RECTO SUSPENSION DELANTERA BMW E70 E71 (CORTECO),1630,0,1,9,10
31106778015 *1,BUJE HIDARULICO BRAZO CURVO SUSPENSION DELANTERA (L/R) BMW E70 E71 E72 (FREY),1992,6,1,8,15
31106778015 *5,BUJE HIDRAULICO BRAZO CURVO SUSPENSION DELANTERA (L/R) BMW E70 E71 E72 (MEYLE) SSF,1215,0,9,4,13
31106779437,ROTULA DE SUSPENSION DELANTERA INFERIOR (L) MINI R53 FEBI,1335,9,3,6,18
31106779437 *1,ROTULA DE SUSPENSION DELANTERA INFERIOR (L) MINI R50 R52 R53 (FREY),1275,9,8,9,26
31106779437-1,ROTULA DE SUSPENSION DELANTERA INFERIOR (L) MINI R53 MEISTERSATZ,1478,3,5,2,10
31106779438,ROTULA DE SUSPENSION INFERIOR DELANTERA R MINI R50-R52-R53 KARLYN,1566,8,0,5,13
31106779438 *1,ROTULA DE SUSPENSION DELANTERA INFERIOR (R) MINI R50 R52 R53 (FREY),1722,1,5,5,11
31106786951 *1,BUJE HIDRAULICO BRAZO CURVO SUSPENSION DELANTERA (L/R) BMW F25 F26 (FREY),1664,2,9,1,12
31106786951 *5,BUJE HIDRAULICO BRAZO CURVO SUSPENSION DELANTERA (L/R) BMW F25 F26 (LEMFORDER) SSF,1505,4,7,4,15
31106786951-3,BUJE DE BRAZO DE SUSPENSION DELANTERO L-R BMW F5 N20 BMTSR,1556,0,9,2,11
31106786959 *5,BUJE BRAZO RECTO DELANTERO BMW F20 F22 F30 F32 F25 (GENUINO) SSF,1465,8,4,2,14
31106787665,ROTULA DE BRAZO CURVO BMW F26 DORMAN ALEMAN,1900,1,7,5,13
31106787665 *1,ROTULA BRAZO CURVO SUSPENSION DELANTERA (L/R) BMW F25 F26 (FREY),1696,4,9,6,19
31106787665-100,ROTULA DE BRAZO CURVO BMW F26 BEMQW INACTIVO,1331,2,5,1,8
31106787673,BRAZO INFERIOR IZQUIERDO BMW X3 F25 X4 F26 METRIX,1403,6,6,5,17
31106787673 *1,BRAZO CURVO INFERIOR SUSPENSION DELANTERA (L) BMW F25 F26 (FREY),1985,4,1,0,5
31106787674,BRAZO INFERIOR DERECHO  BMW X3 F25 X4 F26 AYD,1753,7,1,2,10
31106787674 *1,BRAZO CURVO INFERIOR SUSPENSION DELANTERA (R) BMW F25 F26 (FREY),1701,6,2,8,16
31106787674-1,BRAZO INFERIOR GRANDE CURVO DERECHO F25 AYD,1567,9,9,5,23
31106861151 *1,BRAZO CURVO SUSPENSION DELANTERA INFERERIOR DELANTERO (L) BMW G32 G 11 G12 (FREY),1226,3,9,8,20
31106861152 *1,BRAZO CURVO SUSPENSION DELANTERA INFERERIOR DELANTERO (R) BMW G32 G 11 G12 (FREY),1382,5,7,7,19
31106861161 *1,BRAZO CURVO SUSPENSION DELANTERA (L) BMW G30 G31 (FREY),1444,9,4,4,17
31106861162 *1,BRAZO CURVO SUSPENSION DELANTERA (R) BMW G30 G31 (FREY),1638,5,8,4,17
31106861177 *1,BRAZO RECTO INFERIOR SUSPENSION DELANTERA (L) BMW G30 G31 (FREY),1406,8,3,6,17
31106861178 *1,BRAZO RECTO INFERIOR SUSPENSION DELANTERA (R) BMW G31 G31 (FREY),1392,2,3,9,14
31106871467 *1,BRAZO RECTO SUSPENSION DELANTERA INFERIOR TRASERO (L) BMW G02 G08 (FREY),1689,6,3,2,11
31106871468 *1,BRAZO RECTO SUSPENSION DELANTERA INFERIOR TRASERO (R) BMW G02 G08 (FREY),1702,8,3,7,18
31106878081 *1,BRAZO RECTO SUSPENSION DELANTERA (L) BMW G05 G06 G07 (FREY),1813,8,3,0,11
31106878082 *1,BRAZO RECTO SUSPENSION DELANTERA (R) BMW G05 G06 G07 (FREY),1426,5,2,8,15
31106878593 *3,BRAZO RECTO DE SUSPENSION DELANTERA (L) BMW G20 (AYD),1206,7,2,1,10
31106878594 *2,BRAZO RECTO INFERIOR SUSPENSION DELANTERA (R) BMW G20 G21 (EMBLER),1313,8,0,9,17
31106883115 *1,BRAZO DE CONTROL SUSPENSION DELANTERA (L) BMW G05 G06 G07 (FREY),1906,7,4,3,14
31106883116 *1,BRAZO DE CONTROL SUSPENSION DELANTERA (R) BMW G05 G06 G07 (FREY),1339,1,4,7,12
31106890903 *1,BRAZO CURVO SUSPENSION DELANTERA INFERIOR DELANERO (L) BMW G01 G02 (FREY),1225,1,6,5,12
31106890904 *1,BRAZO CURVO SUSPENSION DELANTERA INFERIOR DELANERO (R) BMW G01 G02 (FREY),1924,3,6,5,14
31106893549 *1,BRAZO CURVO DE SUSPENSION DELANTERA (L) BMW G05 G06 G07 (FREY),1581,6,6,3,15
31106893550 *1,BRAZO CURVO DE SUSPENSION DELANTERA (R) BMW G05 G06 G07 (FREY),1300,7,1,4,12
31106893723 *3,BRAZO RECTO DE SUSPENSION DELANTERA (L) BMW G01 G02 (SORTECH),1600,9,8,7,24
31106893724 *3,BRAZO RECTO DE SUSPENSION DELANTERA (R) BMW G01 G02 (SORTECH),1274,3,4,9,16
31106894661 *1,BRAZO CURVO INFERIOR SUSPENSION DELANTERA (L) BMW G20 G21 (FREY),1825,0,0,0,0
31106894662 *1,BRAZO CURVO INFERIOR SUSPENSION DELANTERA (R) BMW G20 G21 (FREY),1267,5,8,8,21
31106898072 *3,BRAZO RECTO INFERIOR SUSPENSION DELANTERA (R) BMW G20 G21 (TEKNOROT),1278,8,9,3,20
31109803662,ROTULA DE SUSPENSION DELANTERA L / R MINI R56 ( SIDEM ),1316,2,2,6,10
31120305612-2,BUJE DE BRAZO CURVO DE SUSPENSION DELANTERA L-R BMW E60 DELPHI,1489,0,8,3,11
31120305612-3,BUJE DE BRAZO CURVO DE SUSPENSION DELANTERA L-R BMW E60 LEMFORDER,1288,9,3,0,12
31120305612-5,BUJE DE BRAZO CURVO DE SUSPENSION DELANTERA L-R BMW E60 BMTR,1559,3,5,2,10
31120410791 *2,BUJE HIDRAULICO BRAZO CURVO SUSPENSION DELANTERA (L/R) BMW E84 E87 E89 E90 (CORTECO),1867,1,6,0,7
31121092609,BRAZO DE SUSPENSION CURVO IZQUIERDO 540i SIDEM,1500,2,7,3,12
31121092610,BRAZO DE SUSPENSION CURVO DERECHO 540i SIDEM,1245,6,7,6,19
31121094233 *1,BRAZO RECTO SUSPENSION DELANTERA (L) BMW E39 (FREY),1649,6,8,5,19
31121094233 *9,BRAZO RECTO DE SUSPENSION DELANTERA (L) BMW E39 BMTR,1954,8,9,3,20
31121094234,BRAZO RECTO DE SUSPENSION DELANTERA R BMW E39 BMTR,1698,2,0,6,8
31121094234 *1,BRAZO RECTO DE SUSPENSION DELANTERA R BMW E39 FREY,1427,2,6,1,9
31121096169 *1,BRAZO CURVO SUSPENSION DELANTERA (L) BMW E53 (FREY),1555,4,5,8,17
31121096170 *1,BRAZO CURVO SUSPENSION DELANTERA (R) BMW E53 ( FREY),1488,6,1,9,16
31121096372 *3,BUJE HIDRAULICO BRAZO CURVO SUSPENSION DELANTERA (L/R) BMW E83 E53 (LEMFOERDER) SSF,1321,0,8,7,15
31121096372 *4,BUJE DE BRAZO CURVO SUSPENSION DELANTERA L-R BMW E53 E83 FRAP,1588,9,8,3,20
31121096372 *5,BUJE HIDRAULICO BRAZO CURVO SUSPENSION DELANTERA (L/R) BMW E83 E53 (DELPHI) SSF,1462,1,9,0,10
31121124622,BUJE DE BRAZO RECTO DE SUSPENSION DELANTERO L-R BMW E53-M62 BMTR,1213,8,1,8,17
31121124622 *1,BUJE DE BRAZO RECTO DE SUSPENSION DELANTERO L-R BMW E53-M62 FREY,1897,0,3,1,4
31121124622-7,BUJE DE BRAZO RECTO DE SUSPENSION DELANTERO L-R BMW E53-M62 CORTECO,1891,2,8,8,18
31121141717 *1,BRAZO CURVO DE SUSPENSION DELANTERA L BMW E39 FREY,1382,7,5,5,17
31121141717 *2,BRAZO CURVO DE SUSPENSION DELANTERA L BMW E39 BMTR,1207,8,5,2,15
31121141718,BRAZO CURVO DE SUSPENSION DELANTERA R BMW E39 BMTR,1443,2,1,1,4
31121141718 *1,BRAZO CURVO DE SUSPENSION DELANTERA R BMW E39 FREY,1778,3,2,0,5
31121141721,BRAZO CURVO DE SUSPENSION TRASERA (L) BMW E38 SIDEM,1862,6,2,6,14
31121141721-1,BRAZO CURVO DE SUSPENSION TRASERA (L) BMW E38 FREY,1606,4,4,3,11
31121141722,BRAZO CURVO DE SUSPENSION TRASERA (R) BMW E38 SIDEM,1762,3,1,2,6
31121141722-1,BRAZO CURVO DE SUSPENSION TRASERA (R) BMW E38 FREY,1212,8,6,6,20
31122229521,BRAZO RECTO DE SUSPENSION DELANTERA ( L ) BMW E83 BMTRS,1788,1,1,8,10
31122229522,BRAZO RECTO DE SUSPENSION DELANTERA ( R ) BMW E83 BMTRS,1364,9,0,5,14
31122405863,BRAZO RECTO DE SUSPENSION DELANTERA L-R BMW X1-E84 SIDEM,1730,1,4,1,6
31122409598-100,BRAZO GRANDE CURVO BMW E87 MEYLE INACTIVO,1324,4,0,1,5
31126755835 *1,BRAZO INFERIOR RECTO SUSPENSION DELANTERA (L) BMW E63 E65 (FREY),1993,0,9,1,10
31126755836 *1,BRAZO INFERIOR RECTO SUSPENSION DELANTERA (R) BMW E65 (FREY),1899,9,3,0,12
31126756491,ROTULA INFERIOR DE SUSPENSION DELANTERA ( L / R ) BMW E53 ( BMTR ),1318,7,8,5,20
31126756491 *1,ROTULA INFERIOR SUSPENSION DELANTERA (L/R) BMW E53 (FREY),1776,8,2,0,10
31126756491 *2,ROTULA INFERIOR DE SUSPENSION DELANTERA ( L / R ) BMW E53 ( FRAP ),1501,3,0,4,7
31126756491 *3,ROTULA INFERIOR DE SUSPENSION DELANTERA ( L / R ) BMW E53 ( LEMFOERDER ),1937,9,0,5,14
31126757551 *1,BUJE HORQUILLA SUSPENSION DELANTERA (L/R) MINI R55 R56 R57 R58 R59 (FREY),1256,6,4,1,11
31126757551 *5,BUJE HORQUILLA SUSPENSION DELANTERA (L/R) MINI R55 R56 R57 R58 R59 (FEBI) SSF,1606,5,7,9,21
31126757551 *6,BUJE HORQUILLA SUSPENSION DELANTERA (L/R) MINI R50 R52 R53 (DELPHI) SSF,1495,2,8,1,11
31126757551 *7,BUJE DE SUSPENSION DELANTERA MINI R50 L-R (LEMFOERDER) SSF,1763,6,4,5,15
31126757551-1,BUJE DE SUSPENSION DELANTERA MINI R50 L-R DORMAN ALEMAN,1237,3,3,4,10
31126757561 *1,BUJE CON BRIDA DE HORQUILLA SUSPESION DELANTERA (L) MINI R50 R52 R53 (FREY),1212,2,0,1,3
31126757562 *1,BUJE CON BRIDA DE HORQUILLA SUSPESION DELANTERA (R) MINI R50 R52 R53 (FREY),1508,5,4,0,9
31126757623 *1,BUJE HORQUILLA SUSPENSION DELANTERA (L) BMW E46 E85 E86 (FREY),1903,2,0,8,10
31126757623-2,BUJE DE SUSPENSION DELANTERA L BMW E46 M54 DELPHI,1323,4,8,7,19
31126757624,BUJE DE SUSPENSION DELANTERA R BMW E46 BMTR,1269,2,9,3,14
31126757624 *1,BUJE HIDRAULICO HORQUILLA SUSPENSION DELANTERA (R) BMW E46 E85 E86 (FREY),1575,2,4,8,14
31126758510,ROTULA INFERIOR DE SUSPENSION DELANTERA BMW E36 Z3 ( SIDEM ),1968,6,3,7,16
31126758510 *1,ROTULA INFERIOR DE SUSPENSION DELANTERA BMW E36 Z3 FREY,1781,7,5,6,18
31126758513,HORQUILLA DE SUSPENSION DELANTERA INFERIOR (L) BMW E36 (BMTR),1514,2,4,9,15
31126758513 *1,HORQUILLA DE SUSPENSION DELANTERA INFERIOR (L) BMW E36 (FREY),1799,2,9,1,12
31126758514,HORQUILLA SUSPENSION DELANTERA INFERIOR (R) BMW E36 (BMTR),1617,4,4,0,8
31126758514 *1,HORQUILLA SUSPENSION DELANTERA INFERIOR (R) BMW E36 (FREY),1664,0,1,8,9
31126758519 *1,HORQUILLA SUSPENSION DELANTERA (L) BMW E46 (FREY),1436,5,2,7,14
31126758520 *1,HORQUILLA SUSPENSION DELANTERA (R) BMW E46 (FREY),1783,3,0,5,8
31126760181-100,BRAZO INFERIOR RECTO SUSPENSION DELANTERA (L) BMW E60 INACTIVO,1236,5,7,9,21
31126760182-100,BRAZO INFERIOR RECTO SUSPENSION DELANTERA (R) BMW E60 INACTIVO,1286,6,1,6,13
31126760182-101,BRAZO RECTO DE SUSPENSION DELANTERA R BMW E60 INACTIVO,1777,4,3,1,8
31126760275 *1,BRAZO RECTO SUSPENSION DELANTERA (L) BMW E53 (FREY),1810,6,4,1,11
31126760276,BRAZO RECTO DE SUSPENSION DELANTERA R BMW E53 BMTR,1822,3,8,3,14
31126760276 *1,BRAZO RECTO SUSPENSION DELANTERA (R) BMW E53 (FREY),1521,7,2,2,11
31126761409 *1,HORQUILLA SUSPENSION DELANTERA (L) MINI R50 R52 R53 (FREY),1867,3,3,8,14
31126761409 *5,HORQUILLA SUSPENSION DELANTERA (L) MINI R50 R52 R53 (LEMFOERDER) SSF,1211,9,7,3,19
31126761410 *1,HORQUILLA SUSPENSION DELANTERA (R) MINI R50 R52 R53 (FREY),1868,3,4,8,15
31126761410 *5 ,HORQUILLA SUSPENSION DELANTERA (R) MINI R50 R52 R53 (KARLYN) SSF,1840,9,9,4,22
31126761410 *6,HORQUILLA SUSPENSION DELANTERA (R) MINI R50 R52 R53 (URO) SSF,1683,3,5,6,14
31126763699 *1,BRAZO RECTO SUSPENSION DELANTERA (L) BMW E87 E90 (FREY),1612,9,7,2,18
31126763700 *1,BRAZO RECTO SUSPENSION DELANTERA (R) BMW E87 E90 (FREY),1656,7,2,2,11
31126763700-100,BRAZO RECTO DE SUSPENSION DELANTERA ( R ) BMW E90 BMTR INACTIVO,1215,4,6,3,13
31126763719 *1,BUJE HIDRAULICO BRAZO CURVO SUSPENSION DELANTERA (L/R) BMW E84 E87 E89 E90 (FREY),1868,7,2,3,12
31126763719 *5,BUJE HIDRAULICO BRAZO CURVO SUSPENSION DELANTERA (L/R) BMW E84 E87 E89 E90 (DELPHI) SSF,1795,2,1,0,3
31126763719 *7,BUJE HIDRAULICO BRAZO CURVO SUSPENSION DELANTERA (L/R) BMW E84 E87 E89 E90 (LEMFORDER) SSF,1996,5,0,2,7
31126763719-100,BUJE BRAZO CURVO (L/R) SUSPENSION DELANTERO BMW INACTIVO,1613,5,5,9,19
31126763719-101,BUJE BRAZO CURVO (L/R) SUSPENSION DELANTERO BMW E84 E87 E89 E90 INACTIVO,1901,2,3,9,14
31126765992 *1,BUJE GRANDE BRAZO CURVO SUSPENSION DELANTERA (L/R) BMW E60 E63 (FREY),1777,9,0,5,14
31126767530-1,BUJE DE SUSPENSION DELANTERA MINI R56 L-R SIDEM,1745,2,9,3,14
31126767530-5,BUJE DE SUSPENSION DELANTERA MINI R56 L-R MEYLE,1256,2,8,3,13
31126767624,DEPï¿½SITO DE COMBUSTIBLE DE PLï¿½STICO CON TUBO DE LLENADO BMW E60-N52,1711,3,8,0,11
31126767624-1,DEPï¿½SITO DE COMBUSTIBLE DE PLï¿½STICO CON TUBO DE LLENADO BMW E60-N52 FREY,1433,4,1,3,8
31126768297 *1,BRAZO RECTO INFERIOR SUSPENSION DELANTERA (L) BMW E60 (FREY),1358,8,8,6,22
31126768298 *1,BRAZO RECTO INFERIOR SUSPENSION DELANTERA (R) BMW E60 (FREY),1232,5,2,6,13
31126768983 *1,BRAZO CURVO INFERIOR SUSPENSION DELANTERA (L) BMW E84 X DRIVE (FREY),1944,0,2,2,4
31126768984 *1,BRAZO CURVO INFERIOR SUSPENSION DELANTERA (R) BMW E84 X DIVE (FREY),1686,5,7,2,14
31126768984-2,BRAZO DE SUSPENSION DELANTERA ( R ) BMW E84-N55 SIDEM,1629,4,2,0,6
31126768988,ROTULA DE SUSPENSION DELANTERA L / R BMW E84 ( BMTR ),1788,0,1,5,6
31126768988 *1,ROTULA BRAZO CURVO SUSPENSION DELANTERA (L/R) BMW X1 E84 (FREY),1246,6,9,5,20
31126768988-2,ROTULA DE SUSPENSION DELANTERA L / R BMW E84 LEMFORDER,1662,4,1,8,13
31126768989 *1,BRAZO RECTO INFERIOR SUSPENSION DELANTERA (L/R) BMW E84 xDRIVE (FREY),1370,5,3,2,10
31126769715 *1,BUJE HIDRAULICO BRAZO CURVO SUSPENSION DELANTERA (L/R) BMW E83 E53 (FREY),1849,3,0,6,9
31126769715 *6,BUJE HIDRAULICO BRAZO CURVO SUSPENSION DELANTERA (L/R) BMW E83 E53 (MEYLE) SSF,1768,3,3,0,6
31126769717 *5 ,BRAZO CURVO SUSPENSION DELANTERA (L) BMW E53 (DELPHI) SSF,1790,1,6,7,14
31126769718 *9,BRAZO CURVO DE SUSPENSION DELANTERA R BMW E53-M62 BMTR,1343,5,9,4,18
31126769797 *1,BRAZO CURVO SUSPENSION DELANTERA (L) HIDRAULICO BMW E87 E89 E90 (FREY),1514,4,2,1,7
31126769797-2,BRAZO CURVO DE SUSPENSION DELANTERA ( L ) BMW E90 URO,1763,5,5,8,18
31126769798 *1,BRAZO CURVO SUSPENSION DELANTERA (R) HIDRAULICO BMW E81 E89 E90 (FREY),1628,7,3,8,18
31126770849 *,BRAZO RECTO SUSPENSION DELANTERA ( L ) BMW E87 E90 KARLYN,1241,9,8,4,21
31126770849 *4,BRAZO RECTO SUSPENSION DELANTERA (L) BMW E87 E90 (FRAP),1646,8,5,1,14
31126770849 *5,BRAZO RECTO DE SUSPENSION DELANTERA L BMW E90-N52 URO,1768,8,8,2,18
31126770849 *6,BRAZO RECTO DE SUSPENSION DELANTERA L BMW E90-N52 LEMFORDER,1643,4,6,5,15
31126770850 *3,BRAZO RECTO DE SUSPENSION DELANTERA ( R ) BMW E90 FRAP,1318,5,4,8,17
31126771893 *1,BRAZO INFERIOR SUSPENSION DELANTERA (L) BMW E70 E71 E72 (FREY),1243,2,6,4,12
31126771893-6,BRAZO DE SUSPENSION DELANTERO INFERIOR L BMW E70 BMTR,1587,9,0,5,14
31126771894,BRAZO DE SUSPENSION DELANTERO INFERIOR R BMW E70 BMTR,1506,5,7,0,12
31126771894 *1,BRAZO INFERIOR SUSPENSION DELANTERA (R) BMW E70 E71 E72 (FREY),1810,6,1,6,13
31126772235 *1,BUJE HORQUILLA SUSPENSION DELANTERA (L) MINI R55 A R59 (FREY),1772,3,3,6,12
31126772236 *1,BUJE HORQUILLA SUSPENSION DELANTERA (R) MINI R55 A R59 (FREY),1262,7,7,9,23
31126772236-100,SOPORTE BUJE DELANTERO LADO DERECHO MINI COOPER R56 INACTIVO,1845,1,8,9,18
31126772301,HORQUILLA DE SUSPENSION DELANTERA (L) MINI R56 BENDIX,1400,6,3,0,9
31126772301 *1,HORQUILLA DE SUSPENSION DELANTERA (L) MINI R56 FREY,1451,2,3,3,8
31126772301-1,HORQUILLA DE SUSPENSION DELANTERA (L) MINI R56 TOPRAN,1654,9,1,9,19
31126772302,HORQUILLA INFERIOR DE SUSPENSION DELANTERA (R) MINI R56 DELPHI,1944,6,6,7,19
31126772302 *1,HORQUILLA INFERIOR DE SUSPENSION DELANTERA (R) MINI R56 (FREY),1511,9,1,7,17
31126772303 *1,ROTULA INFERIOR DE SUSPENSION DELANTERA (L) MINI R56 (FREY),1829,1,8,6,15
31126772303 *3,ROTULA INFERIOR DE SUSPENSION DELANTERA (L) MINI R56 (METRIX),1529,3,8,2,13
31126772304,ROTULA INFERIOR DE SUSPENSION DELANTERA (R) MINI R56 DELPHI,1355,1,3,7,11
31126772304 *1,ROTULA INFERIOR SUSPENSION DELANTERA (R) MINI R55 A R59 (FREY),1734,0,9,2,11
31126773949,BRAZO CURVO DE SUSPENSION DELANTERA ( L ) BMW E70-N62 ( BMTR ),1492,3,8,5,16
31126773949 *1,BRAZO CURVO DE SUSPENSION DELANTERA (L) BMW E70 E71 (FREY),1730,2,0,3,5
31126773950,BRAZO CURVO DE SUSPENSION DELANTERA R BMW E70-N62 BMTR,1383,7,3,5,15
31126773950 *1,BRAZO CURVO SUSPENSION DELANTERA (R) BMW E70 E71 (FREY),1638,9,2,4,15
31126774825 *1,BRAZO CURVO INFERIOR SUSPENSION DELANTERA (L) BMW E60 (FREY),1493,3,3,5,11
31126774825-100,BRAZO CURVO DE SUSPENSION DELANTERA L BMW E60 INACTIVO,1704,8,3,2,13
31126774826 *1,BRAZO CURVO INFERIOR SUSPENSION DELANTERA (R) BMW E60 (FREY),1560,2,7,8,17
31126774831 *1,BRAZO INFERIOR CURVO SUSPENSION DELANTERA (L) BMW E65 (FREY),1290,8,4,8,20
31126774832 *1,BRAZO CURVO SUSPENSION DELANTERA (R) BMW E65 (FREY),1472,7,1,8,16
3112677514-1,BUJE DE BRAZO CURVO DE SUSPENSION DELANTERA BMW F07 FREY,1402,6,7,6,19
31126775145-9,BUJE DE BRAZO CURVO DE SUSPENSION DELANTERA BMW F07 SIDEM,1490,3,3,1,7
31126775959 *1,BRAZO SUSPENSION DELANTERA INFERIOR DELANTERO (L) BMW F01 F02 F07 (FREY),1669,6,7,4,17
31126775960 *1,BRAZO SUSPENSION DELANTERA INFERIOR DELANTERO (R) BMW F01 F02 F07 (FREY),1796,3,8,0,11
31126775967 *1,HORQUILLA SUPERIOR SUSPENSION DELANTERA (L/R) BMW F01 F02 F06 F07 F10 A F13 i8 (FREY),1648,6,4,6,16
31126775971 *1,BRAZO CURVO INFERIOR SUSPENSION DELANTERA (L) BMW F06 F10 F11 (FREY),1369,5,6,8,19
31126775972,BRAZO CURVO DE SUSPENSION DELANTERA R BMW F10-N52N SIDEM,1271,1,6,0,7
31126775972 *1,BRAZO CURVO INFERIOR SUSPENSION DELANTERA (R) BMW F06 F10 F11 (FREY),1415,3,1,9,13
31126775979 *5,BUJE DE HORQUILLA DE SUSPENSION DELANTERA BMW F10 (FEBI) SSF,1685,8,9,4,21
31126776418-9,HORQUILLA DE SUSPENSION DELANTERA SUPERIOR R BMW E70 BMTR,1365,9,9,3,21
31126777733 *1,BRAZO CURVO INFERIOR SUSPENSION DELANTERA (L) BMW F10 F11 F06 F12 (FREY),1412,7,0,8,15
31126777734 *1,BRAZO SUSPENSION DELANTERA INFERIOR DELANTERO (R) BMW F06 F10 F11 A F13 (FREY),1765,4,5,3,12
31126783443,ROTULA DE SUSPENSION DELANTERA MINI COOPER R50 ( DELPHI ),1976,5,8,2,15
31126783443 *1,ROTULA SUSPENSION DELANTERA (L/R) MINI R50 R52 R53 (FREY),1916,2,1,2,5
31126783443-1,ROTULA DE SUSPENSION DELANTERA MINI COOPER R50 VAICO,1495,3,7,4,14
31126783443-2,ROTULA DE SUSPENSION DELANTERA MINI COOPER R50 ISU,1320,7,3,9,19
31126783719,BUJE DE BRAZO RECTO DE DELANTERO L-R BMW E90 CHICO,1459,6,5,2,13
31126783719-1,BUJE DE BRAZO RECTO DE DELANTERO L-R BMW E90 CHICO FREY,1222,8,6,9,23
31126787669 *1,BRAZO RECTO INFERIOR SUSPENSION DELANTERA (L) BMW F25 F26 (FREY),1412,3,0,4,7
31126787669-100,BRAZO RECTO DELANTERO INFERIOR ( L ) BMW F25 INACTIVO,1693,4,1,4,9
31126787670 *1,BRAZO RECTO INFERIOR SUSPENSION DELANTERA (R) BMW F25 F26 (FREY),1600,6,0,6,12
31126794203 *1,BRAZO SUSPENSION INFERIOR DELANTERO (L) BMW F06 F10 A F13 (FREY),1792,5,4,7,16
31126794204 *1,BRAZO SUSPENSION INFERIOR DELANTERO (R) BMW F06 F10 A F13 (FREY),1737,0,0,1,1
31126798107 *1,BRAZO RECTO SUSPENSION DELANTERA (L) BMW F01 F02 F07 (FREY),1223,1,2,1,4
31126798108 *1,BRAZO RECTO SUSPENSION DELANTERA (R) BMW F01 F02 F07 (FREY),1477,6,3,1,10
31126850605 *1,BRAZO SUSPENSION INFERIOR TRASERO (L) BMW F10 F11 (FREY),1893,2,2,5,9
31126850606 *1,BRAZO SUSPENSION INFERIOR TRASERO (R) BMW F10 F11 (FREY),1508,0,0,2,2
31126851691 *1,BRAZO CURVO SUSPENSION DELANTERA (L) BMW F15 F16 (FREY),1415,7,0,7,14
31126851692 *1,BRAZO CURVO SUSPENSION DELANTERA BMW F15 F16 (FREY),1478,9,4,0,13
31126851693 *3,BUJE DE SUSPENSION BMW E70 (LEMFORFER),1489,7,0,6,13
31126851693 *4,BUJE DE SUSPENSION BMW E70 (METRIX),1489,4,6,7,17
31126852991 *1,BRAZO RECTO INFERIOR SUSPENSION DELANTERA (L) BMW F20 F22 F30 F32 (FREY),1887,9,8,0,17
31126852992 *1,BRAZO RECTO INFERIOR SUSPENSION DELANTERA (R) BMW F20 F22 F30 F32 (FREY),1933,6,4,5,15
31126854723 *1,BRAZO INFERIOR CURVO SUSPENSION DELANTERA INFERIOR (L) HIDRAULICO BMW F32 xDRIVE (FREY),1620,1,6,6,13
31126854724-100,BRAZO CURVO SUSPENSION DELANTERA INFERIOR (R) BMW F20 A F23 F30 A F33 F36 (FREY) INACTIVO,1219,4,1,6,11
31126854727 *1,BRAZO RECTO SUSPENSION DELANTERA (L) BMW F20-F23 F30-F34 F36 (FREY),1331,9,2,0,11
31126854728 *1,BRAZO RECTO SUSPENSION DELANTERA SUPERIOR (R) BMW F20 A F23 F30 A F34 F36 (FREY),1830,3,8,6,17
31126855741 *1,BRAZO INFERIOR CURVO SUSPENSION DELANTERA (L) HIDRAULICO BMW F20 F22 F30 F32 (FREY),1909,4,1,8,13
31126855742 *1,BRAZO INFERIOR CURVO SUSPENSION DELANTERA (R) HIDRAULICO BMW F20 F22 F30 F32 (FREY),1865,5,1,5,11
31126855742-100,BRAZO CURVO DE SUSPENSION DELANTERA R BMW F30-N20 BEMWQ INACTIVO,1755,5,0,5,10
31126855743 *1,BUJE HIDRAULICO BRAZO CURVO SUSPENSIï¿½N DELANTERA (L/R) BMW F20 F22 F30 F32 (FREY),1313,2,2,6,10
31126855743 *5,BUJE HIDRAULICO BRAZO CURVO SUSPENSIï¿½N DELANTERA (L/R) BMW F20 F22 F30 F32 (LEMFORDER) SSF,1839,1,4,6,11
31126855743 *8,BUJE HIDRAULICO BRAZO CURVO SUSPENSIï¿½N DELANTERA (L/R) BMW F20 F22 F30 F32 (CORTECO),1336,8,4,6,18
31126855743 *9,BUJE DE BRAZO CURVO DE SUSPENSIï¿½N DELANTERA L-R BMW F30 TOPRAN,1309,1,8,6,15
31126855743-5,BUJE DE BRAZO CURVO DE SUSPENSIï¿½N DELANTERA L-R BMW F30 METRIX,1811,8,3,7,18
31126863785,HORQUILLA DE SUSPENSION DELANTERA SUPERIOR ( R-L ) BMW E70-E71 TOPRAN,1286,6,1,9,16
31126863785 *1,HORQUILLA SUPERIOR SUSPENSION DELANTERA SUPERIOR (L) BMW E70 E71 (FREY),1270,1,9,8,18
31126863786,HORQUILLA DE SUSPENSION DELANTERA SUPERIOR ( R-L ) BMW E70-E71 BMTR,1839,2,3,3,8
31126863786 *1,HORQUILLA SUSPENSION DELANTERA SUPERIOR (L/R) BMW E70 E71 (FREY),1993,2,8,3,13
31126863786-2,HORQUILLA DE SUSPENSION DELANTERA SUPERIOR ( R-L ) BMW E70-E71 DELPHI,1858,0,2,7,9
31126864821 *1,BRAZO RECTO DE SUSPENSION DELANTERA (L) BMW F15 FREY,1237,0,5,7,12
31126864822,BRAZO RECTO DE SUSPENSION DELANTERA ( R ) BMW F15 OPTIMAL,1240,0,7,3,10
31126864822 *1,BRAZO RECTO DE SUSPENSION DELANTERA (R) BMW F15 FREY,1391,0,3,0,3
31126874341 *1,BUJE HORQUILLA SUSPENSION DELANTERA (L) BMW F39 F45 F46 F48 MINI F54 F55 F56 F57 F60 (FREY),1353,8,7,5,20
31126874342 *1,BUJE HORQUILLA CON BRACKET SUSPENSION DELANTERA (R) BMW F39 F45 F46 F48 MINI F54 F55 F56 F57 F60 (FREY),1861,6,2,2,10
31126874343 *1,BUJE HORQUILLA SIN BRACKET SUSPESNSION (L/R) BMW F39 F45 F46 F48 MINI F54 F55 F56 F57 F60 (FREY),1397,1,8,9,18
31126879841 *1,HORQUILLA DELANTERA (L) MINI F55 F56 (FREY),1934,1,0,7,8
31126879842 *1,HORQUILLA DELANTERA (R) MINI F55 F56 (FREY),1631,5,5,2,12
31126879843 *1,HORQUILLA INFERIOR SUSPENSION DELANTERA (L) BMW F39 F40 F44 F45 F46 F48 F54 F60 (FREY),1825,4,7,5,16
31126879843B,HORQUILLA INFERIOR CON SOPORTE DE GOMA SUSPENSION DELANTERA (L) BMW F39 F40 F44 F45 F46 F48 F54 F60 (FREY),1498,5,6,0,11
31126879844 *1,HORQUILLA INFERIOR SUSPENSION DELANTERA (R) F39 F40 F44 F45 F46 F48 F54 F60 (FREY),1382,7,1,3,11
31126879844B,HORQUILLA INFERIOR CON SOPORTE DE GOMA SUSPENSION DELANTERA (R) BMW F39 F40 F44 F45 F46 F48 F54 F60 (FREY),1969,6,6,6,18
31127519247-100,MANGUERA DE VENTILACION DEPOSITO DE ANTICONGELANTE BMW E60-M54 INACTIVO,1404,5,6,4,15
31127519247-101,MANGUERA DE VENTILACION DEPOSITO DE ANTICONGELANTE BMW E60-M54 FREY INACTIVO,1698,6,1,8,15
31129059288,BUJE DE HORQUILLA DELANTERA L-R BMW E36-Z3 BMTR,1514,9,3,3,15
31129059288 *1,BUJE HORQUILLA SUSPENSION DELANTERA (L/R) BMW E36 Z3 (FREY),1300,0,2,2,4
31129059288 *5,KIT 2 PZ BUJE HORQUILLA SUSPENSION DELANTERA (L/R) BMW E36 Z3 (LEMFOERDER) SSF,1804,7,3,6,16
31129059288 *6,KIT 2 PZ BUJE HORQUILLA SUSPENSION DELANTERA (L/R) BMW E36 Z3 (FEBI) SSF,1470,7,4,0,11
31129803498 *3,BUJE HORQUILLA INFERIOR SUSPENSION DELANTERA (L/R) MINI R60 R61 (METRIX),1913,9,3,1,13
31129806519 *1,HORQUILLA SUSPENSION DELANTERA (L) MINI R60 R61 (FREY),1872,8,2,9,19
31129806520 *1,HORQUILLA SUSPENSION DELANTERA (R) MINI R60 R61 (FREY),1319,7,5,6,18
31200321,DEPOSITO DE ANTICONGELANTE S60 XC60 S80 LAND ROVER (EMBLER),1890,4,9,9,22
31201412,TERMINAL DIRECCION SIN BIELETA SUSPENSION DELANTERA (R) VOLVO S40 (FEBI),1263,7,0,3,10
31201413,TERMINAL DIRECCION SIN BIELETA SUSPENSION DELANTERA (L) VOLVO S40 (FEBI),1848,2,3,0,5
31201909 *2,ENFRIADOR ACEITE MOTOR VOLVO (2.4 L T5) (2.5 L T2) (2.9 L T) (EMBLER) GOG,1427,5,7,2,14
31203413226 *1,MASA RUEDA DELANTERA (L/R) BMW E83 M54 N52N (FREY),1390,7,9,0,16
31203450600,BALERO DOBLE DE RUEDA DELANTERA BMW E83 FAG,1402,4,6,3,13
31206756256 *1,BRIDA DE RUEDA BMW X5 E53 FREY,1370,5,8,6,19
31206768993 *1,BRIDA DE RUEDA BMW E90 E91 E92 FREY,1806,3,7,2,12
31206775771 *1,BALERO MAZA DELANTERO BMW F10 FREY,1454,3,8,1,12
31206794850 *1,BALERO MASA RUEDA DELANTERA (L/R) BMW F20 F30 F32 (FREY),1914,5,5,4,14
31206795959,BALERO MAZA DELANTERO BMW E70 OPTIMAL,1353,5,2,6,13
31206795959-2,BALERO MAZA DELANTERO BMW E70 BENDIX,1863,5,9,6,20
31206795959-3,BALERO MAZA DELANTERO BMW E70 BMTSR,1209,1,5,8,14
31206850158,BALERO MAZA DELANTERO BMW F10 BMTR,1957,7,7,6,20
31206867088 *1,BALERO MASA RUEDA DELANTERA (L/R) BMW F06 F25 F26 (FREY),1999,6,9,9,24
31206867260 *1,COJINETE DE RUEDA BMW F20 F30 FREY,1811,1,2,9,12
31206870725 *1,BALERO DOBLE MAZA RUEDA DELANTERA (L/R) BMW F25 F26 (FREY),1250,7,4,6,17
31206874443 *1,BALERO MASA DELANTERO BMW F39 F40 F44 F46 F48 F55 F56 I01 (FREY),1962,4,7,4,15
31209813211 *1,BALERO MASA DELANTERO (L/R) MINI R60 R61  (FREY),1494,4,4,2,10
31216765157,BALERO MAZA DE RUEDA DELANTERA BMW E84-E87-E89-E90 BMTR,1967,2,7,3,12
31216765157 *1,BALERO MAZA RUEDA DELANTERA (L/R) BMW E84 E87 E89 E90 (FREY),1512,0,8,9,17
31219000-1,BOMBA AGUA MECANICA ENFRIAMIENTO MOTOR VOLVO S80-T6 2a GEN (URO),1814,6,9,2,17
31221093427,BALERO MAZA DELANTERO BMW E39,1347,1,2,6,9
31221093427 *1,BALERO MAZA DELANTERO BMW E39 FREY,1746,5,4,1,10
31226750217 *1,COJINETE CUBO DE RUEDA DELANTERA E65 E66 FREY,1431,2,7,8,17
31226751978-101,BALERO DOBLE DELANTERO BMW E53 (FREY) INACTIVO,1349,0,2,3,5
31226756889,BALERO DE RUEDA DELANTERA L-R MINI R50-R53 FAG FW9226,1784,9,9,7,25
31226757024,BALERO MAZA DELANTERO BMW E46-M54 BMTR,1437,9,1,1,11
31226757024 *1,BALERO MAZA RUEDA DELANTERA (L/R) BMW E46 (FREY),1369,2,3,8,13
31226765601,BALERO MAZA DELANTERO BMW E60 BMTR,1962,6,9,4,19
31226765601 *1,BALERO MAZA DELANTERO BMW E60 FREY,1951,8,4,6,18
31226783913 *1,BALERO DOBLE DE RUEDA DELANTERA BMW E83 (FREY),1269,8,2,7,17
31226783913-100,BALERO DOBLE DELANTERO BMW E53 BMTR INACTIVO,1307,0,7,2,9
31226783913-101,BALERO DOBLE DE RUEDA DELANTERA BMW E83 FREY INACTIVO,1271,3,4,7,14
31226783913-5,BALERO DOBLE DELANTERO BMW E53 FAG,1934,2,1,8,11
31226882263 *1,BALERO MAZA RUEDA DELANTERA (L/R) BMW E70 E71 (FREY),1204,4,8,4,16
31251213 *5,MANGUERA VENTILACION SEPARADOR ACEITE GASES MOTOR PCV VOLVO S40 V40 2.4 L 5 CIL (GATES) SSF,1218,1,0,2,3
31251501,JUNTA CABEZA MOTOR MEDIDA STANDAR 0.90 MM VOLVO T5 2.5 LITROS PAYEN,1995,3,2,4,9
31251501 *5 ,JUNTA CABEZA MOTOR MEDIDA STANDAR 0.90 MM VOLVO T5 2.5 LITROS (ELRING) SSF,1282,1,6,9,16
31256016,JUEGO DE FUELLE LOEBRO,1255,2,8,8,18
31261059 *3,FILTRO COMBUSTIBLE GASOLINA VOLVO C30 C70 MAHLE KL559,1915,9,1,1,11
31261988 *2,MOTOVENTILADOR ENFRIAMIENTO MOTOR VOLVO 2.5 C30 (EMBLER) GOG,1884,3,0,8,11
31261988 *5,MOTOVENTILADOR ENFRIAMIENTO MOTOR VOLVO 2.5 C30 (TYC) SSF,1654,6,5,1,12
31266773950,BRAZO CURVO DE SUSPENSION DELANTERA R BMW E53,1772,4,3,2,9
31266773950-1,BRAZO CURVO DE SUSPENSION DELANTERA R BMW E53 FREY,1950,4,1,9,14
31272732,SENSOR DE PRESION DE COMBUSTIBLE VOLVO S40 ( BOSCH ),1455,4,7,8,19
31277603,AMORTIGUADOR DE SUSPENSION DELANTERA R VOLVO S40 SACHS 313665,1303,3,9,1,13
31277881 *5,BUJE SUSPENSION HORQUILLA DELANTERA (L/R) VOLVO CX90 2003 A 2014 (MEYLI) SSF,1988,1,5,0,6
31290593 *2,KIT 2 PZ FOCO XENON D3S LUZ BLANCA 4500K 35W MERCEDES AUDI VW BMW VOLVO PORSCHE (EMBLER) MLL,1877,3,9,4,16
31290593 *3,KIT 2 PZ FOCO XENON D3S LUZ BLANCA 5500K 35W MERCEDES AUDI VW BMW VOLVO PORSCHE (EMBLER) MLL,1534,8,4,4,16
31290593 *4,KIT 2 PZ FOCO XENON D3S LUZ AZUL 7500K 35W MERCEDES AUDI VW BMW VOLVO PORSCHE (EMBLER) MLL,1896,7,1,8,16
31290593-100,FOCO LUZ BLANCA XENON D3S CON IGNITOR AUDI VW VOLVO PORSCHE INACTIVO,1833,0,6,3,9
31293698,TERMOSTATO DE MOTOR VOLVO S80 2a GEN. ( FACET ),1434,5,1,3,9
31293700 *5,TERMOSTATO ENFRIAMIENTO MOTOR VOLVO S60 C70 V70 XC70 XC90 (FACET) SSF,1745,8,5,2,15
31302344,TERMINAL DIRECCION SIN BIELTA SUSPENSION DELANTERA (L) LAND ROVER LR2 (TOPRAN),1342,7,2,2,11
31303411973,GOMA DE REBOTE DE AMORTIGUADOR DELANTERO L-R BMW E83 BMTR,1308,4,3,4,11
31303411973 *1,GOMA REBOTE AMORTIGUADOR DELANTERO (L/R) BMW E53 E83 (FREY),1231,9,4,4,17
31303414299,TORNILLO DE BARRA ESTABILIZADORA L BMW E83 BMTR,1738,1,9,1,11
31303414299 *1,TORNILLO DE BARRA ESTABILIZADORA L BMW E83 FREY,1842,4,4,0,8
31303414300,TORNILLO DE BARRA  ESTABILIZADORA R BMW E83 BMTR,1521,1,6,9,16
31303414300 *1,TORNILLO DE BARRA  ESTABILIZADORA R BMW E83 (FREY),1961,7,2,0,9
31303414300-5,TORNILLO DE BARRA  ESTABILIZADORA R BMW E83 FREY,1394,2,6,3,11
31306772749,BASE DE AMORTIGUADOR DELANTERO L-R  MINI R56 LEMFORDER,1676,1,4,5,10
31306772749 *1,BASE AMORTIGUADOR SUSPENSION DELANTERA (L/R) MINI R55 A R61 (FREY),1477,4,8,9,21
31306772749-1,BASE DE AMORTIGUADOR DELANTERO L-R  MINI R56 TOPRAN,1655,6,0,7,13
31306772749-2,BASE DE AMORTIGUADOR DELANTERO L-R  MINI R56 MEISTERSATZ,1677,2,0,7,9
31306778833,BASE DE AMORTIGUADOR DELANTERO MINI R50-R53 CORTECO,1295,9,9,6,24
31306778833 *1 ,BASE AMORTIGUADOR SUSPENSION DELANTERA (L/R) MINI R50 R52 R53 (FREY),1351,0,5,4,9
31306778833-1,BASE DE AMORTIGUADOR DELANTERO MINI R50-R53 (OSSCA),1566,3,2,8,13
31306779604-1,BASE DE AMORTIGUADOR DELANTERO L-R BMW E53-M54 LEMFOERDER,1605,1,3,2,6
31306779604-2,BASE DE AMORTIGUADOR DELANTERO L-R BMW E53-M54 FEBI,1333,7,2,6,15
31306781545,TORNILLO ESTABILIZADOR SUSPENSION DELANTERA (L) BMW E66 (TOPRAN),1928,3,0,9,12
31306781546,TORNILLO ESTABILIZADOR SUSPENSION DELANTERA (R) BMW E66 (TOPRAN),1638,5,4,2,11
31306781548 *1 ,TORNILLO ESTABILIZADOR SUSPENSION DELANTERA (R) BMW E60 (FREY),1843,3,3,9,15
31306787163,TORNILLO ESTABILIZADOR SUSPENSION DELANTERA (L) BMW F25 (METRIX),1455,2,1,8,11
31306787163 *1,TORNILLO ESTABILIZADOR SUSPENSION DELANTERA (L) BMW F25 (FREY),1516,8,8,1,17
31306787164,TORNILLO ESTABILIZADOR SUSPENSION DELANTERA (R) BMW F25 (METRIX),1754,7,0,6,13
31306787164 *1,TORNILLO ESTABILIZADOR SUSPENSION DELANTERA (R) F25 F26  (FREY),1803,2,7,9,18
31306791712 *1,CUBRE POLVO AMORTIGUADOR SUSPENSION DELANTERA (L/R) BMW F20 F22 F30 F32  ( FREY ),1261,7,4,9,20
31306792211,TORNILLO ESTABILIZADOR SUSPENSION DELANTERA (L/R) BMW F20 F22 F30 F32 (LEMFORDER),1751,1,2,9,12
31306792211 *1,TORNILLO ESTABILIZADOR SUSPENSION DELANTERA (L/R) BMW F20 F22 F30 F32 (FREY),1935,4,9,5,18
31306792212 *2,TORNILLO ESTABILIZADOR SUSPENSION DELANTERA (R) BMW F20-F23 F30-F34 F36 (EMBLER),1492,8,4,3,15
31306795082 *1,BASE AMORTIGUADOR SUSPENSION DELANTERA (L/R) BMW F01 F07 F12 (FREY),1238,3,3,1,7
31306795083,BASE DE AMORTIGUADOR DELANTERO L-R BMW F10-N20 LEMFOERDER,1986,8,1,1,10
31306795083 *1,BASE DE AMORTIGUADOR DELANTERO L-R BMW F10-N20 FREY,1265,1,7,0,8
31306851879,BASE AMORTIGUADOR BMW F15 OSSCA,1481,3,5,6,14
31306851879 *1,BASE AMORTIGUADOR SUSPENSION DELANTERA (L/R) BMW F15 F16 (FREY),1704,6,0,6,12
31306852158 *1,BASE AMORTIGUADOR SUSPENSION DELANTERA (L/R) BMW F25 F26 (FREY),1626,3,5,8,16
31306852158-100,BASE DE AMORTIGUADOR DELANTERO BMW F25 N20-N55 INACTIVO,1936,6,3,1,10
31306852431 *1,BASE AMORTIGUADOR SUSPENSION DELANTERA (L/R) MINI F56 (FREY),1320,9,2,0,11
31306852431 *5,BASE AMORTIGUADOR SUSPENSION DELANTERA MINI F56 (CORTECO),1935,5,7,9,21
31306861483 *1,BARRA ESTABILIZADORA DE SUSPENSION BMW G11 G12 G30 G31 (FREY),1792,6,8,9,23
31306862863 *1,TORNILLO ESTABILIZADOR SUSPENSION DELATERA (L/R) MINI F55 F56 F57 (FREY),1414,0,5,7,12
31306862864 *1,TORNILLO ESTABILIZADOR SUSPENSION DELANTERA (L/R) BMW F39 F40 F44 F48 MINI  F54 F60 (FREY),1718,6,9,6,21
31306863135-1,PAR BASE DE AMORTIGUADOR DELANTERO ( L-R ) BMW F30-N20 LEMDORDER,1226,5,6,8,19
31306863135-4,BASE DE AMORTIGUADOR DELANTERO ( L-R ) BMW F30-N20 CORTECO,1844,4,7,9,20
31306869888 *1,BASE AMORTIGUADOR SUSPENSION DELANTERA (L/R) 6 TORNILLOS  BMW F20 F30 (FREY),1720,7,2,4,13
31306869888 *2,BASE AMORTIGUADOR SUSPENSION DELANTERA (L/R) 4 TORNILLOS  BMW F20 F30 (EMBLER),1998,0,0,9,9
31306877057 *3,AMORTIGUADOR AIRE SUSPENSION DELANTERA (L) BMW F40 (ALKO),1944,7,8,4,19
31306880366-2,BASE DE AMORTIGUADOR DE SUSPENSION DELANTERA MINI F56 EMBLER,1910,5,1,0,6
31306884181,BASE AMORTIGUADOR DELANTERO ( L- R ) BMW F48 CORTECO,1644,1,0,3,4
31306884181 *1,BASE AMORTIGUADOR SUSPENSION DELANTERA (L/R) BMW F38 F45 F46 F48 F54 F60 (FREY),1780,7,9,9,25
31306886751 ,AMORTIGUADOR SUSPENSION NDELANTERA (L) BMW F45 F46 F48 (SACHS),1253,1,7,7,15
31306886751 *A,AMORTIGUADOR SUSPENSION DELANTERA (L) BMW F45 F46 F48 (EMBLER) TECH,1930,8,0,2,10
31306886752,AMORTIGUADOR DELANTERO (R) BMW F45 F46 F48 SACHS,1796,2,4,9,15
31306886752 *A,AMORTIGUADOR SUSPENSION DELANTERA (R) BMW F45 F46 F48 (EMBLER) TECH,1482,7,5,1,13
31306886753 *5,AMORTIGUADOR SIN SENSOR SUPENSION DELANTERA (L) BMW F48 F49 (BILSTEIN) SSF,1355,6,5,7,18
31306886754 *5,AMORTIGUADOR SIN SENSOR SUPENSION DELANTERA (R) BMW F48 F49 (BILSTEIN) SSF,1264,4,3,6,13
31306886755 *5,AMORTIGUADOR SUSPENSION DELANTERA (L) BMW F48 (BILSTEIN) SSF,1529,0,8,7,15
31306886756 *5,AMORTIGUADOR SUSPENSION DELANTERA (R) BMW F48 (BILSTEIN) SSF,1779,2,9,4,15
31306888325 *1,BASE AMORTIGUADOR SUSPENSION DELANTERA (L/R) BMW G01 G02 (FREY),1557,1,7,5,13
31306893359 *1,TORNILLO BARRA ESTABILIZADORA SUSPENSION DELANTERA (L) BMW G20 G21 (FREY),1974,2,5,9,16
31306893359 *2,TORNILLO BARRA ESTABILIZADORA SUSPENSION DELANTERA (L) BMW G20 G21 (EMBLER),1613,7,6,1,14
31306893360 *1,TORNILLO BARRA ESTABILIZADORA SUSPENSION DELANTERA (R) BMW G20 G21 (FREY),1940,2,3,6,11
31306893360 *2,TORNILLO BARRA ESTABILIZADORA SUSPENSION DELANTERA (R) BMW G20 G21 (EMBLER),1563,4,0,3,7
31309813653 *5,AMORTIGUADOR SUSPENSION DELANTERA (L) MINI R60 R61 (BILSTEIN) SSF,1872,7,3,6,16
31309813654 *5,AMORTIGUADOR SUSPENSION DELANTERA (R) MINI R60 R61 (BILSTEIN) SSF,1611,0,1,4,5
31311091101,AMORTIGUADOR DE SUSPENSION DELANTERA L BMW E36 BENDIX,1532,0,4,9,13
31311091102,AMORTIGUADOR DE SUSPENSION DELANTERA R BMW E36 BENDIX,1212,9,0,5,14
31311091773-V,AMORTIGUADOR DE SUSPENSION DELANTERA L BMW E36 FREY,1783,2,1,0,3
31311091774,AMORTIGUADOR DE SUSPENSION DELANTERA R BMW E36 FREY,1523,9,2,0,11
31311096271 *1,AMORTIGUADOR SUSPENSION DELANTERA (L) BMW E53 (FREY),1790,8,8,5,21
31311096272 *1,AMORTIGUADOR SUSPENSION DELANTERA (R) BMW E53 (FREY),1831,7,8,4,19
31312283126 *A,AMORTIGUADOR AIRE (R)  BMW E60 (EMBLER) TECH,1833,9,4,6,19
31313453521,AMORTIGUADOR SUSPENSION DELANTERO (L) BMW E83 (BMTSR),1652,5,8,1,14
31313453521 *1,AMORTIGUADOR SUSPENSION DELANTERA (L) BMW E83 (FREY),1384,8,4,6,18
31313453522 *1,AMORTIGUADOR SUSPENSION DELANTERA (R) BMW E83 (FREY),1267,1,6,7,14
31313453522-1,AMORTIGUADOR DE SUSPENSION DELANTERA ( R ) BMW E83 BMTR,1745,5,3,1,9
31316151 *5,1 PZ. SELLO VALVULA ESCAPE MOTOR 6 MM VOLVO  2.5 2.9 C30 C70 S40 S60 S80 V40 V50 V70 XC60 XC70 XC90 (VICTOR REINZ) SSF,1588,9,4,7,20
31316151 *6,1 PZ. SELLO VALVULA ESCAPE MOTOR 6 MM VOLVO  2.5 2.9 C30 C70 S40 S60 S80 V40 V50 V70 XC60 XC70 XC90 (CORTECO) SSF,1919,3,1,5,9
31316151-100,SELLOS VALVULA ESCAPE MOTOR 6 MM VOLVO  V40 V50 INACTIVO,1480,9,6,9,24
31316752597 *1,AMORTIGUADOR DE SUSPENSION DELANTERA L BMW E65-N62 FREY,1974,3,1,0,4
31316752598 *1,AMORTIGUADOR SUSPENSION DELANTERA (R) BMW E65 (FREY),1362,2,1,4,7
31316759097 *1,AMORTIGUADOR SUSPENSION DELANTERA (L) BMW E46 (FREY),1506,5,3,0,8
31316759098 *1,AMORTIGUADOR SUSPENSION DELANTERA (R) BMW E46 (FREY),1229,6,0,5,11
31316764603 *R,AMORTIGUADOR SUSPENSION DELANTERA CON RESORTE (L) BMW E53 (FREY),2000,9,5,2,16
31316764604 *1,AMORTIGUADOR SUSPENSION DELANTERA CON RESORTE (R) BMW E53 (FREY),1250,1,2,1,4
31316772730,AMORTIGUADOR DE SUSPENSION SPORT DELANTERA ( R ) MINI R56 S SACHS 313739Z,1711,2,9,3,14
31316772921 *1,AMORTIGUADOR SUSPENSION DELANTERA (L) BMW E87 E90 (FREY),1792,0,8,6,14
31316772921 *2,AMORTIGUADOR DE SUSPENSION DELANTERA L BMW E90-N52 SACHS 311403 (EMBLER) TECH,1973,2,1,4,7
31316772921 *4,AMORTIGUADOR DE SUSPENSION DELANTERA (L) BMW E87 E90 (BMTR),1651,6,0,2,8
31316772922 *1,AMORTIGUADOR SUSPENSION DELANTERA (R) BMW E87 E90 (FREY),1555,0,7,8,15
31316772922-100,AMORTIGUADOR DE SUSPENSION DELANTERA ( R ) BMW E87 E90 BMTR inactivo,1574,8,6,2,16
31316780465-9,AMORTIGUADOR DE SUSPENSION DELANTERO L MINI R50 SACHS 290237,1969,5,3,8,16
31316780466-9,AMORTIGUADOR DE SUSPENSION DELANTERO R MINI R50 SACHS 290236,1388,1,5,4,10
31316780469,AMORTIGUADOR DE SUSPENSION DELANTERO (L) MINI R53 BILSTEIN,1590,4,7,8,19
31316780470,AMORTIGUADOR DE SUSPENSION DELANTERO (R) MINI R53 BILSTEIN,1254,7,0,5,12
31316780521 *1,AMORTIGUADOR SUSPENSION DELANTERA (L) MINI R50 R52 R53 (FREY),1877,1,2,7,10
31316780522 *1,AMORTIGUADOR SUSPENSION DELANTERA (R) MINI R50 R52 R53 (FREY),1537,0,5,0,5
31316782207 *1,AMORTIGUADOR SUSPENSION DELANTERA (L) MINI R56 R58 (FREY),1564,0,3,6,9
31316782208 *1,AMORTIGUADOR SUSPENSION DELANTERA (R) MINI R56 R58 (FREY),1376,8,0,8,16
31316782209 *2,AMORTIGUADOR SUSPENSION DELANTERA (L) MINI R56 SACHS 313738,1607,6,6,9,21
31316782210 *3,AMORTIGUADOR DE SUSPENSION SPORT DELANTERA ( R ) MINI R56 S SACHS 313739,1230,9,2,1,12
31316783016 *1,AMORTIGUADOR SIN SENSOR SUSPENSION DELANTERA (L/R) BMW E71 E71 (FREY),1497,1,2,8,11
31316784521,AMORTIGUADOR TRASERO L - R MINI COOPER  R56 SACHS 313741Z,1781,4,2,0,6
31316784917 *3,AMORTIGUADOR AIRE SUSPENSION DELANTERA (L) BMW E89 (KONI),1387,2,8,7,17
31316784918 *3,AMORTIGUADOR AIRE SUSPENSION DELANTERA (R) BMW E89 (KONI),1250,0,9,5,14
31316785592-100,BALERO DE RUEDA DELANTERA L-R BMW F30-N20 FREY INACTIVO,1978,9,3,7,19
31316785987 *1,AMORTIGUADOR DE SUSPENSION DELANTERA L BMW Z4 FREY 312466,1529,1,9,7,17
31316785987 *3,AMORTIGUADOR DE SUSPENSION DELANTERA L BMW Z4 (BILSTEIN),1951,3,9,7,19
31316785988,AMORTIGUADOR DE SUSPENSION DELANTERA R BMW Z4 (BILSTEIN),1679,9,3,1,13
31316785988 *1,AMORTIGUADOR DE SUSPENSION DELANTERA R BMW Z4 FREY 312467,1363,8,0,8,16
31316786013 *5,AMORTIGUADOR SUSPENSION DELANTERA (L) BMW E91 (BILSTEIN) SSF,1413,6,8,9,23
31316786014 *5,AMORTIGUADOR SUSPENSION DELANTERA (R) BMW E87 E90 (BILSTEIN) SSF,1989,7,3,6,16
31316786532,AMORTIGUADOR DE SUSPENSION DELANTERA R BMW E65-N62 BMTR,1462,2,7,4,13
31316791551 *1,AMORTIGUADOR SIN SENSOR SUSPENSION DELANTERA (L/R) BMW F20 F30 F32 (FREY),1776,8,0,3,11
31316791551 *5,AMORTIGUADOR SIN SENSOR SUSPENSION DELANTERA (L/R) BMW F20 F30 F32 (SACHS 315869) SSF,1853,7,2,7,16
31316791551 *6,AMORTIGUADOR SIN SENSOR SUSPENSION DELANTERA (L/R) BMW F20 F30 F32 (BILSTEIN) SSF,1331,5,5,0,10
31316796315 *1,AMORTIGUADOR SIN SENSOR SUSPENSION DELANTERA (L) BMW F25 F26 (FREY),1848,8,7,3,18
31316796315 *3,AMORTIGUADOR SUSPENSION DELANTERA (L) BMW F25 F26 (SACHS 314878),1323,4,2,2,8
31316796315 *5,AMORTIGUADOR SIN SENSOR SUSPENSION DELANTERA (L) BMW F25 F26 (BILSTEIN) SSF,1503,6,9,3,18
31316796316 *1,AMORTIGUADOR SIN SENSOR SUSPENSION DELANTERA (R) BMW F25 F26 (FREY),1442,0,2,8,10
31316796316 *3,AMORTIGUADOR SUSPENSION DELANTERA (R) BMW F25 (SACHS 314879),1410,9,4,2,15
31316796316 *5,AMORTIGUADOR SIN SENSOR SUSPENSION DELANTERA (R) BMW F25 F26 (BILSTEIN) SSF,1585,4,4,8,16
31316850441 *1,AMORTIGUADOR SUSPENSION DELANTERA (L) BMW F10 F18 (FREY),1898,5,5,9,19
31316850442 *1,AMORTIGUADOR SUSPENSION DELANTERA (R) BMW F10 F18 (FREY),1362,2,3,1,6
31316851333 *1,AMORTIGUADOR SUSPENSION DELANTERA (L) BMW E84 sDRIVE 18i 20i (FREY),1358,0,2,8,10
31316851334 *1,AMORTIGUADOR SUSPENSION DELANTERA (R) BMW E84 sDRIVE 18i 20i (FREY),1762,8,8,0,16
31316851335 *1,AMORTIGUADOR SUSPENSION DELANTERA (L) BMW E84 xDRIVE 25i 28i 35i (FREY),1217,6,3,4,13
31316851336 *1,AMORTIGUADOR SUSPENSION DELANTERA (R) BMW E84 xDRIVE 25i 28i 35i (FREY),1925,0,8,9,17
3131685135-100,AMORTIGUADOR SUSPENSION DELANTERA (L) BMW E84 SACHS INACTIVO,1950,3,2,6,11
31316851747 *1,AMORTIGUADOR SIN SENSOR SUSPENSION DELANTERA (L/R) BMW F15 F16 (FREY),1472,0,2,3,5
31316852411 *3,AMORTIGUADOR SUSPENSIï¿½N DELANTERA (L) MINI F55 F56 (GENUINO),1810,0,8,0,8
31316852411-100,AMORTIGUADOR DE SUSPENSIï¿½N DELANTERA (R) MINI F56 B38 INACTIVO,1391,3,4,3,10
31316852412 *3,AMORTIGUADOR SUSPENSIï¿½N DELANTERA (R) MINI F55 F56 (GENUINO),1861,8,7,6,21
31316852412-100,AMORTIGUADOR DE SUSPENSIï¿½N DELANTERA ( L ) MINI F56 B38 INACTIVO,1459,6,3,0,9
31316852413 *1,AMORTIGUADOR SIN SENSOR SUSPENSION DELANTERA (L) MINI F55 F56 F57 (FREY),1926,2,8,8,18
31316852413 *5,AMORTIGUADOR SUSPENSION DELANTERA (L) MINI F55 F56 F57 (BILSTEIN) SSF,1966,5,5,9,19
31316852414 *1,AMORTIGUADOR SIN SENSOR SUSPENSION DELANTERA (R) MINI F55 F56 F57 (FREY),1711,7,5,7,19
31316852414 *5,AMORTIGUADOR SUSPENSION DELANTERA (R) MINI F55 F56 F57 (BILSTEIN) SSF,1766,8,4,6,18
31316861685 *1,AMORTIGUADOR SIN SENSOR SUPENSION DELANTERA (L) BMW F48 F49 (FREY),1975,8,2,1,11
31316861686 *1,AMORTIGUADOR SIN SENSOR SUPENSION DELANTERA (R) BMW F48 F49 (FREY),1966,4,2,4,10
31316861692-100,AMORTIGUADOR DELANTERO (R) 318293 INACTIVO,1667,1,9,7,17
31316862701 *1,AMORTIGUADOR SUSPENSION DELANTERA (L) MINI F54 (FREY),1430,9,7,9,25
31316862702 *1,AMORTIGUADOR SUSPENSION DELANTERA (R) MINI F54 (FREY),1474,5,3,2,10
31316862702 *3,AMORTIGUADOR SUSPENSION DELANTERA (R) MINI F54 (BILSTEIN),1936,6,1,2,9
31316862702 *A,AMORTIGUADOR SUSPENSION DELANTERA (R) MINI F54 (EMBLER) TECH,1553,9,0,5,14
31316866030 *1,AMORTIGUADOR SUSPENSION DELANTERA (R) BMW G01 G02 (FREY),1975,7,4,8,19
31316866600 *3,AMORTIGUADOR AIRE SUSPENSION DELANTERA (R) BMW G30 (HIGH QUALITY),1710,6,5,0,11
31316867213 *1,AMORTIGUADOR SUSPENSION DELANTERA (L) MINI COOPER F60 (FREY),1656,3,8,7,18
31316867214 *1,AMORTIGUADOR SUSPENSION DELANTERA (R) MINI COOPER F60 (FREY),1504,0,6,8,14
31316871779 *1,AMORTIGUADOR AIRE SUSPENSION DELANTERA (L) BMW G01 G02 (FREY),1625,6,3,5,14
31316890929 *1,AMORTIGUADOR AIRE SUSPENSION DELANTERO (L) BMW G38 (FREY),1207,6,4,5,15
31316890930 *1,AMORTIGUADOR AIRE SUSPENSION DELANTERO (R) BMW G38 (FREY),1900,5,9,7,21
31318036005,AMORTIGUADOR DELANTERO ( L ) BMW E87 BILSTEIN,1887,8,9,5,22
31319606 *2,TERMOSTATO ENFRIAMIENTO MOTOR VOLVO C30 C70 S40 S50 V50 V60 XC60 XC70 (EMBLER) GOG,1450,6,3,8,17
31319606 *5,TERMOSTATO ENFRIAMIENTO MOTOR VOLVO C30 C70 S40 S50 V50 V60 XC60 XC70 (PRO PARTS) SSF,1271,5,3,4,12
31319608,TERMOSTATO WAHLER,1356,4,3,4,11
31326764457,AMORTIGUADOR DE SUSPENSION DELANTERA L BMW E60 BMTR,1761,9,5,3,17
31326764457 *1,AMORTIGUADOR ALUMINIO SUSPENSION DELANTERA (L) BMW E60 2004 A 2007 (FREY),1982,5,2,3,10
31326764458 *1,AMORTIGUADOR ALUMINIO SUSPENSION DELANTERA (R) BMW E60 2004 A 2007 (FREY),1542,5,1,0,6
31326781918 *3,AMORTIGUADOR SUSPENSION DELANTERA (L/R) BMW E70 (SACHS 315312),1217,2,7,8,17
31330050 *3,FILTRO ACEITE MOTOR VOLVO C30 S60 S40 MAHLE OC1014,1326,5,8,4,17
31331090612 *1,BALERO BASE AMORTIGUADOR SUPENSION DELNATERA (L/R) BMW E39 E46 E60 E53 E85 (FREY),1497,7,2,1,10
3133109170-100,BASE DE AMORTIGUADOR DELANTERO ( L-R ) BMW E46 INACTIVO,1523,3,7,4,14
31331091709 *1,BASE AMORTIGUADOR SUSPENSION DELANTERA (L/R) BMW E46 E83 E90 (FREY),1478,0,9,1,10
31331091709 *2 ,BASE AMORTIGUADOR SUSPENSION DELANTERA (L/R) BMW E46 E83 E90 (EMBLER),1651,2,5,4,11
31331094616*6,BASE AMORTIGUADOR DELANTERA BMW E46 E83 E90  CORTECO,1440,3,2,5,10
31331094749,CUBRE POLVO AMORTIGUADOR L-R BMW E90 BMTR,1859,6,6,2,14
31331094749 *1,CUBRE POLVO AMORTIGUADOR SUSPENSION DELANTERA (L/R) BMW E90 (FREY),1225,6,1,1,8
31331096311 *1,BASE AMORTIGUADOR SUSPENSION DELANTERA (L/R) BMW E53 (FREY),1448,2,3,9,14
31331124508,BASE DE AMORTIGUADOR E36 BOGE,1429,9,0,8,17
31331139437,BASE DE AMORTIGUADOR DELANTERO L-R BMW E34 CORTECO,1272,8,9,0,17
31331139437-1,BASE DE AMORTIGUADOR DELANTERO L-R BMW E34 FREY,1240,3,3,0,6
31331765 *5,SENSOR ARBOL LEVAS VOLVO C30 C70 S40 S60 S80 V50 V70 XC70 XC90 (FACET) SSF,1914,5,9,1,15
31331765 *6,SENSOR ARBOL LEVAS VOLVO C30 C70 S40 S60 S80 V50 V70 XC70 XC90 (BREMI) SSF,1503,0,4,2,6
31336750892,GOMA DE REBOTE DE AMORTIGUADOR DELANTERA L-R BMW E46 BMTR,1339,5,1,6,12
31336750892 *1,TOPE GOMA REBOTE AMORTIGUADORSUSPENSION DELANTERA (L/R) BMW E46 (FREY),1669,7,6,1,14
31336767333,GOMA DE REBOTE TOPE DE AMORTIGUADOR E90,1963,5,5,3,13
31336769584 *3,BASE AMORTIGUADOR SUSPENSION DELANTERA (L/R) BMW E53 (CORTECO),1346,7,9,4,20
31336769584-9,BASE DE AMORTIGUADOR DELANTERO L-R BMW E53-M54,1831,9,8,9,26
31336771352 *1,TOPE AMORTIGUADOR SUSPENSION DELANTERA (L/R) BMW E90 (FREY),1922,2,7,7,16
31336771352-100,TOPE DE AMORTIGUADOR L-R BMW E90 BEMQW INACTIVO,1790,7,3,1,11
31336771516,GOMA DE REBOTE DE AMORTIGUADOR DELANTERO BMW E70 BMTR,1431,6,9,8,23
31336771516-1,GOMA DE REBOTE DE AMORTIGUADOR DELANTERO BMW E70 FREY,1888,9,3,9,21
31336771892 ,GOMA DE REBOTE DE AMORTIGUADOR DELANTERO BMW E70  BMTR,1423,0,0,8,8
31336771892 *1,GOMA REBOTE AMORTIGUADOR SUSPENSION DELANTERA (L/R) BMW E70 E71 (FREY),1350,9,8,5,22
3133677473-100,BASE DE AMORTIGUADOR DELANTERO BMW E70-N52 INACTIVO,1281,5,1,9,15
31336774738,BASE DE AMORTIGUADOR DELANTERO BMW E70-N52 (LEMFOERDER),1449,4,8,2,14
31336775097 *3,BASE DE AMORTIGUADOR DELANTERO BMW E90 E91 E92 (OSSCA),1298,5,1,8,14
31336776389,SOPORTE DE GOMA INFERIOR DE BASE AMORTIGUADOR DELANTERO BMW E70 LEMFOERDER,1776,4,3,8,15
31336776389-1,SOPORTE DE GOMA INFERIOR DE BASE AMORTIGUADOR DELANTERO BMW E70 FREY,1811,2,8,2,12
31336776390 *1,GOMA SUPERIOR BASE AMORTIGUADOR SUSPENSION DELANTERA (L/R)  BMW E70 E71 (FREY),1794,1,5,6,12
31336776390C-100,SOPORTE DE GOMA SUPERIOR DE BASE AMORTIGUADOR DELANTERO BMW E70 INACTIVO,1443,9,2,3,14
31336779612,BASE DE AMORTIGUADOR DELANTERO BMW E65-N62 BMTR,1472,7,5,8,20
31336779612 *1,BASE DE AMORTIGUADOR DELANTERO BMW E65-N62 FREY,1495,5,6,6,17
31336787104 *1,CUBRE POLVO GOMA REBOTE AMORTIGUADOR SUSPENSION DELANTERA (L/R) BMW F25 F26 (FREY),1621,7,2,5,14
31336788776 *1,BASE AMORTIGUADOR SUSPENSION DELANTERA (L/R) BMW E70 E71 (FREY),1663,9,6,9,24
31336788776 *3,BASE SOPOPRTE AMORTIGUADOR DELANTERO BMW E70 E71 (CORTECO),1299,6,5,6,17
31336788776-3,BASE DE AMORTIGUADOR DELANTERO BMW E70-N52 EMBLER,1901,5,3,4,12
31336788776-4,BASE DE AMORTIGUADOR DELANTERO BMW E70-N52 LEMFOERDER,1919,0,3,1,4
31336798834 *1,BASE GOMA RESORTE SUSPENSION DELANTERA (L/R) BMW F01 F06 F10 F25 F26 I12 (FREY),1640,0,5,5,10
31336854708 *1,TOPE GOMA MUELLE SUSPENSION DELANTERA (L/R) BMW F20 F22 F30 MINI F56 (FREY),1801,4,2,8,14
31336855440 *5,GOMA DE REBOTE DE AMORTIGUADOR DELANTERO BMW F20-F23 F30-F32 F45 MINI F54 (FEBI) SSF,1747,8,7,4,19
31336859766 *3,GOMA DE REBOTE DE AMORTIGUADOR DELANTERO MINI F55 F56 F57 (VERMO),1980,7,6,6,19
31338685 *2,SEPARADOR ACEITE PCV MOTOR VOLVO T5 5 CILINDROS (EMBLER) GOG,1475,4,5,2,11
31340273,TORNILLO DE BARRA ESTABILIZADORA ( L / R ) VOLVO S40 ( NORDIC ),1592,6,2,0,8
31340273-1,TORNILLO DE BARRA ESTABILIZADORA ( L / R ) VOLVO S40 2a GEN. ( LEMFOERDER ),1604,7,6,1,14
31341331 *3,BALATAS FRENOS TRASEROS VOLVO C30-S40 (TRW GDB1938),1522,3,6,2,11
31341331 *5,BALATAS FRENOS TRASEROS VOLVO C30-S40 (BOSCH) SSF,1581,9,3,9,21
31341331 *6,BALATAS FRENOS TRASEROS VOLVO C30-S40 (ATE) SSF,1586,5,5,3,13
31341331-1,BALATAS FRENOS TRASEROS VOLVO C30-S40 BREMBO P59042N,1769,7,0,0,7
31342364 *5,SENSOR MASA AIRE MOTOR MAF VOLVO C30 C70 S40 V50 (PIERBURG) SSF,1866,2,5,3,10
31351090263,BUJE DE GOMA DE BARRA ESTABILIZADORA BMW E36 MTC,1792,6,0,4,10
31351090263-1,BUJE DE GOMA DE BARRA ESTABILIZADORA BMW E36 FREY,1296,2,0,0,2
31351090263-3,BUJE DE GOMA DE BARRA ESTABILIZADORA BMW E36 URO,1969,2,3,8,13
31351091764,TORNILLO DE BARRA ESTABILIZADORA DELANTERA ( L/ R ) BMW E36 ( MAYLE ),1251,6,9,6,21
31351091764-1,TORNILLO DE BARRA ESTABILIZADORA DELANTERA ( L-R ) BMW E36 KARLYN,1753,1,9,5,15
31351091764-2,TORNILLO DE BARRA ESTABILIZADORA DELANTERA ( L-R ) BMW E36 LEMFORDER,1559,5,6,2,13
31351091764-3,TORNILLO DE BARRA ESTABILIZADORA DELANTERA ( L-R ) BMW E36 FREY,1574,3,5,9,17
31351094556 *1,BUJE GOMA BARRA ESTABILIZADORA SUSPENSION DELANTERA 24 MM (L/R) BMW E46 E85 E86 (FREY),1618,9,9,4,22
31351094556 *5,BUJE GOMA BARRA ESTABILIZADORA SUSPENSION DELANTERA 24 MM (L/R) BMW E46 E85 E86 (FEBI) SSF,1220,8,3,5,16
31351095661,TORNILLO DE BARRA ESTABILIZADORA L BMW E39 BMTR,1741,1,0,6,7
31351095661-1,TORNILLO DE BARRA ESTABILIZADORA L BMW E39 FREY,1922,9,0,2,11
31351095662,TORNILLO DE BARRA ESTABILIZADORA R BMW E39 BMTR,1244,7,8,5,20
31351095662-1,TORNILLO DE BARRA ESTABILIZADORA R BMW E39 FREY,1869,2,4,4,10
31351095694 *1,TORNILLO BARRA ESTABILIZADORA SUSPESNSION DELANTERA (L/R) BMW E46 E85 E86 FREY,1617,7,8,3,18
31351097021 *1,BUJE GOMA BARRA ESTABILIZADORA SUSPENSION DELANTERA 29 MM BMW E53 (FREY),1217,6,3,3,12
31351097021 *5,BUJE GOMA BARRA ESTABILIZADORA SUSPENSION DELANTERA 29 MM BMW E53 (FEBI) SSF,1897,3,0,0,3
31351097021-2,BUJE DE GOMA DE BARRA ESTABILIZADORA BMW E53 VAICO,1452,9,3,2,14
31351097179,GOMA DE BARRA ESTABILIZADORA BMW E46 / M54 ( FEBI ),1721,7,6,9,22
31351097179 *1,GOMA BUJE BARRA ESTABILIZADORA SUSPENSION DELANTERA 23 MM BMW E46 (FREY),1344,7,2,0,9
31356750703,TORNILLO ESTABILIZADOR SUSPENSION  DELANTERA (L) BMW E53 (BMTR),1992,6,8,3,17
31356750703 *1,TORNILLO ESTABILIZADOR SUSPENSION DELANTERA (L) BMW E53 (FREY),1287,6,9,5,20
31356750703 -4,TORNILLO ESTABILIZADOR SUSPENSION  DELANTERA (L) BMW E53 (LEMFORDER),1714,8,4,3,15
31356750703-2,TORNILLO ESTABILIZADOR SUSPENSION DELANTERA (L) BMW E53 (MEYLE),1726,4,5,8,17
31356750704,TORNILLO ESTABILIZADOR SUSPENSION DELANTERA (R) BMW E53 (BMTR),1698,4,4,0,8
31356750704 *1,TORNILLO ESTABILIZADOR SUSPENSION DELANTERA (R) BMW E53 (FREY),1549,9,6,8,23
31356757146,GOMA DE BARRA ESTABILIZADORA MINI R56 URO,1325,5,0,5,10
31356757146 *1,BUJE GOMA BARRA ESTABILIZADORA DELANTERA 22.5 MM (L/R) MINI R50 R52 R55 R56 R57 R58 R59 (FREY),1832,9,6,4,19
31356757146-2,GOMA DE BARRA ESTABILIZADORA MINI R56 TOPRAN,1414,4,2,6,12
31356758302,BUJE DE GOMA DE BARRA ESTABILIZADORA EJE DELANTERO L-R OSSCA,1724,7,1,2,10
31356758302 *1,BUJE GOMA BARRA ESTABILIZADORA DELANTERA 24 MM (L/R) MINI R50 R52 R53 R56 R58 (FREY),1509,3,5,1,9
3135676-100,TONILO ESTIZADOR INACTIVO,1590,3,3,2,8
31356765574 *1,BUJE GOMA BARRA ESTABILIZADORA 26.5 MM (L/R) BMW E81 E89 E90 (FREY),1846,6,7,6,19
31356765574 *5,BUJE GOMA BARRA ESTABILIZADORA 26.5 MM (L/R) BMW E81 E89 E90 (FEBI) SSF,1790,4,6,1,11
31356765574-2,BUJE DE GOMA DE BARRA ESTABILIZADORA BMW MOTOR N52-N46N CRP,1590,1,0,0,1
31356765933,TORNILLO ESTABILIZADOR SUSPENSION DELANTERA (L) BMW E90 (BMTR),1588,9,4,6,19
31356765933 *1,TORNILLO ESTABILIZADOR SUSPENSION DELANTERA (L) BMW E81 E84 E89 E90 (FREY),1657,1,6,4,11
31356765933-1,TORNILLO ESTABILIZADOR SUSPENSION DELANTERA (L) BMW E90 (BEMQW),1353,5,3,3,11
31356765934 *1,TORNILLO ESTABILIZADOR SUSPENSION DELANTERA (R) BMW E81 E84 E89 E90 (FREY),1970,5,5,9,19
31356765934 *5,TORNILLO ESTABILIZADOR SUSPENSION DELANTERA (R) BMW E81 E84 E89 E90 (LEMFORDER) SSF,1736,5,4,4,13
31356765934 *6,TORNILLO ESTABILIZADOR SUSPENSION DELANTERA (R) BMW E81 E84 E89 E90 (DELPHI) SSF,1659,3,0,5,8
31356768771 *1,TORNILLO ESTABILIZADOR SUSPENSION DELANTERA (L) BMW E84 E90 (FREY),1765,6,1,5,12
31356768771 *5,TORNILLO ESTABILIZADOR SUSPENSION DELANTERA (L) BMW E84 E90 (DELPHI) SSF,1316,4,9,8,21
31356768772 *1,TORNILLO ESTABILIZADOR SUSPENSION DELANTERA (R) BMW E84 E90 (FREY),1431,1,6,2,9
31356768772 *5,TORNILLO ESTABILIZADOR SUSPENSION DELANTERA (R) BMW E84 E90 (DELPHI) SSF,1464,0,2,4,6
31356769499 *1,TORNILLO BARRA ESTABILIZADORA SUSPENSION DELANTERA (L) BMW E60 E61 (FREY),1271,1,5,8,14
31356769500 *1,TORNILLOS BARRA ESTABILIZADORA SUSPENSION DELANTERA (R) BMW E60 E61 (FREY),1852,9,4,5,18
31356772843 *5,BUJE GOMA BARRA ESTABILIZADORA SUSPENSION DELANTERA 21.5 MM MINI R56 R58 (FEBI),1427,5,4,8,17
31356772843-1,BUJE DE BARRA ESTABILIZADORA DE SUSPENSION DELANTERA MINI R56 TOPRAN,1402,6,3,5,14
31356772844 *5,BUJE GOMA BARRA ESTABILIZADORA 23.5 MM MINI R55 R56 R57 R59 (MEYLE) SSF,1337,0,9,5,14
31356773023 *1,TORNILLO ESTABILIZADOR SUSPENSION DELANTERA (L) BMW E70 E71 E72 F15 F16 (FREY),1238,5,4,9,18
31356773023 *5,TORNILLO ESTABILIZADOR SUSPENSION DELANTERA (L) BMW E70 E71 E72 F15 F16 (FEBI) SSF,1350,4,1,7,12
31356773023-4,TORNILLO ESTABILIZADOR SUSPENSION DELANTERA (L) BMW E70 (BEMQW),1467,6,8,8,22
31356773024 *1,TORNILLO ESTABILIZADOR SUSPENSION DELANTERA (R) BMW E70 E71 E72 F15 F16 (FREY),1939,5,6,3,14
31356774737 *1 ,BARRA ESTABILIZADORA SUSPENSION DELANTERA BMW E70 E71 (FREY ),1540,3,7,1,11
31356777319,TORNILLO ESTABILIZADOR SUSPENSION DELANTERA (L/R) BMW F10 (SIDEM),1267,2,9,2,13
31356777319 *1,TORNILLO ESTABILIZADOR SUSPENSION DELANTERA (L/R) BMW F01 F02 F03 F04 F06 F07 10 F11 F12 F13  (FREY),1861,9,5,1,15
31356778831 *1,TORNILLO ESTABILIZADOR SUSPENSION DELANTERA (L/R) MINI R50 A R59 (FREY),1242,8,5,1,14
31356778831 *5,TORNILLO ESTABILIZADOR SUSPENSION DELANTERA (L/R) MINI R50 A R59 (KARLYN) SSF,1417,3,5,2,10
31356778831-1,TORNILLO ESTABILIZADOR SUSPENSION DELANTERA (L/R) MINI R56 (DELPHI),1475,3,5,3,11
31356780847 *5,TORNILLO BARRA ESTABILIZADORA SUSPESNSION DELANTERA (L/R) BMW E46 E85 E86 (FEBI) SSF,1773,5,4,1,10
31356780847-100,TORNILLO DE BARRA ESTABILIZADORA DELANTERO L-R BMW E46 METRIX INACTIVO,1874,3,9,3,15
31356780847-3,TORNILLO DE BARRA ESTABILIZADORA DELANTERO L-R BMW E46 BEMQW,1533,9,3,3,15
31356788710B,BUJE GOMA BARRA ESTABILIZADORA SUSPENSION DELANTERA 5.7 MM (L/R) BMW F25 F26 (FREY),1721,0,1,4,5
31356792124,GOMA DE BARRA ESTABILIZADORA BMW F30 BEMQW,1626,1,7,9,17
31356792124B,GOMA DE BARRA ESTABILIZADORA BMW F20 F21 F22 F23 F30 F31 F32 F33 F36 (FREY),1472,8,6,3,17
31356857623 *3,TORNILLO ESTABILIZADOR SUSPENSION DELANTERA (L) BMW E70 (BMTR),1661,1,2,7,10
31356857624 *5,TORNILLO ESTABILIZADOR SUSPENSION DELANTERA (R) BMW E70 E71 E72 F15 F16 (FEBI) SSF,1544,7,0,9,16
31356857624-9,TORNILLO ESTABILIZADOR SUSPENSION DELANTERA (R) BMW E70 (BMTR),1830,3,5,8,16
31356863402B,BUJE BARRA ESTABILIZADORA DELANTERA BMW F15 F16 (FREY),1486,9,4,1,14
31356881091 *5,TORNILLO BARRA ESTABILIZADORA SUSPENSION DELANTERA (L) BMW G01 G02 (LEMFï¿½RDER) SSF,1687,5,7,6,18
31356881092 *5,TORNILLO BARRA ESTABILIZADORA SUSPENSION DELANTERA (R) BMW G01 G02 (LEMFï¿½RDER) SSF,1355,2,6,4,12
31359779,SOPORTE DE MOTOR ( L ) VOLVO S40 ( PRO PARTS ),1351,3,1,3,7
31359806351 *3,TORNILLO ESTABILIZADOR SUSPENSION DELANTERA (L) MINI R60 R61 (DELPHI),1426,2,0,3,5
31359806352 *2,TORNILLO ESTABILIZADOR SUSPENSION DELANTERA (R) MINI R60 R61 (EMBLER),1733,0,2,2,4
31360784 *5,BUJE HORQUILLA SUSPENSION DELANTERA (L/R) VOLVO S60 S80 V70 (FEBI) SSF,1921,5,0,6,11
31369415 *3,FILTRO POLEN AIRE CABINA CON CARBON ACTIVADO VOLVO S40 V40 2000 A 2004 (MAHLE LAK107),1866,5,7,7,19
31369416 *3,FILTRO ENTRADA AIRE MOTOR VOLVO S40 (MAHLE LA107),1333,3,7,3,13
31370089 *5,FILTRO ENTRADA AIRE MOTOR VOLVO S60 S90 V60 V60XC V90 XC60 XC 90 (HENGST ALEMAN) SSF,1578,3,0,5,8
3141300360 *1,POLEA REENVIO DE UN SOLO CANAL 97 MM  MERCEDES M112 M113 (FREY),1253,5,4,1,10
31491073 *5,SENSOR POSICIONION ARBOL LEVAS (L/R) VOLVO JAGUAR LAND ROVER (BREMI) SSF,1731,1,8,4,13
31507508522,DIFERENCIAL DELANTERO SEMINUEVO BMW MOTOR M62 ORIGINAL,1583,3,0,1,4
31507512915,DIFERENCIAL DELANTERO SEMINUEVO BMW MOTOR M54-N62 GENUINO,1547,4,0,9,13
31507603004,DIFERENCIAL DELANTERO BMW E70 (PASO 44/10),1334,5,8,5,18
31508743675,RETEN DE CIGUEï¿½AL DELANTERO BMW F30 / N20 ( CORTECO ),1520,9,6,3,18
31508743675-1,RETEN DE CIGUEï¿½AL DELANTERO BMW F30 / N20 FREY,1497,3,1,8,12
31521428678 *3,RETEN CIGUEï¿½AL DELANTERO 44X69X10/15 MM BMW E46 E90-E92 F30-F36 G11-G15 (CORTECO),1732,6,2,9,17
31532828,SENSOR DE CIGUEï¿½AL MERCEDES W203 / M111 ( GENERICO ),1534,4,6,6,16
31603450566,FLECHA EXTERIOR DERECHA BMW E83-N52,1658,8,4,3,15
31603450566-5,FLECHA EXTERIOR DERECHA BMW E83-N52 FREY,1933,9,6,1,16
31607507402,CUBRE POLVO DE JUNTA HOMOSINETICA DELANTERA EXTERIOR BMW E46-M54 BMTR,1386,9,1,0,10
31607507402-1,CUBRE POLVO DE JUNTA HOMOSINETICA DELANTERA EXTERIOR BMW E46-M54 GKN,1409,3,0,6,9
31607507402-2,CUBRE POLVO DE JUNTA HOMOSINETICA DELANTERA EXTERIOR BMW E46-M54 FREY,1346,9,6,4,19
31607518258,CUBRE POLVO DE FLECHA DELANTERA INTERIOR (R) MINI R53 EMPI,1677,9,7,5,21
31607529203,CUBRE POLVO BMW E83 EMPI,1549,5,6,4,15
31607529203 *1,CUBRE POLVO EXTERIOR FLECHA DELANTERA 122X84X9.5 MM  (L/R) BMW E83 (FREY),1729,1,2,6,9
31607529204,CUBRE POLVO DE FLECHA DELANTERA INTERIOR BMW E83-N46 EMPI,1675,3,1,6,10
31607529204-1,CUBRE POLVO DE FLECHA DELANTERA INTERIOR BMW E83-N46 LEMFOLDER,1879,2,9,4,15
31607529204-2,CUBRE POLVO DE FLECHA DELANTERA INTERIOR BMW E83-N46 FREY,1343,2,1,7,10
31607545107,CUBREPOLVO DE FLECHA DELANTERA L-R BMW E70 MEISTERSATZ,1401,0,7,1,8
31607545107 *1,CUBRE POLVO FLECHA DELANTERA 107X28 MM (L/R) BMW E70 E71 (FREY),1954,9,1,3,13
31607545125,FLECHA DELANTERA IZQUIERDA BMW E70 / N52N ( BMTR ),1946,0,2,5,7
31607545125 *1,FLECHA DELANTERA IZQUIERDA BMW E70 / N52N (FREY),1753,0,3,5,8
31607545126 *1,FLECHA HOMOCINETICA DELANTERA 1055MM (R) BMW E70-E72 F15 F16 F85 F86 (FREY),1313,0,5,3,8
31607565313,FLECHA DELANTERA IZQUIERDA BMW E53 / M62 ( BMTR ),1291,9,1,9,19
31607565313 *1,FLECHA DELANTERA IZQUIERDA BMW E53-M62 FREY,1971,6,5,6,17
31607565314 *1,FLECHA DELANTERA DERECHA BMW E53-M62 FREY,1755,1,7,2,10
31607565315,CUBRE POLVO DE FLECHA DELANTERA INTERIOR BMW E53 EMPI,1988,4,6,6,16
31607565315 *1,CUBRE POLVO FLECHA DELANTERA INTERNA 130X70X28 MM (L/R) BMW E53 (FREY),1546,6,7,9,22
31607565316,CUBRE POLVO DE FLECHA DELANTERA EXTERIOR BMW MOTOR M54-M62-N62 EMPI,1766,6,0,9,15
31607565316 *1,CUBRE POLVO DE FLECHA DELANTERA EXTERIOR BMW MOTOR M54-M62-N62 FREY,1785,0,9,2,11
31607570270 *1,CUBRE POLVO EXTRIOR LADO RUEDA BMW E84 F20 F22 F30  (FREY),1254,9,0,6,15
31607574868,FLECHA DELANTERA DERECHA ( COMPLETA ) MINI R50,1325,2,2,3,7
31607574868-5,FLECHA DELANTERA DERECHA ( COMPLETA ) MINI R50 ( DSS ),1636,2,1,8,11
31607574871,FLECHA DELANTERA IZQUIERDA ( COMPLETA ) MINI R50 ( DSS ),1259,0,0,1,1
31607605512 *1,FLECHA HOMOCINETICA DELANTERA 876MM (R) BMW E84 (FREY),1827,9,7,2,18
31607618680 *1,FLECHA HOMOCINETICA DELANTERA 901MM (R) F06 F10 F11 F12 F13 (FREY),1875,1,3,9,13
31607618681 *1,FLECHA HOMOCINETICA DELANTERA (L) 606MM BMW F06 F10-F13 (FREY),1295,0,8,0,8
31607620599 *1,CUBRE POLVO DE FLECHA DELANTERA INTERIOR BMW F25 F26 (FREY),1702,1,0,8,9
31608605469 *1,EJE TRANSMISION DELANTERO (L) MINI R56 R55 R57 R58 (FREY),1680,9,2,6,17
31608611928 *1,ARBOL DE TRANSMISION DELANTERO 884MM MINI F55 F56 F57 (FREY),1786,2,4,6,12
31608611932 *1,FLECHA JUNTA HOMOSINETICA DELANTERA (R) MINI B38 (FREY),1537,5,5,6,16
31608643381 *1,Eje Delantero Izquierdo Lado del conductor para 15-19 Mini Cooper FREY,1424,6,4,1,11
31608643383 *1,FLECHA HOMOCINETICA DELANTERA (L) BMW F45 F46 F48 MINI F54 F60 (FREY),1243,4,0,8,12
31608680337 *2,FLECHA HOMOCINETICA DELANTERA 574 MM (L) BMW F97 F98 G01 G02 (EMBLER),1979,4,1,2,7
31608680338 *2,FLECHA HOMOCINETICA DELANTERA 939 MM (R) BMW F97 F98 G01 G02 (EMBLER),1819,2,2,0,4
31608681530 *1,EJE TRANSMISION DELANTERO (R) BMW F48 F39 MINI F54 F60 (FREY),1796,2,0,3,5
31658608,ENLACE ESTABILIZADOR FEBI,1420,1,9,7,17
31926783913,BALERO DOBLE DELANTERO BMW E60,1769,7,0,1,8
31926783913-100,BALERO DOBLE DELANTERO BMW E60 FREY INACTIVO,1319,2,7,3,12
32103444366,DIRECCION HIDRAULICA BMW E83 (SEMINUEVA A CAMBIO),1288,5,1,3,9
32103444366-1,DIRECCION HIDRAULICA BMW E83 (SEMINUEVA A CAMBIO) FREY,1324,0,5,1,6
32103444999 *1,BIELETA DIRECCION CON TERMINAL SUSPENSION DELANTERA (L/R) BMW E83 (FREY),1518,9,7,8,24
32106763342,DIRECCION HIDRAULICA BMW E53 (SEMINUEVA A CAMBIO),1783,0,2,6,8
32106763342-1,DIRECCION HIDRAULICA BMW E53 (SEMINUEVA A CAMBIO) FREY,1517,1,6,1,8
32106765013 *1,CAJA DIRECCION HIDRAULICA CREMALLERA BMW E81 E90 E84 (FREY),1598,2,0,2,4
32106765234,CUBRE POLVO DE DIRECCION HIDRAULICA BMW E90 M3-S65 LEMFOERDER,1800,8,3,3,14
32106765234-1,CUBRE POLVO DE DIRECCION HIDRAULICA BMW E90 M3-S65 SIDEM 305130,1409,0,3,5,8
32106774347,BIELETA DIRECCION CON TERMINAL SUSPENSION DELANTERA (L/R) BMW E60-M54 (FREY) R,1417,9,0,2,11
32106777463,DIRECCION HIDRAULICA NORMAL BMW E81,1952,3,0,5,8
32106777463-1,DIRECCION HIDRAULICA NORMAL BMW E81 FREY,1586,5,5,1,11
32106777469,DIRECCION HIDRAULICA ACTIVA ELECTRONICA BMW E81,1513,3,6,1,10
32106777469-1,DIRECCION HIDRAULICA ACTIVA ELECTRONICA BMW E81 FREY,1320,5,6,9,20
32106777479,BIELETA DIRECCION CON TERMINAL SUSPENSION DELANTERA (L/R) BMW E60-M54 (BMTR),1417,3,0,3,6
32106777504,BIELETA DIRECCION CON TERMINAL SUSPENSION DELANTERA (L) BMW E46-M54 (FREY),1988,4,6,5,15
32106777522,BIELETA DIRECCION CON TERMINAL SUSPENSION DELANTERA (R) MINI R50-R52-R53 (KARLYN),1432,4,5,5,14
3210677754-100,BIELETA DE DIRECCION CON TERMINAL R BMW E46 INACTIVO,1753,4,4,5,13
32106778547,BIELETA DIRECCION CON TERMINAL SUSPENSION DELANTERA (L) MINI R56 (FEBI),1448,4,3,2,9
32106778547 *1,BIELETA DIRECCION CON TERMINAL SUSPENSION DELANTERA (L) MINI R56 (FREY),1379,6,9,5,20
32106778547-1,BIELETA DIRECCION CON TERMINAL SUSPENSION DELANTERA (L) MINI R56 (DELPHI),1456,3,4,4,11
32106778548,BIELETA DIRECCION CON TERMINAL SUSPENSION DELANTERA (R) MINI R56 (FEBI),1635,1,9,1,11
32106778548 *1,BIELETA DIRECCION CON TERMINAL SUSPENSION DELANTERA (R) MINI R56 (FREY),1579,9,4,4,17
32106778548-1,BIELETA DIRECCION CON TERMINAL SUSPENSION DELANTERA (R) MINI R56 (TOPRAN),1858,8,5,7,20
32106780985 *5,BIELETA DIRECCION CON TERMINAL SUSPENSION DELANTERA (L/R) BMW E70 E71 E72 (DELPHI) SSF,1573,3,4,7,14
32106783548,DIRECCION ELECTRICO MECANICA MINI R56 / N14 ( ORIGINAL),1998,2,8,6,16
32106784716 *1,BIELETA DIRECCION  CON TERMINAL SUSPENSION DELANTERA (L) BMW F01 F02 F04 F06 F07 F10-F13 (FREY),1489,6,4,3,13
32106784719 *1,BIELETA DIRECCION  CON TERMINAL SUSPENSION DELANTERA (R) BMW F01 F02 F04 F06 F07 F10-F13 (FREY),1923,8,0,1,9
32106787472,BIELETA DIRECCION CON TERMINAL SUSPENSION DELANTERA (L/R) F25 F26 X3 X4 (TOPRAN),1724,3,9,6,18
321067934-100,BIELETA DE DIRECCION DELANTERA L-R BMW E70-N52 INACTIVO,1488,8,2,9,19
32106793496 *1,BIELETA DIRECCION CON TERMINAL SUSPENSION DELANTERA (L/R) BMW E70 E71 E72 (FREY),1544,2,0,8,10
32106793496-100,BIELETA DE DIRECCION DELANTERA L-R BMW E70 ( FREY ) INACTIVO,1995,2,6,5,13
32106793497,TERMINAL DIRECCION SIN BIELETA SUSPENSION DELANTERA (L/R) BMW E70 / N52 (DELPHI),1670,3,0,1,4
32106793497-1,TERMINAL DIRECCION SIN BIELETA SUSPENSION DELANTERA (L/R) BMW E70 / N52 (FREY),1257,6,8,7,21
32106799960 *1,BIELETA DIRECCION CON TERMINAL SUSPENSION DELANTERA (L) BMW F20 F30 F32 (FREY),1631,8,4,9,21
32106799960-2,BIELETA DIRECCION CON TERMINAL SUSPENSION DELANTERA (L) BMW F30 (BMWQ),1412,0,3,2,5
32106799965 *1,BIELETA DIRECCION CON TERMINAL SUSPENSION DELANTERA (R) BMW F20 F30 F32 (FREY),1719,6,0,2,8
32106854733 *1,BIELETA DIRECCION CON TERMINAL SUSPENSION DELANTERA (L) MINI F55 F56 F57 (FREY),1852,6,1,8,15
32106854736 *1,BIELETA DIRECCION  CON TERMINAL SUSPENSION DELANTERA (R) MINI F55 F56 F57 (FREY),1643,9,2,0,11
32106856876,BOMBA DE DIRECCIï¿½N ELECTRICA MINI R56-N14 ORIGINAL,1734,5,7,3,15
32106865426 *1,CUBRE POLVO DIRECCION HIDRAULICA BMW E87 E90 (FREY),1597,5,1,7,13
32106865426 *9,CUBRE POLVO DIRECCION HIDRAULICA BMW E87 E90 (BMTR),1516,6,4,3,13
32106867404 *1,BIELETA DIRECCION  CON TERMINAL SUSPENSION DELANTERA (L) BMW F39 F40 F46-F48 MINI F54 F60 (FREY),1626,5,9,2,16
32106867405 *1,BIELETA DIRECCION  CON TERMINAL SUSPENSION DELANTERA (R) BMW F39 F40 F46-F48 MINI F54 F60 (FREY),1479,4,5,6,15
32106868688 *1,BIELETA DIRECCION CON TERMINAL SUSPENSION DELANTERA (L) BMW G11-G16 G30 G31 G32 (FREY),1623,0,2,9,11
32106868689 *1,BIELETA DIRECCION CON TERMINAL SUSPENSION DELANTERA (R) BMW G11-G16 G30 G31 G32 (FREY),1450,7,8,6,21
32106871884 *1 ,BIELETA DIRECCION CON TERMINAL SUSPENSION DELANTERA (L) BMW G01 G02 G21 (FREY),1702,7,6,4,17
32106871892 *1,BIELETA DIRECCION CON TERMINAL SUSPENSION DELANTERA (R) BMW G01 G02 G30 (FREY),1282,3,8,0,11
32106872482,DIRECCION ELECTRONICA SEMINUEVA BMW E90 ( GENUINA ),1818,8,9,6,23
32106872482-1,DIRECCION ELECTRONICA SEMINUEVA BMW E90 FREY,1383,4,3,2,9
32106883539 *1,CREMALLERA DE DIRECCION BMW F01 F02 F06 F07 F10-F13 (FREY),1423,5,1,1,7
32106884809 *3,BIELETA DIRECCION CON TERMINAL SUSPENSION DELANTERA (L/R) BMW G05 G06 G07 (SIDEM),1576,8,5,8,21
32111094673 *1,BIELETA DIRECCION CON TERMINAL SUSPENSION DELANTERA (L) BMW E39 (FREY),1202,4,8,3,15
32111094674,BIELETA DIRECCION CON TERMINAL SUSPENSION DELANTERA (R) BMW E39 (BMTR),1726,4,4,2,10
32111094674 *1,BIELETA DIRECCION CON TERMINAL SUSPENSION DELANTERA (R) BMW E39 (FREY),1291,2,6,6,14
32111096897 *1,BIELETA DIRECCION CON TERMINAL SUSPENSION DELANTERA (L) BMW E46 E85 E86 (FREY),1480,8,9,4,21
32111096898 *1,BIELETA DIRECCION CON TERMINAL SUSPENSION DELANTERA (R) BMW E46 E85 (FREY),1455,4,7,5,16
32111139313,TERMINAL DIRECCION SIN BIELETA SUSPENSION DELANTERA (L) BMW E36 TM (BMTR),1257,4,9,0,13
32111139313-1,TERMINAL DIRECCION SIN BIELETA SUSPENSION DELANTERA (L) BMW E36 TM (FREY),1307,5,6,0,11
32111139315,BIELETA DIRECCION CON TERMINAL SUSPENSION DELANTERA (L) BMW E36-M52 (BMTR),1575,5,2,9,16
32111139315-1,BIELETA DIRECCION CON TERMINAL SUSPENSION DELANTERA (L) BMW E36-M52 (FREY),1922,3,9,2,14
32111139316,BIELETA DIRECCION CON TERMINAL SUSPENSION DELANTERA (R) BMW E36-M52 (BMTR),1631,7,0,5,12
32111139316-1,BIELETA DIRECCION CON TERMINAL SUSPENSION DELANTERA (R) BMW E36-M52 (FREY),1591,2,9,9,20
32116777521,BIELETA DIRECCION CON TERMINAL SUSPENSION DELANTERA (L) MINI R50-R52-R53 (KARLYN),1487,5,0,2,7
32131096145,DIRECCION HIDRAULICA SI SERVOTRONIC BMW E39,1800,8,9,8,25
32131096145-1,DIRECCION HIDRAULICA SI SERVOTRONIC BMW E39 FREY,1767,5,9,5,19
32131096280,DIRECCION HIDRAULICA BMW E36 SEMINUEVA A CAMBIO ( EMBLER ),1778,2,1,7,10
32131096280-1,DIRECCION HIDRAULICA BMW E36 FREY,1578,0,5,9,14
32131096283 *1,CAJA DE DIRECCION HIDRAULICA CREMALLERA BMW E46 (FREY),1863,6,3,6,15
32131096910,CUBRE POLVO DE DIRECCION HIDRAULICA BMW E46 BMTR,1730,5,9,5,19
32131096910 *1,CUBRE POLVO DE DIRECCION HIDRAULICA BMW E46 FREY,1441,7,3,4,14
32131096910-1,CUBRE POLVO DE DIRECCION HIDRAULICA BMW E46 OPTIMAL,1560,9,4,3,16
32131096910-3,CUBRE POLVO DE DIRECCION HIDRAULICA BMW E46 (EMBLER),1569,3,4,9,16
32136751026,CUBRE POLVO DE DIRECCION BMW E53 LEMFOLDER,1961,7,0,6,13
32136751026 *1,CUBRE POLVO DIRECCION HIDRAULICA (L/R) BMW E53 E60 E65 E83 (FREY),1633,6,1,0,7
32136751745,DIRECCION HIDRAULICA NO SERVOTRONIC BMW E39 ( EMBLER ),1662,5,9,9,23
32136751745-1,DIRECCION HIDRAULICA NO SERVOTRONIC BMW E39  FREY,1472,8,9,5,22
32136755065,CAJA DE DIRECCION HIDRAULICA BMW E46,1661,4,4,2,10
32136755065-1,CAJA DE DIRECCION HIDRAULICA BMW E46 FREY,1232,5,8,7,20
32136756757,CUBRE POLVO DE DIRECCION MINI R50-R53 VAICO,1729,6,8,6,20
32136769267 *1,CAJA DE DIRECCION ASISTIDA BME E53 FREY,1447,4,1,1,6
32140029 *5,FILTRO ACEITE MOTOR VOLVO S60 S80 S90 V60 V60XC V90 V90XC XC40 XC60 XC70 XC90 (MAHLE) SSF,1639,6,0,2,8
32211091723,TERMINAL DIRECCION SIN BIELETA SUSPENSION DELANTERA (L) BMW E39 540i (VAICO),1215,2,2,2,6
32211091723-1,TERMINAL DIRECCION SIN BIELETA SUSPENSION DELANTERA (L) BMW E39 540i (FREY),1428,0,3,0,3
32211096059 *1,BARRA CENTRAL DIRECCION HIDRAULICA CON BIELETAS BMW 540i E39 (FREY),1959,5,2,6,13
32211096059 *5,BARRA CENTRAL DIRECCION HIDRAULICA CON BIELETAS BMW 540i E39 (FEBI) SSF,1680,8,4,9,21
32216751277 *1,BIELETA DIRECCION CON TERMINAL SUSPENSION DELANTERA (L/R) BMW E53 (FREY),1483,5,4,6,15
32216751277-100,BIELETA DIRECCION CON TERMINAL SUSPENSION DELANTERA (L/R) BMW E53-N62 (INACTIVO),1550,0,7,0,7
32216762243 *1,BIELETA DIRECCION CON TERMINAL SUSPENSION DELANTERA (L) BMW E84  E87 E90 (FREY),1391,9,7,0,16
32216762244,BIELETA DIRECCIï¿½N CON TERMINAL SUSPENSION DELANTERA (R) BMW E90 (BMTR),1532,3,8,4,15
32216762244 *1,BIELETA DIRECCION CON TERMINAL SUSPENSION DELANTERA (R) BMW E84 E87 E90 (FREY),1299,2,8,8,18
32216762244 *2,BIELETA DIRECCIï¿½N CON TERMINAL SUSPENSION DELANTERA (R) BMW E90 (FRAP),1795,0,6,3,9
32216762403 *1,BIELETA DIRECCION CON TERMINAL SUSPENSION DELANTERA (L/R) BMW E60-M54 (FREY),1818,7,6,9,22
32242189 *3,"FILTRO COMBUSTIBLE GASOLINA VOLVO S60, S80, V70, XC90 (MAHLE KL257)",1464,2,0,9,11
32242190 *3,FILTRO COMBUSTIBLE GASOLINA VOLVO S80 (MAHLE KL705),1998,1,5,3,9
32249280 *5,MANGUERA SUPERIOR RADIADOR ENFRIAMIENTO MOTOR VOLVO S60 S80 V70 XC60 XC70 (REIN) SSF,1580,2,0,8,10
32301094703 *5,ACOPLAMIENTO DE DIRECCION GENUINO BMW,1716,4,8,5,17
32306777040,PLACA DE APOYO  DIRECCION CENTRAL E70 GENUINO,1382,4,1,3,8
32306786254,ARBOL DE DIRECCION BMW E70 / E71 / N63 ( GENUINA ),1680,6,7,5,18
32306786254-1,ARBOL DE DIRECCION BMW E70 / E71 / N63 FREY,1347,5,9,9,23
32306786899,MODULO DE COLUMNA BMW E90,1648,6,0,3,9
32306786899-1,MODULO DE COLUMNA BMW E90 FREY,1735,9,2,8,19
32306793632 *1,SENSOR ANGULO GIRO DIRECCION  BMW E46 E53 E83 (FREY),1667,1,7,7,15
32306793632 *5,SENSOR ANGULO GIRO DIRECCION  BMW E46 E53 E83 (JL) SSF,1907,0,7,0,7
32339856 *5,1 GALON CON 3.785  LITROS ANTICONGELANTE CONSENTRADO (GENUINO VOLVO) SSF,1317,1,6,7,14
32411094098 *1,BOMBA DIRECCION HIDRAULICA TAPA PLANA BMW E39 E46 E83 M52 M54 (FREY),1933,0,8,4,12
32411095526,MANGUERA DE DEPOSITO DE ACEITE A BOMBA DE DIRECCIï¿½N BMW E46-M54 FEBI,1965,4,8,8,20
32411095526 *1,MANGUERA DEPOSITO ACEITE A BOMBA DIRECCIï¿½N BMW E46 M54 (FREY),1619,7,6,5,18
32411095526-2,MANGUERA DE DEPOSITO DE ACEITE A BOMBA DE DIRECCIï¿½N BMW E46-M54 OSSCA,1592,2,1,9,12
32411095526-3,MANGUERA DE DEPOSITO DE ACEITE A BOMBA DE DIRECCIï¿½N BMW E46-M54 TOPRAN,1302,4,6,9,19
32411097164 *1,DEPOSITO ACEITE DIRECCION HIDRAULICA BMW E46 M54 (FREY),1404,6,3,5,14
32412227197,BOMBA DE DIRECCION HIDRAULICA BMW E36-Z3-ZF GENERICA,1870,4,8,0,12
32412227197-1,BOMBA DE DIRECCION HIDRAULICA BMW E36-Z3-ZF FREY,1730,4,6,6,16
32413450590,BOMBA DE DIRECCION HIDRAULICA BMW F25,1764,4,8,3,15
32413450590 *2,BOMBA DE DIRECCION HIDRAULICA BMW F25 (EMBLER),1621,5,4,3,12
32413450590-1,BOMBA DE DIRECCION HIDRAULICA BMW F25 FREY,1525,0,2,2,4
32414042171 *2,BOMBA DIRECCION HIDRAULICA TRIANGULAR SIN SENSOR BMW E81 E84 E90 N52N (EMBLER),1246,3,1,1,5
32416-100,BOMBA DIRECCION HIDRAULICA SIN SENSOR BMW 32416 INACTIVO,1356,5,5,5,15
32416756582-100,BOMBA DE DIRECCION HIDRAULICA LICUADORA ZF BMW E46 M54 (EMBLER) INACTIVO,1440,0,3,9,12
32416757914 *1,BOMBA DIRECCION HIDRAULICA BMW E38 E39 E60 E53 M54 (FREY),1550,6,1,4,11
32416759773 *1,MANGUERA PRESION DIRECCION HIDRAULICA BMW E53 M62 (FREY),1212,7,8,6,21
32416760034 *1,BOMBA DIRECCION HIDRAULICA TAPA REDONDA BMW E46 M54 (FREY),1477,8,9,8,25
32416763976,MANGUERA DE DIRECCION DE ALTA PRESION BMW E53-N62,1494,6,4,9,19
32416763976-1,MANGUERA DE DIRECCION DE ALTA PRESION BMW E53-N62 FREY,1321,6,5,3,14
32416766702 *1,BOMBA DIRECCION HIDRAULICA BMW E53 M62 4.4L 4.6L N62 4.4L 4.8L (FREY),1529,1,9,8,18
32416767137,MANGUERA DE RETORNO DE DIRECCION BMW E53-M62 REIN,1435,6,8,1,15
32416767137-1,MANGUERA DE RETORNO DE DIRECCION BMW E53-M62 FREY,1474,8,1,8,17
32416768094 *2,DEPOSITO COMPESACION DE DIRECCION ASISTIDA BMW E90 SEMINUEVA (ORIGINAL),1697,3,4,4,11
32416768094-100,DEPOSITO ACEITE DIRECCION BMW E83 E84  E87 E90 INACTIVO,1248,3,0,6,9
32416769887 *1,BOMBA DIRECCION HIDRAULICA SIN SENSOR BMW E84 E81 E90 N52N (FREY),1475,3,2,0,5
32416774215,MANGUERA DE DIRECCION DE ALTA PRESION BMW E46-M54 REIN,1312,2,7,6,15
32416774215 *1,MANGUERA DIRECCION HIDRAULICA ALTA PRESION BMW E46 M54 320i (FREY),1988,0,2,1,3
32416774215-1,MANGUERA DE DIRECCION DE ALTA PRESION BMW E46-M54 VAICO,1574,2,7,5,14
32416776882,MANGUERA DE RETORNO DE DIRECCION BMW E90-N54 REIN,1933,2,1,6,9
32416776882-1,MANGUERA DE RETORNO DE DIRECCION BMW E90-N54 FREY,1326,5,6,4,15
32416778425,ELECTROBOMBA DE DIRECCION SEMINUEVA MINI R50 / R52 / R53 ( GENUINA ),1589,1,7,3,11
32416779245 *1,BOMBA DIRECCION HIDRAULICA CON SENSOR LICUADORA BMW E88 E90 N54 (FREY),1365,9,5,4,18
32416780413 *1,BOMBA DIRECCION HIDRAULICA BMW E87 N46 N46N (FREY),1589,9,5,2,16
32416780413 *2,BOMBA DIRECCION HIDRAULICA BMW E87 N46 N46N (EMBLER),1381,2,7,5,14
32416781458,MANGUERA RETORNO DIRECCION ASISTIDA BMW E90 SEMINUEVA (ORIGINAL),1837,0,8,4,12
32416781744 *5,MANGUERA BAJA PRESION ALIMENTACION ACEITE DIRECCION MINI R50 R52 R53 (REIN) SSF,1638,1,9,3,13
32416796367,MANGUERA DE RETORNO DE DIRECCION BMW E46-M54 GENUINA,1366,0,6,5,11
32416796367-1,MANGUERA DE RETORNO DE DIRECCION BMW E46-M54 FREY,1872,3,4,5,12
32416796390,MANGUERA DE BOMBA DE DIRECCION BMW E46-M54 REIN,1710,1,2,2,5
32416796390-1,MANGUERA DE BOMBA DE DIRECCION BMW E46-M54  ( REIN ),1847,7,1,9,17
32416796452-1,BOMBA DE DIRECCION HIDRAULICA BMW E70 FREY,1223,2,9,2,13
32416851217,DEPOSITO DE ACEITE DE DIRECCION BMW E46-M54BMTR,1446,8,8,7,23
32416851217-2,DEPOSITO DE ACEITE DE DIRECCION BMW E46-M54 MEISTERSATZ,1965,2,8,9,19
32416851217-3,DEPOSITO DE ACEITE DE DIRECCION BMW E46 M54 REIN,1780,0,5,7,12
32416851217-4,DEPOSITO DE ACEITE DE DIRECCION BMW E46-M54 DORMAN,1529,4,2,4,10
32416851218 *1,DEPOSITO DIRECCION HIDRAULICA BMW E83 E84 E87 E90 (FREY),1746,6,5,2,13
32416857718 *5,VENTILADOR BOMBA DIRECCION HIDRAULICA MINI R50 R53 R53 (REIN) SSF,1644,7,3,5,15
32418 *5,BUJE HORQUILLA SUSPENSION DELANTERA (L/R) VOLVO C30 C70 S40 V50 (FEBI) SSF,1907,5,4,8,17
32421740858 *1,POLEA DIRECCION HIDRAULICA 135MM BMW M52 M54 (FREY),1282,3,2,2,7
32421740858 *5,POLEA DIRECCION HIDRAULICA 135 MM BMW M52 M54 (FEBI) SSF,1415,1,3,0,4
32427500335 *1,POLEA DIRECCION HIDRAULICA 135 MM BMW E87 N46 N46N (FREY),1324,8,5,6,19
32427500335-1,POLEA DE DIRECCION HIDRAULICA 131 MM BMW E87 N46N ( ORIGINAL),1223,6,1,0,7
32427516848 *1,POLEA DIRECCION HIDRAULICA 116 MM BMW E60 E65 E83 M54 (FREY),1794,0,8,8,16
32427537862,POLEA DE DIRECCION HIDRAULICA 6 CANALES BMW N52 N52N ( GENUINA ),1429,5,4,0,9
32427537862 *1,POLEA DE DIRECCION HIDRAULICA 6 CANALES BMW N52 N52N (FREY),1489,8,5,9,22
32427537862 *5,POLEA DE DIRECCION HIDRAULICA 6 CANALES BMW N52 N52N (URO) SSF,1659,0,1,6,7
32427553955,POLEA DE DIRECCION HIDRAULICA 7 CANALES BMW N54 N55 ( GENUINA ),1931,9,0,6,15
32427553955 *1,POLEA DE DIRECCION HIDRAULICA 7 CANALES BMW N54 N55 ( FREY ),1392,6,2,9,17
32427553955-1,POLEA DE DIRECCION HIDRAULICA 7 CANALES BMW N54 N55 ( VAICO ),1254,0,4,3,7
32427553955-4,POLEA DE DIRECCION HIDRAULICA 7 CANALES BMW N54 N55 (URO),1275,1,3,5,9
32665 *5,SOPORTE MOTOR SUPERIOR (R ) LAND ROVER LR2 2008 A 2012 (FEBI) SSF,1838,1,3,0,4
33107505601,RETEN DE DIFERENCIAL DELANTERO BMW E53 FREY,1996,1,5,3,9
33107505601-9,RETEN DE DIFERENCIAL DELANTERO BMW E53 CORTECO,1394,9,6,7,22
33107505603,RETEN DE DIFERENCIAL TRASERO BMW E46-M54 CORTECO,1307,6,7,1,14
33107505603-1,RETEN DE DIFERENCIAL TRASERO BMW E46-M54 FREY,1298,2,3,1,6
33107510658,DIFERENCIAL TRASERO BMW X5-E53  GENUINO,1966,3,6,1,10
33127621206,RETEN DE DIFERENCIAL TRASERO BMW E46-M54 FEBI,1683,3,6,8,17
33127621206-1,RETEN DE DIFERENCIAL TRASERO BMW E46-M54 (FREY),1392,0,3,5,8
33171090950 *5,BUJE DIFERENCIAL TRASERO BMW E36 Z3 E36 (URO PARTS) SSF,1547,4,8,0,12
33176751808 *5,BUJE PUENTE SUSPENSION TRASERA 68X60 MM BMW E46 E83 E84 (FEBI) SSF,1721,3,8,5,16
33176751808-1,BUJE DE DIFERENCIAL TRASERO BMW E46-M52 FREY,1677,8,4,2,14
33176770788 *5,BUJE CENTRAL PUENTE SUSPENSION TRASERA BMW E46 E83 E85 E86 (FEBI) SSF,1374,9,9,6,24
33208609838,ARBOL DE TRANSMISION FREY,1532,8,3,5,16
33211229205,CUBRE POLVO FLECHA TRASERA  INTERIOR BMW E53-M54,1635,0,2,7,9
33211229205-1,CUBRE POLVO FLECHA TRASERA  INTERIOR BMW E53-M54  FREY,1780,3,5,9,17
33211229213,CUBRE POLVO FLECHA TRASERA  EXTERIOR BMW E53-M54,1286,9,5,9,23
33211229213-1,CUBRE POLVO FLECHA TRASERA  EXTERIOR BMW E53-M54 FREY,1669,4,2,8,14
33211229428,FLECHA TRASERA L-R 27 DIENTES 67 CM BMW E36 LUZAN,1559,6,2,4,12
33211229428-1,FLECHA TRASERA L-R 27 DIENTES 67 CM BMW E36 FREY,1348,1,3,1,5
33217547073 *1,FLECHA HOMOCINETICA TRASERA (L) BMW E82 E87 E88 E90 E92 (FREY),1389,8,5,2,15
33306772241 *1,BRAZO RECTO SUSPENSION TRASERA (L) BMW E60 E61 E63 E64 E65 E66 (FREY),1221,8,8,0,16
33306772242 *1,BRAZO RECTO SUSPENSION TRASERA (R) BMW E60 E61 E63 E64 E65 E66 (FREY),1542,8,2,1,11
33316758259 *1,BUJE PUENTE SUSPENSION TRASERA BMW E87 E90 (FREY),1828,5,9,6,20
33316770781 *1,BUJE PUENTE SUSPENSION TRASERA 72 X 63 MM (L/R) BMW E46 E83 E84 (FREY),1393,5,8,2,15
33316770781 *5,BUJE PUENTE SUSPENSION TRASERA 72 X 63 MM (L/R) BMW E46 E83 E84 (FEBI) SSF,1710,6,1,4,11
33316770784 *5,BUJE PUENTE SUSPENSION TRASERA (R) 66X70 MM BMW E46 E83 (FEBI) SSF,1718,3,3,8,14
33321090905 *1,BRAZO CURVO SUSPENSION SUPERIOR TRASERO (L) BMW E38 E52 (FREY),1925,0,1,4,5
33321095411 *1,BRAZO CURVO SUPERIOR SUSPENSION TRASERA (L) BMW E53 (FREY),1230,1,4,2,7
33321095412 *1,BRAZO CURVO SUPERIOR SUSPENSION TRASERA (R) BMW E53 (FREY),1471,1,5,4,10
33321095414 *1,BRAZO RECTO SUPERIOR SUSPENSION TRASERA (L/R) BMW E53 (FREY),1281,2,2,5,9
33321097009 *1,BUJE HORQUILLA MANGO SUSPENSION TRASERA (L/R) BMW E36 E46 E83 (FREY),1432,3,4,7,14
33322406292 *3,BRAZO RECTO DE SUSPENSION TRASERA (L/R) BMW E81 E82 E87 E88 E0 E91 E92 E93 (EMASA),1573,4,1,2,7
33326763092 *1,BUJE TIRANTE HORQUILLA SUSPENSION TRASERA (L/R) 46 X 48 X12 MM BMW E81 E89 E90 (FREY),1496,9,1,5,15
33326767748,ROTULA DE SUSPENSION TRASERA L-R  BMW E53 BMTR,1761,8,0,6,14
33326767748-1,ROTULA DE SUSPENSION TRASERA L-R  BMW E53 FREY,1906,7,9,1,17
33326768791 *3,BRAZO SUPERIOR RECTO SUSPENSION TRASERA (L/R) BMW E38 E39 (DELPHI),1755,5,9,1,15
333267707-100,BUJE DE MANGO TRASERO BMW INACTIVO,1659,6,0,7,13
33326770743,BUJE DE HORQUILLA TRASERA BMW E53-M54 LEMFORDER SET 2,1705,6,3,0,9
33326770743-1,BUJE DE HORQUILLA TRASERA BMW E53-M54 FREY,1380,8,7,9,24
33326770749 *9,BUJE DE SUSPENSION TRASERA BMW M54 (BMTR),1323,0,6,4,10
33326770786 *5,BUJE HORQUILLA MANGO SUSPENSION TRASERA (L/R) BMW E36 E46 E83 (FEBI) SSF,1662,9,4,1,14
33326770813,BRAZO TRANSVERSAL TRASERO INFERIOR L-R BMW E46 DELPHI,1784,4,2,9,15
33326770813-1,BRAZO TRANSVERSAL TRASERO INFERIOR L-R BMW E46 FREY,1865,0,8,6,14
33326770824,BUJE DE BRAZO RECTO DE SUSPENSION TRASERO BMW E46 FEQ,1950,3,9,5,17
33326770824-1,BUJE DE BRAZO RECTO DE SUSPENSION TRASERO BMW E46 FREY,1797,1,3,2,6
33326770859,BRAZO SUPERIOR DE SUSPENSION TRASERA ( L ) BMW E53-M54 BMTR,1743,8,8,2,18
33326770859 *5,BRAZO SUPERIOR DE SUSPENSION TRASERA ( L ) BMW E53-M54 (LEMFORDER) SSF,1255,7,8,5,20
33326770859 *6,BRAZO SUPERIOR DE SUSPENSION TRASERA ( L ) BMW E53-M54 (KARLYN) SSF,1406,5,4,0,9
33326770860,BRAZO CURVO DE SUSPENSION TRASERA ( R ) BMW E53-M62 BMTR,1756,1,9,9,19
33326770860-2,BRAZO CURVO DE SUSPENSION TRASERA ( R ) BMW E53-M62 LEMFORDER,1222,0,2,9,11
33326770969 *1,BRAZO RECTO SUSPENSION TRASERA (L) BMW E70 E71 E72 F15 F16 F85 F86 (FREY),1615,0,9,8,17
33326770969-100,BRAZO RECTO DE SUSPENSION TRASERA L BMW E70 INACTIVO,1870,8,1,1,10
33326770970,BRAZO RECTO DE SUSPENSION TRASERA R BMW E70 BMTR,1303,2,8,5,15
33326770970 *1,BRAZO RECTO SUSPENSION TRASERA (R) BMW E70 E71 E72 F15 F16 F85 F86 (FREY),1690,0,6,7,13
33326772899,HORQUILLA DE SUSPENSION TRASERA L BMW E90 BMTR,1594,5,6,5,16
33326772899-1,HORQUILLA DE SUSPENSION TRASERA L BMW E90 FREY,1905,2,8,6,16
33326774796,BRAZO RECTO DE SUSPENSION TRASERA L-R BMW E53 BMTR,1924,2,4,1,7
33326775083 *1,BRAZO RECTO SUSPENSION TRASERA SUPERIOR DELANTERO (L) BMW E39 E60 E63 E65 (FREY),1639,5,0,3,8
33326775084 *1,BRAZO RECTO SUSPENSION TRASERA SUPERIOR DELANTERO (L/R) BMW E39 E60 E63 E65 (FREY),1306,0,0,5,5
33326775551 *2,BUJE DE BRAZO SUSPENSION TRASERA (L/R) BMW E36 E46 E85 E86 E89 (URO),1763,6,5,5,16
33326775551 *3,BUJE SUSPENSION BMW E36 (BMTR),1788,4,2,0,6
33326775902 *1,BRAZO SUSPENSION TRASERA SUPERIOR TRASERO BMW F01 F02 F04 F06 F10 F12 (FREY),1645,0,8,8,16
33326779387 *1,BRAZO SUSPENSION TRASERA (L) BMW E70 E71 E72 F15 F16 F85 F86 (FREY),1286,8,3,7,18
33326779387 *3,BRAZO DE SUSPENSION DELANTERA SUPERIOR TRASERA ( L ) BMW E70 (BMTR),1219,9,5,5,19
33326779388,BRAZO SUPERIOR DE SUSPENSION TRASERA R BMW E70 BMTR,1354,2,0,3,5
33326779388 *1,BRAZO SUPERIOR DE SUSPENSION TRASERA R BMW E70 (FREY),1619,5,9,4,18
33326781625,HORQUILLA DE SUSPENSION TRASERA INFERIOR ( L-R ) BMW E46 ORIGINAL SEMINUEVA,1817,2,4,1,7
33326781625-1,HORQUILLA DE SUSPENSION TRASERA INFERIOR ( L-R ) BMW E46 FREY,1878,5,7,9,21
33326782238 *1,BRAZO CONTROL RECTO TRASERO (L/R) BMW E82 E84 E87 E88 E90 E92 E93 (FREY),1833,5,3,9,17
33326792525 *1,TIRANTE HORQUILLA INFERIOR SUSPENSION TRASERA (L/R) BMW F20 F22 F30 F32 (FREY),1303,0,4,2,6
33326792533 *1,BRAZO SUSPENSION TRASERA SUPERIOR (L/R) BMW F20 F30 F32 (FREY),1780,1,3,2,6
33326792540 *1,TIRANTE HORQUILLA SUPERIOR SUSPENSION TRASERA (L/R) BMW F20 F22 F30 F32 (FREY),1974,1,3,2,6
33326792553,BUJE TRASERO E81 E27 E46 X1 VAICO,1291,7,2,2,11
33326792553 *1,ROTULA INFERIOR SUSPENSION TRASERA (L/R) BMW E81 E84 E90 F20 F30 F32 (FREY),1413,9,7,0,16
33326792553-1,BUJE TRASERO E81 E27 E46 X1 TOPRAN,1222,8,3,5,16
33326870535 *1,BRAZO CURVO SUPERIOR SUSPENSION TRASERA (L/R) BMW G30 (FREY),1210,1,8,1,10
3332764105-1,BUJE DE HORQUILLA DE SUSPENSION TRASERA BMW E53-M54 FREY,1711,6,1,6,13
3332764105-A,BUJE DE HORQUILLA DE SUSPENSION TRASERA BMW E53-M54 LEMFORDER,1334,0,4,1,5
3332764105-B,BUJE DE HORQUILLA DE SUSPENSION TRASERA BMW E53-M54  (LEMFORDER ),1591,0,5,6,11
33406787015 *1,BALERO DOBLE RUEDA TRASERA (L/R) BMW F25 F26 (FREY),1664,4,3,6,13
33406789970 *1,BALERO DOBLE RUEDA TRASERA (L/R) BMW E84 xDRIVE sDRIVE (FREY),1494,6,2,2,10
33411090505 *1,BALERO DOBLE RUEDA TRASERA (L/R) 45X85x41 MM (L/R) BMW E36 E46 E83 E85 E86 (FREY),1846,9,5,2,16
33411093567 *1,BRIDA DE RUEDA BMW E46 E36 FREY,1656,0,2,4,6
33411095238,BALERO MAZA TRASERO BMW E53 BMTR,1541,8,7,0,15
33411095238 *1,BALERO MAZA TRASERO BMW E53 FREY,1993,5,7,4,16
33411095417 *1,BRIDA DE RUEDA BMW E83 E53 FREY,1903,4,0,9,13
33411130617,BALERO DE RUEDA TRASERA BMW E36-M52 BMTR,1767,5,7,9,21
33411130617 *1,BALERO DOBLE RUEDA TRASERA (L/R) MEDIDA 42X75X37 MM BMW E36 (FREY),1334,6,5,8,19
33416756830,BALERO MAZA EJE TRASERO ( L - R ) MINI COOPER R53 BENDIX,1762,4,7,4,15
33416760056 *1,COJINETE DE CUBO DE RUEDA BMW E90 (FREY),1903,2,8,0,10
33416762317 *1,BALERO BOBLE RUEDA TRASERA 42X75X37 BMW E36 E46 E87 E90 Z3 Z4 (FREY),1919,6,6,6,18
33416770974 *1,COJINETE DE RUEDA TRASERA BMW X5 F15 FREY,1458,0,1,9,10
33416774944 *1,BALERO MAZA RUEDA TRASERA (L/R) MINI R50 R52 R53 (FREY),1576,0,9,9,18
33416776651 *1,MASA RUEDA TRASERA SIN BALERO (L/R) BMW E70 F15 F16 (FREY),1667,4,4,5,13
33416792356 *1,RODAMIENTO TRASERO BMW F20 F30 FREY,1208,4,3,2,9
33416792361 *1,BALERO DOBLE 45X84X41 RUEDA TRASERA (L/R) BMW F30 F32 (FREY),1604,5,9,9,23
33416792369 *1,MASA RUEDA TRASERA (L/R) BMW F30 F31 F34 (FREY),1859,7,0,2,9
33416859547 *1,BALERO MASA TRASERO (L/R) BMW F39 F45 F46 F48 F55 (FREY),1614,5,8,8,21
33416867261 *1,MASA RUEDA TRASERA (L/R) F20 F21 F22 F23 F30 F31 (FREY),1915,1,3,7,11
33493-33030,ENFRIADOR DE ACEITE DE TRANSMISION AUTOMATICA TOYOTA CAMRY BMTRS,1821,2,5,8,15
33503450542,BASE DE AMORTIGUADOR BMW E83 OPTIMAL,1927,0,0,4,4
33503451402 *1,AMORTIGUADOR SUSPENSION TRASERA (L/R) BMW E83 (FREY),1694,4,1,6,11
33506764913 *1,AMORTIGUADOR SUSPENSION TRASERO (L/R) MINI R50 R52 R53 (FREY),1298,8,9,8,25
33506764913 *5,AMORTIGUADOR SUSPENSION TRASERA (L/R) MINI R50 (BILSTEIN) SSF,1928,4,3,4,11
33506764914-1,AMORTIGUADOR DE SUSPENSION TRASERO L-R MINIR50-R53 SACHS,1758,5,0,3,8
33506767010 *1,GOMA BASE AMORTIGUADOR SUSPENSION TRASERA (L/R) BMW E84 E87 E90 (FREY),1559,4,2,7,13
33506771737,BASE DE AMORTIGUADOR SUPERIOR TRASERO TOPRAN,1436,3,3,6,12
33506771738,BASE DE AMORTIGUADOR INFERIOR TRASERO BMW E90 URO,1246,9,4,5,18
33506771738 *1,BASE INFERIOR AMORTIGUADOR SUSPENSION TRASERA (L/R) BMW E81 E90 (FREY),1986,1,4,6,11
33506775735 *1,SOPORTE DE COLUMNA SUSPENCION TRASERA N47N FREY,1351,6,7,3,16
33506776139 *1,BASE AMORTIGUADOR SUSPENSION TRASERA (L/R) BMW F01 (FREY),1991,4,1,6,11
33506781539,TORNILLO DE BARRA ESTABILIZADORA DE SUSPENSION TRASERA L-R BMW E65 DELPHI,1919,0,2,5,7
33506781539-1,TORNILLO DE BARRA ESTABILIZADORA DE SUSPENSION TRASERA L-R BMW E65 FREY,1758,4,4,0,8
33506785985 *1,AMORTIGUADOR DE SUSPENSION TRASERA ( L-R ) BMW E60 ( FREY ),1586,2,2,3,7
33506787178 *1,BASE AMORTIGUADOR SUSPENSION TRASERA (L/R) 3 TORNILLOS  BMW F25 F26 (FREY),1683,9,8,6,23
33506791706 *1,BASE AMORTIGUADOR SUSPENSION TRASERA (L/R) 3 TORNILLOS BMW F21 F22 F30-F32 F39 F40 F44-F48 (FREY),1227,0,7,1,8
33506791706 *2,BASE AMORTIGUADOR SUSPENSION TRASERA (L/R) 3 TORNILLOS BMW F21 F22 F30-F32 F39 F40 F44-F48 (EMBLER),1506,9,1,6,16
33506888425 *1,AMORTIGUADOR SUSPENSION TRASERA (L/R) MINI F54 (FREY),1663,0,5,1,6
33521092362,BASE DE AMORTIGUADOR TRASERO L-R BMW E46 BMTR,1431,7,5,5,17
33521092362 *1,BASE AMORTIGUADOR SUSPENSION TRASERA (L/R) BMW E36 E46 (FREY),1789,0,0,0,0
33521093646 *1,AMORTIGUADOR SUSPENSION TRASERO (L/R) BMW E39 (FREY),1625,6,0,8,14
33521095913 *1,AMORTIGUADOR SUSPENSION TRASERA (L/R) BMW E36 E46 (FREY),1890,5,7,5,17
33521096278 *1,AMORTIGUADOR SUSPENSION TRASERA (L/R) BMW E53 (FREY),1610,2,7,6,15
33521097272 *1,BASE AMORTIGUADOR SUSPENSION TRASERA (L/R) BMW E53 (FREY),1803,1,8,3,12
33526754124 *1,BASE AMORTIGUADOR SUSPENSION TRASERA (L/R) MINI R50 A R56 (FREY),1346,1,7,3,11
33526758095 *1,AMORTIGUADOR SUSPENSION DELANTERA (L/R) BMW E65 E66 E67 (FREY),1294,5,5,1,11
33526766605,AMORTIGUADOR DE SUSPENSION TRASERA L-R BMW E60-M54 BMTR,1858,7,8,1,16
33526768544 *1,BASE AMORTIGUADOR SUSPENSION TRASERA (L/R) BMW E84 E87 E90 (FREY),1857,0,9,0,9
33526768544-3,BASE DE AMORTIGUADOR TRASERO ( L-R )  BMW E90 LEMFORDER,1712,7,3,7,17
33526768544-4,BASE DE AMORTIGUADOR TRASERO ( L-R )  BMW E90 MEISTERSATZ,1473,0,5,3,8
33526768544-5,BASE AMORTIGUADOR TRASERO ( L-R )  BMW E90 (BEMQW),1793,3,2,7,12
33526768917,AMORTIGUADOR TRASERO L - R BMW E90 E27 E87 SACHS 310984,1499,1,2,6,9
33526772926,AMORTIGUADOR DE SUSPENSION TRASERA L-R BMW E90-N52 BMTR,1760,9,9,7,25
33526772926 *1,AMORTIGUADOR SUSPENSION TRASERA (L/R) BMW E87 E90 (FREY),1501,0,0,7,7
33526772926 *2,AMORTIGUADOR DE SUSPENSION TRASERA L-R BMW E90-N52 SACH,1669,5,5,8,18
33526773669,BASE DE AMORTIGUADOR TRASERO L-R BMW E53-M54 BMTR,1235,7,9,9,25
33526775551,BUJE DE SUSPENSION TRASERA BMW E46,1502,0,9,2,11
33526775551 *1,BUJE DE SUSPENSION TRASERA BMW E46 (FREY),1929,9,5,4,18
33526779611,BASE DE AMORTIGUADOR TRASERO SUPERIOR BMW E60-N52 GENUINO,1503,5,5,0,10
33526779611 *1,BASE AMORTIGUADOR SUSPENSION TRASERA BMW E60 E63 E65 (FREY),1643,2,0,8,10
33526779670,BASE DE AMORTIGUADOR TRASERO BMW E46-M54 GENUINO,1426,3,6,7,16
33526779670-1,BASE DE AMORTIGUADOR TRASERO BMW E46-M54 FREY,1607,0,2,2,4
33526781921 *1,AMORTIGUADOR SUSPENSION TRASERA (L) BMW E70 E71 (FREY),1258,5,1,1,7
33526781921-1,AMORTIGUADOR DE SUSPENSION TRASERA L BMW E70-N52N KYB 341730,1341,7,4,7,18
33526781922 *1,AMORTIGUADOR SUSPENSION TRASERA (R) BMW E70 E71 (FREY),1751,0,0,9,9
33526781922-1,AMORTIGUADOR SUSPENSION TRASERA (R) BMW E70 E71 KYB 341729,1404,3,6,0,9
33526791562 *1,AMORTIGUADOR SIN SENSOR SUSPENSION TRASERA (L/R) BMW F20 F21 F22 F30 (FREY),1680,0,2,8,10
33526791562 *2,AMORTIGUADOR DE SUSPENSION TRASERA (L/R) BMW F20 F21 F30 (SACHS 315872),1671,5,6,1,12
33526796317 *1,AMORTIGUADOR SIN SENSOR SUSPENSION TRASERA (L/R) BMW F25 F26 (FREY),1623,3,3,5,11
33526798150 *1,AMORTIGUADOR SUSPENSION TRASERA (L/R) BMW F07 GT (FREY),1319,7,4,7,18
33526850445 *1,AMORTIGUADOR SUSPENSION TRASERA (L/R) BMW F10 F18 (FREY),1643,4,4,5,13
33526853964,AMORTIGUADOR DE SUSPENSION TRASERA MINI R56 SACHS 313740,1980,8,9,7,24
33526853964 *1,AMORTIGUADOR SUSPENSION TRASERA (L/R) MINI R56 R58 (FREY),1338,6,5,4,15
33526855243 *1,AMORTIGUADOR SUSPENSION TRASERA (L/R) BMW E84 sDRIVE 18i 20i E84 xDRIVE 25i 28i 35i (FREY),1788,2,0,1,3
33526861687 *1,AMORTIGUADOR SIN SENSOR SUSPENSION TRASERA (L/R) BMW F48 F49 (FREY),1456,5,9,1,15
33526862428 *1,AMORTIGUADOR SUSPENSION TRASERA (L/R) MINI F55 F56 F57 (FREY),1875,8,8,0,16
33526867865 *1,AMORTIGUADOR SIN SENSOR SUSPENSION TRASERA (L) BMW F15 F16 (FREY),1272,2,6,4,12
33526867866 *1,AMORTIGUADOR SIN SENSOR SUSPENSION TRASERA (R) BMW F15 F16 (FREY),1576,5,4,2,11
33526873799 *5,AMORTIGUADOR SIN SENSOR SUSPENSION TRASERA (L/R) BMW F20 F21 F22 F30 (BILSTEIN) SSF,1562,8,5,5,18
33526873799 *6,AMORTIGUADOR SIN SENSOR SUSPENSION TRASERA (L/R) BMW F20 F21 F22 F30 (SACHS) SSF,1860,3,2,5,10
33526879653 *5,AMORTIGUADOR SUSPENSION TRASERA (L/R) MINI F55 F56 F57 (BILSTEIN) SSF,1217,7,6,5,18
33526888424 *1,AMORTIGUADOR SUSPENSION TRASERA (L/R) MINI F60 (FREY),1789,2,8,1,11
33529807019 *1,AMORTIGUADOR AIRE SUSPENSION TRASERA (L) MINI R60 R61 (FREY),1324,5,5,6,16
33529807020 *1,AMORTIGUADOR AIRE SUSPENSION TRASERA (R) MINI R60 R61 (FREY),1794,0,1,6,7
33531093785,PLACA ELASTICA INFERIOR BMW E39,1249,3,7,6,16
33531093785-1,PLACA ELASTICA INFERIOR BMW E39 FREY,1305,6,5,1,12
33531138109,GOMA DE REBOTE AMORTIGUADOR TRASERO E36 E46 URO,1359,4,0,2,6
33536767334,GOMA DE REBOTE DE AMORTIGUADOR TRASERO L-R BMW E90 FEBI,1665,2,9,9,20
33536767334 *1,GOMA DE REBOTE DE AMORTIGUADOR TRASERO L-R BMW E90 FREY,1763,0,7,3,10
33536767334-1,GOMA DE REBOTE DE AMORTIGUADOR TRASERO L-R BMW E90 REIN,1589,2,6,6,14
33536852452 *1,TOPE GOMA MUELLE SUSPENSION TRASERA (L/R) MINI F55 F56 F57 (FREY),1378,6,5,5,16
33536857468 *2,CUBRE POLVO AMORTIGUADOR (L/R) SUSPENSION TRASERA BMW F45 F48 (EMBLER),1385,3,3,6,12
33551096735,TORNILLO ESTABILIZADOR SUSPENSION TRASERA (L/R) BMW E53 (DELPHI),1991,7,8,9,24
33551096735 *1,TORNILLO ESTABILIZADOR SUSPENSION TRASERA (L/R) BMW E53 (FREY),1759,4,9,7,20
33556751269 *1,GOMA BUJE BARRA ESTABILIZADORA SUSPENSION DELANTERA 23.5 MM BMW E46 E85(FREY),1688,6,5,8,19
33556776559 *1 ,GOMA BUJE BARRA ESTABILIZADORA SUSPENSION TRASERA BMW E70 F15 F16 (FREY),1965,7,5,7,19
33556857626,TORNILLO ESTABILIZADOR SUSPENSION TRASERA (L/R) BMW E70 F15 E71 F16  (TOPRAN),1971,4,2,0,6
33676296102R,TAPA DE VOLANTE BMW SEMINUEVA (GENUINA),1936,6,1,0,7
3385010,TERMINAL DIRECCION SIN BIELETA SUSPENSION DELANTERA (L) MERCEDES W123 (LEMFORDER),1813,6,6,3,15
3385210,TERMINAL DIRECCION SIN BIELETA SUSPENSION DELANTERA (R) MERCEDES W123 (LEMFORDER),1354,9,1,3,13
34106787490,DISCO DE FRENOS DELANTEROS BMW F25 / N20 ( PAGID 355123891 ),1277,4,6,4,14
34106787490 *1,DISCO FRENOS DELANTERO 328X28X73 MM BMW F25 F26 (FREY),1749,3,6,5,14
34106790927,SEGURO DE BALATAS DE FRENO DELANTERO ( CLIP ) BMW F30 ( GENUINO ),1595,2,0,5,7
34106790927-1,SEGURO DE BALATAS DE FRENO DELANTERO ( CLIP ) BMW F30 FREY,1524,3,8,6,17
34106797606 *5,DISCO FRENOS DELANTERO 370X73 MM BMW F30 N20 (FREMAX) SSF,1303,0,9,6,15
34106859181 *1,BALATAS FRENOS DELANTEROS 148X70 MM BMW F20 F22 F30 F36 F25 F26 (FREY),1545,8,6,5,19
34106859181 *3,BALATAS FRENOS DELANTEROS 148X70 MM BMW F20 F22 F30 F36 F25 F26 (TRW GDB1942),1313,8,3,2,13
34106859181 *5,BALATAS FRENOS DELANTEROS 148X70 MM BMW F20 F22 F30 F36 F25 F26 (JURID) SSF,1941,8,8,6,22
34106859181 *6,BALATAS FRENOS DELANTEROS 148X70 MM BMW F20 F22 F30 F36 F25 F26 (ATE) SSF,1992,0,2,8,10
34106860019 *3,BALATAS FRENOS DELANTEROS 129X74 MM BMW F48 MINI F55 (TRW GDB2098),1457,2,8,1,11
34106860019 *5,BALATAS FRENOS DELANTEROS BMW F39 F40 F44 F48 MINI F54 F60 (FERODO) SSF,1388,8,7,3,18
34106860020 *3,BALATAS FRENOS DELANTEROS MINI F56 TRW GDB2137- GDB4885,1248,0,5,4,9
34106865722 *1,DISCO FRENOS DELANTEROS 330X24 MM BMW G08 G28 G38 (FREY),1370,7,2,7,16
34106874034 *1,BALATAS FRENOS DELANTEROS 129X64 MM MINI F55 F56 F57 (FREY),1205,8,2,6,16
34106874034 *6,BALATAS FRENOS DELANTEROS 129X64 MM MINI F55 F56 F57 (FERODO) SSF,1715,2,9,1,12
34106882418 *1,BALATAS FRENOS DELANTEROS BMW F39 F40 F44 F48 MINI F54 F60 (FREY),1268,0,4,5,9
34106882418 *5,BALATAS FRENOS DELANTEROS 129X74 MM BMW F48 MINI F55 (FERODO) SSF,1856,2,4,8,14
34106882418 *6,BALATAS FRENOS DELANTEROS BMW F39 F40 F44 F48 MINI F54 F60 (AKEBONO EURO) SSF,1573,3,0,6,9
34106882418 *7,BALATAS FRENOS DELANTEROS BMW F39 F40 F44 F48 MINI F54 F60 (ATE) SSF,1977,4,1,7,12
34106884224 *1,BALATAS FRENOS DELANTERO 114.5 X 91.2 MM BMW F39 F40 F44 F48 MINI F54 F55 F56 F57 F60 (FREY),1440,7,7,2,16
34106885503 *3,BALATAS FRENOS DELANTEROS 129X64 MM MINI F55 F56 F57 (TRW GDB2087),1360,2,4,4,10
34106885503 *5,BALATAS FRENOS DELANTEROS 129X64 MM MINI F55 F56 F57 (AKEBONO EURO) SSF,1453,4,4,0,8
34106888459 *1,BALATAS FRENOS DELANTERO 124 X 118 MM BMW G05-G07 G11-G16 G20 G21 G30-G32 (FREY),1571,6,7,2,15
34106889266 *5,BALATAS FRENOS DELANTERO 114.5 X 91.2 MM BMW F39 F40 F44 F48 MINI F54 F55 F56 F57 F60 (FERODO) SSF,1645,7,8,5,20
34106889266 *6,BALATAS FRENOS DELANTERO 114.5 X 91.2 MM BMW F39 F40 F44 F48 MINI F54 F55 F56 F57 F60 (ATE) SSF,1623,8,1,1,10
34106889266 *7,BALATAS FRENOS DELANTERO 114.5 X 91.2 MM BMW F39 F40 F44 F48 MINI F54 F55 F56 F57 F60 (JURID) SSF,1335,2,0,1,3
341101476-100,BALATAS FRENOS TRASEROS BMW  PAGID T1389 INACTIVO,1577,7,1,5,13
34111163307 *3,BALATAS FRENOS DELANTEROS 156X73 MM BMW E38 E39 E53 (TRW GDB1261),1766,5,8,1,14
34111502891 *2,DISCO FRENOS DELANTERO 276X22 MM MINI R50 R52 R53 (EMBLER) EMB,1744,7,6,5,18
34111502891 *5,DISCO FRENOS DELANTERO 276 X 22 MM MINI R50 R52 R53 (FREMAX PAINTED) SSF,1429,0,8,7,15
34112227670,SEGURO DE BALATAS DE FRENOS DELANTERAS BMW E46 ( ATE ),1722,5,2,1,8
34112282995,BALATAS FRENOS DELANTEROS BMW E46 M Z4 M BOSCH,1330,4,3,2,9
34112284869 *3,BALATAS DELANTERAS 209X87 MM BMW M F06 F10 F12 F13 F16 F87 (BREMBO),1664,6,4,0,10
34113400151 *1,DISCO FRENOS DELANTEROS VENTILADO (L/R) 325 MM BMW E83 M54 E83 N52N (FREY),1971,5,3,9,17
34113400151 *6,DISCO FRENOS DELANTEROS 325X25 MM BMW E83 M54 ( PAGID 355112231 ),1200,1,3,2,6
34114074370,BALATAS DE FRENOS DELANTEROS BMW E70-N52N PAGID T1619,1235,6,5,0,11
34116750159,GOMA DE AMORTIGUADOR BMW E70 (BMTR),2000,5,6,5,16
34116750159 *1,SEGURO BALATAS FRENOS DELANTERA (L/R) 18.6 MM BMW E36 E46 E83 E85 E86 (FREY),1566,7,3,0,10
34116750159 *5,SEGURO DE BALATAS DE FRENOS DELANTERAS BMW E46 (ATE) SSF,1695,1,3,1,5
34116761244 *1,BALATAS FRENOS DELANTEROS 150X58 MM BMW E46 E36 E85 (FREY),1969,2,1,7,10
34116761244 *3,BALATAS FRENOS DELANTEROS 150X58 MM BMW E46 E36 E85 (TRW GDB1348),1724,5,2,3,10
34116761244 *5,BALATAS FRENOS DELANTEROS 150X58 MM BMW E46 E36 E85 (ATE) SSF,1882,6,8,3,17
34116761244 *6,BALATAS FRENOS DELANTEROS 150X58 MM BMW E46 E36 E85 (JURID) SSF,1549,4,5,5,14
34116761252 *1,BALATAS FRENOS DELANTEROS 156X74 MM BMW E38 E39 E53 (FREY),1304,2,0,3,5
34116761252-1,BALATAS DE FRENOS DELANTEROS BMW E53 BREMBO P06021N,1463,5,7,2,14
34116761252-2,BALATAS DE FRENOS DELANTEROS BMW E53 PAGID T1136,1353,0,4,0,4
34116761277,BALATAS FRENOS DELANTEROS BMW E39 PAGID T1103,1310,9,5,7,21
34116761278 *1,BALATAS FRENOS DELANTEROS 155X64 MM BMW E39 ( FREY),1741,8,1,0,9
34116761282 *1,BALATAS FRENOS DELANTEROS BMW E53-N62 FREY,1753,9,4,8,21
34116761282 *5,BALATAS FRENOS DELANTEROS BMW E53-N62 (JURID) SSF,1281,1,7,6,14
34116763617 *1,BALATAS FRENOS DELANTEROS 155X64 MM BMW E60 E61 (FREY),1594,1,0,6,7
34116764021 *1,DISCO FRENOS DELANTEROS VENTILADOS (L/R) 310X24 MM BMW E60 (FREY),1216,1,3,7,11
34116764021 *3,DISCO FRENOS DELANTEROS VENTILADOS (L/R) 310X24 MM BMW E60 (HELLA),1782,1,0,4,5
34116767061,DISCO DE FRENOS DELANTEROS BMW E39 ( VENTILADO BREMBO I1225 ),1507,0,8,8,16
34116767147 *1,BALATAS FRENOS DELANTEROS 150X58 MM BMW E81 E82 E87 E88 (FREY),1725,6,1,4,11
34116768933 *5,DISCO FRENOS DELANTEROS VENTILADO (L/R) 294 MM MINI R50 R52 R53 JCW (FREMAX PAINTED) SSF,1893,3,9,5,17
34116768933 *6,DISCO FRENOS DELANTEROS VENTILADO (L/R) 294 MM MINI R50 R52 R53 JCW (ATE) SSF,1622,0,9,9,18
3411676951 *3,BALATAS FRENOS DELANTEROS 57X150 MM BMW  (TRW GDB1625),1492,7,6,8,21
34116769763-100,BALATAS FRENOS DELANTEROS 57X150 MM BMW E87 F56 R56 (FREY) INACTIVO,1787,7,2,9,18
34116770332 *1,BALATAS FRENOS DELANTEROS 140.2 X 60 MM MINI R50 R52 R53 (FREY),1557,4,8,3,15
34116770332 *3,BALATAS FRENOS DELANTEROS 140.2 X 60 MM MINI R50 R52 R53 (TRW GDB1476),1942,1,9,0,10
34116770332 *5,BALATAS FRENOS DELANTEROS 140.2 X 60 MM MINI R50 R52 R53 (ATE) SSF,1350,0,0,1,1
34116770332 *9,BALATAS FRENOS DELANTEROS 140.2 X 60 MM MINI R50 R52 R53 (FTE BL1786A2),1272,2,4,4,10
34116771868 *3,BALATAS FRENOS DELANTEROS 155X64 MM BMW E90 E84 E89 (TRW GDB1559),1726,8,7,4,19
34116771868 *5,BALATAS FRENOS DELANTEROS 155X64 MM BMW E90 E84 E89 (ATE) SSF,1608,0,6,1,7
34116771868 *6,BALATAS FRENOS DELANTEROS 155X64 MM BMW E90 E84 E89 (BOSCH) SSF,1698,4,9,6,19
34116772892 *3,BALATAS FRENOS DELANTEROS 131X53 MM BMW E87 E88 MINI F56 R56 (TRW GDB1870),1863,0,9,9,18
34116772892 *5,BALATAS FRENOS DELANTEROS 131X53 MM BMW E87 E88 MINI F56 R56 (FERODO) SSF,1513,6,1,4,11
34116772892 *6,BALATAS FRENOS DELANTEROS 131X53 MM BMW E87 E88 MINI F56 R56 (ATE) SSF,1732,8,6,6,20
34116772892 *7 ,BALATAS FRENOS DELANTEROS 131X53 MM BMW E87 E88 MINI F56 R56 (JURID) SSF,1469,2,1,9,12
34116774050 *1,BALATAS FRENOS DELANTEROS 131X53 MM BMW E87 E88 MINI F56 R56 (FREY),1736,3,6,2,11
34116774986 *1,DISCO FRENOS DELANTEROS VENTILADO (L/R) 294 MM MINI R50 R52 R53 (FREY),1540,1,7,6,14
34116776526,CLIP DE RETENCION GENUINO,1751,1,8,3,12
34116776526 *1,REPUESTO DE REPARACION TORNILLOS DE FRENO BMW E90 (FREY),1345,5,9,8,22
34116777772 *5,BALATAS FRENOS DELANTEROS 155X64 MM BMW E81 E87 E88 (BOSCH) SSF,1264,9,9,9,27
34116777772 *6,BALATAS FRENOS DELANTEROS 155X64 MM BMW E81 E87 E88 (ATE) SSF,1234,5,8,4,17
34116778048 *1,BALATAS DE FRENOS DELANTEROS 193X79 MM BMW E70 E71 F16 (FREY),1687,8,7,7,22
34116778320 *5,BALATAS FRENOS DELANTEROS 140.2 X 60 MM MINI R50 R52 R53 R55 R56 R57 R58 R59 JCW (JURID) SSF,1350,9,0,6,15
34116778647,DISCO DE FRENOS DELANTEROS BMW 135 COUPE / N55 ( ZIMMERMANN ),1618,1,1,2,4
34116778647-1,DISCO DE FRENOS DELANTEROS BMW 135 COUPE / N55 FREEMAX,1306,8,3,5,16
34116779652 *1,BALATAS FRENOS DELANTEROS 155X64 MM BMW E46 E85 E86 (FREY),1297,1,8,4,13
34116779652 *5,BALATAS FRENOS DELANTEROS 155X64 MM BMW E46 E85 E86 (FERODO) SSF,1623,4,8,5,17
34116779652 *6,BALATAS FRENOS DELANTEROS 155X64 MM BMW E46 E85 E86 (ATE) SSF,1566,0,4,5,9
34116779652 *7,BALATAS FRENOS DELANTEROS 155X64 MM BMW E46 E85 E86 (JURID) SSF,1324,7,3,0,10
34116780-100,BALATAS FRENOS DELANTEROS 155X68 MM BMW TEXTAR INACTIVO,1400,8,3,5,16
34116780711 *1,BALATAS FRENOS DELANTEROS 155X68 MM BMW E90 F30 E84 (FREY),1873,0,4,7,11
34116780711 *3,BALATAS FRENOS DELANTEROS 155X68 MM BMW E90 F30 E84 (TRW GDB1729),1457,7,1,4,12
34116780711 *5,BALATAS FRENOS DELANTEROS 155X68 MM BMW E90 F30 E84 (JURID) SSF,1293,0,0,7,7
34116780711 *6,BALATAS FRENOS DELANTEROS 155X68 MM BMW E90 F30 E84 (ATE) SSF,1252,1,3,8,12
34116786044 *1,BALATAS FRENOS DELANTEROS 164.8 X 73.0 MM BMW E81 E90 (FREY),1447,8,0,1,9
34116786044 *3,BALATAS FRENOS DELANTEROS 164.8 X 73 MM BMW E87 E90 (TRW GDB1802),1437,4,9,9,22
34116786044 *5,BALATAS FRENOS DELANTEROS 165X73 MM BMW E87 E90 (BOSCH) SSF,1968,3,3,8,14
34116789157 *3,BALATAS FRENOS DELANTEROS MINI R56-N14 JOHN COOPER (TRW GDB1948),1295,0,2,6,8
34116789157 *5,BALATAS FRENOS DELANTEROS 120.9 X 75.5 MINI JCW R55 R56 R57 R58 R59 (BOSCH) SSF,1770,3,3,8,14
34116789157 *6,BALATAS FRENOS DELANTEROS 120.9 X 75.5 MINI JCW R55 R56 R57 R58 R59 (FERODO) SSF,1717,9,9,0,18
34116791514 *3,BALATAS DE FRENOS DELANTEROS 193X79 MM BMW E70 E71 F16 (TRW GDB1728),1421,5,3,1,9
34116791514 *5,BALATAS DE FRENOS DELANTEROS 193X79 MM BMW E70 E71 F16 (FERODO) SSF,1954,9,7,8,24
34116791514 *6,BALATAS DE FRENOS DELANTEROS 193X79 MM BMW E70 E71 F16 (ATE) SSF,1395,9,0,3,12
34116792217,DISCO DE FRENOS DELANTEROS 300 MM BMW F20 PAGID,1959,1,9,9,19
34116792217 *1,DISCO FRENOS DELANTEROS 300 MM BMW F20 F30 (FREY),1432,1,6,6,13
34116792217-3,DISCO DE FRENOS DELANTEROS 300 MM BMW F20  (HIPPER),1356,6,1,4,11
34116792219 *1,DISCO FRENOS DELANTERO (L/R) 312 X 24 MM BMW F20 F22 E90 F32 E84 (FREY),1839,7,6,0,13
34116792219 *5,DISCO FRENOS DELANTERO (L/R) 312 X 24 MM BMW F20 F22 E90 F32 E84 (FREMAX) SSF,1546,4,1,5,10
34116792221,DISCO DE FRENOS DELANTEROS BMW F30 / N20 ( PAGID 355119561 ),1471,3,5,2,10
34116792221 *1,DISCO FRENOS DELANTEROS VENTILADO (L/R) 330 MM BMW F22 F30 F32 (FREY),1674,3,4,3,10
34116794056 *3,BALATAS FRENO DELANTERAS  R56 E87 (TRW GDB1611),1368,0,8,2,10
34116794429,PINZA DE FRENO F18 FREY,1936,0,5,2,7
34116794464 *3,BALATAS FRENOS DELANTEROS 193X96 MM BMW F15 (TRW GDB1915),1611,5,6,1,12
3411679491-100,BALATAS FRENOS DELANTEROS 155X68 MM BMW E60 M54 N52 INACTIVO,1625,0,4,0,4
34116794915 *3,BALATAS FRENOS DELANTEROS 155X68 MM BMW E60-N62 (TRW GDB2021),1751,1,9,7,17
34116794916-1,BALATAS FRENOS DELANTEROS BMW E60 BREMBO,1800,0,9,9,18
34116794917,BALATAS FRENOS DELANTEROS BMW E90-N54 PAGID T2029,1821,8,4,2,14
34116794917-1,BALATAS FRENOS DELANTEROS BMW E90-N54 TEXTAR 2331303,1247,7,2,2,11
34116794918 *1,BALATAS FRENOS DELANTEROS 155X68 MM BMW E60 M54 N52 6 CIL E63 N52 6 CIL (FREY),1342,5,6,6,17
34116794920,BALATAS FRENOS DELANTEROS BMW E90-N54 BREMBO P06031N,1517,0,2,9,11
34116797859 *1,BALATAS FRENOS DELANTEROS 155X64 MM BMW E81 E87 E88 (FREY),1499,5,0,3,8
34116797859 *3,BALATAS FRENOS DELANTEROS 155X64 MM BMW E81 E87 E88 (TRW GDB1810),1742,8,7,0,15
34116799351 *1,DISCO FRENOS DELANTERO 307X24X67 MM BMW F39 F40 F44-F46 F48 (FREY),1208,3,1,0,4
34116799964 *1,BALATAS FRENOS DELANTEROS 135X114 MM BMW E70 E71 S63 F15 F16 N55 N63N (FREY),1583,8,2,7,17
34116799964 *3,BALATAS FRENOS DELANTEROS 135X114 MM BMW E70-S63 (TRW GDB1826),1202,5,2,1,8
34116799964 *5,BALATAS FRENOS DELANTEROS 135X114 MM BMW E70-S63 (JURID) SSF,1203,6,9,7,22
34116850568 *1,BALATAS FRENOS DELANTEROS 156 X 62 MM BMW F20 F33 F34 (FREY),1496,7,1,6,14
34116850568 *3,BALATAS FRENOS DELANTEROS 156X62 MM BMW F20 F33 F34 (TRW GDB1934),1644,9,7,2,18
34116850568 *5,BALATAS FRENOS DELANTEROS 156X62 MM BMW F20 F33 F34 (ATE) SSF,1834,6,4,3,13
34116850885,BALATAS FRENOS DELANTEROS 155X68 MM BMW E90-N52 FTE BL2084A2,1540,0,3,8,11
34116851269 *1,BALATAS FRENOS DELANTEROS 192X79 MM BMW F01 F06 F10 (FREY),1948,9,9,8,26
34116851269 *3,BALATAS DE FRENOS DELANTEROS BMW F10 (TRW GDB1838),1453,0,7,0,7
34116852253 *1,BALATAS FRENOS DELANTEROS 171X77 MM BMW F26 E70 F15 E71  (FREY),1527,2,8,0,10
34116852253 *3,BALATAS FRENOS DELANTEROS 171X77 MM BMW F26 E70 F15 E71 (TRW GDB1726),1359,1,3,6,10
34116852253 *5,BALATAS FRENOS DELANTEROS 171.1 X 76.8 MM BMW F26 E70 F15 E71 (FERODO) SSF,1222,6,2,6,14
34116852253 *6,BALATAS FRENOS DELANTEROS 171.1 X 76.8 MM BMW F26 E70 F15 E71 (BOSCH) SSF,1871,5,2,6,13
34116852253 *7,BALATAS FRENOS DELANTEROS 171.1 X 76.8 MM BMW F26 E70 F15 E71 (JURID) SSF,1993,8,0,8,16
34116852253 *9,BALATAS DE FRENOS DELANTEROS 171X76 MM BMW E70-N52 BMTR,1692,0,5,3,8
34116854997 *1,DISCO FRENOS DELANTERO 292X22X79 MM BMW E81 E82 E87 E88 E90 (FREY),1403,6,9,7,22
34116854997 *3,DISCO DE FRENOS DELANTEROS BMW E87-N46N (HIPPER),1558,8,3,0,11
34116854998,DISCO DE FRENOS DELANTEROS BMW E90 - N52N  PAGID 355123581,1945,0,6,4,10
34116854998 *1,DISCO DE FRENOS DELANTEROS BMW E90-N52N (FREY),1777,2,1,5,8
34116854998 *5,DISCO DE FRENOS DELANTEROS BMW E90 - N52N (FREMAX) SSF,1835,2,5,7,14
34116854999,DISCO DE FRENOS DELANTEROS VENTILADO BMW E90 ( BREMBO A6156 ),1976,4,6,6,16
34116854999 *1,DISCO FRENOS DELANTEROS VENTILADO 330X24 MM BMW E81 E82 E84 E87 E88 E90-E93 (FREY),1771,4,5,9,18
34116855000,DISCO DE FRENOS DELANTERO BMW E90 PAGID 348 X 30 MM,1841,3,7,9,19
34116855000-1,DISCO DE FRENOS DELANTERO BMW E90 FREMAX,1585,0,2,7,9
34116855781 *1,DISCO FRENOS DELANTERO VENTILADO (L/R) 316X22 MM MINI R55 R56 R57 R58 R59 JWC (FREY),1380,0,2,5,7
34116855781 *5,DISCO FRENOS DELANTERO VENTILADO (L/R) 316X22 MM MINI R55 R56 R57 R58 R59 JWC (FREMAX) SSF,1573,2,8,7,17
34116855781 *6,DISCO FRENOS DELANTERO VENTILADO (L/R) 316X22 MM MINI R55 R56 R57 R58 R59 JWC (ATE) SSF,1445,9,6,8,23
34116855782 *1,DISCO FRENOS DELANTERO HIPERVENTILADO (L/R) 316X22 MM MINI R55 R56 R57 R58 R59 JWC (FREMAX) SSF,1589,6,8,1,15
34116855782 *2,DISCO FRENOS DELANTERO HIPERVENTILADO (L/R) 316X22 MM MINI R55 R56 R57 R58 R59 (EMBLER) EMB,1974,2,3,2,7
34116858651 *1,DISCO FRENOS DELANTEROS 280 MM (L/R) MINI R55 R56 R57 R59 (FREY),1649,0,8,0,8
34116859066 *1,BALATAS FRENOS DELANTEROS 114X91 MM BMW F20 F22 F30 F32 (FREY),1405,3,8,4,15
34116859679 *1,DISCO DE FRENO BMW E53 ( FREY ),1943,8,3,9,20
34116864047,DISCO DE FRENOS DELANTEROS BMW E46 ( PAGID 355107671 ),1596,1,2,2,5
34116864047 *2,DISCO DE FRENOS DELANTEROS BMW E46 M54 (FREMAX),1837,6,5,3,14
34116864047-1,DISCO DE FRENOS DELANTEROS BMW E46 ( FREMAX ),1598,4,5,0,9
34116864058,DISCO DE FRENOS DELANTEROS BMW E46 ( BREMBO 300 X 22 MM ),1564,4,0,9,13
34116864058-1,DISCO DE FRENOS DELANTEROS BMW E46 ( PAGID 300 X 22 MM ),1727,3,0,5,8
34116864060,DISCO DE FRENOS DELANTEROS BMW E46 286 X 22 MM PAGID,1576,2,5,7,14
34116864060-1,DISCO DE FRENOS DELANTEROS BMW E46 286 X 22 MM BREMBO,1959,9,3,6,18
34116864906,DISCO DE FRENOS DELANTERO BMW E60-N52N PAGID 355123791,1801,0,9,9,18
34116865713 *2,DISCO FRENOS TRASEROS SOLIDOS (L/R) 330X24 MM BMW F39 F40 F45-F48 MINI F60 (EMBLER),1655,4,4,7,15
34116866295,DISCO DE FRENOS DELANTEROS 280X22 MM MINI F55 F56 F57  (FREMAX),1827,0,5,3,8
34116866295 *1,DISCO DE FRENOS DELANTEROS 280X22 MM MINI F55 F56 F57 (FREY),1266,1,0,2,3
34116866297,DISCO DE FRENOS DELANTERO DIEMETRO 294 MM MINI F56 BREMBO,1672,7,9,3,19
34116866297 *1,DISCO FRENOS DELANTERO VENTILADO (L/R) 294 MM BMW F39 F45 F48 MINI F54 F55 F56 F57 F60 (FREY),1367,2,8,5,15
34116872632 *1,BALATAS FRENOS DELANTEROS BMW F10 ( FREY ),1554,0,4,2,6
34116872632 *5,BALATAS FRENOS DELANTEROS BMW F10 (JURID) SSF,1976,5,5,3,13
34116878876 *3,BALATAS FRENOS DELANTEROS 114X91 MM BMW F20 F22 F30 F32 (TRW GDB1943),1706,5,5,3,13
34116878876 *5,BALATAS FRENOS DELANTEROS 114X91 MM BMW F20 F22 F30 F32 (JURID) SSF,1396,1,7,7,15
34116883469 *1,BALATAS FRENOS DELANTEROS 219.0 X 84.7 MM BMW G1 G2 G5 G6 G20 G30 (FREY),1721,8,4,8,20
34116883470 *5,BALATAS FRENOS DELANTEROS 219.0 X 84.7 MM BMW G1 G2 G5 G6 G20 G30 (JURID) SSF,1509,9,6,5,20
34116886481 *1,DISCO DE FRENOS DELANTEROS BMW E70 E71 F15 F16 (FREY),1387,6,5,3,14
34116898729 *5,DISCO DE FRENO DELANTERO (L/R) BMW F12 (FREMAX) SSF,1426,6,1,6,13
34119804735 *1,BALATAS FRENOS DELANTEROS 131X71 MM MINI R56 R60 (FREY),1261,6,0,0,6
34119804735 *3,BALATAS FRENOS DELANTEROS 131X71 MM MINI R56 R60 (TRW GDB1712),1650,4,4,1,9
34119804735 *6,BALATAS FRENOS DELANTEROS 131X71 MM MINI R56 R60 (ATE) SSF,1817,1,6,6,13
34119804735 *7,BALATAS FRENOS DELANTEROS 131X71 MM MINI R50 R53 (AKEBONO EURO) SSF,1373,1,4,5,10
34119804735 *8,BALATAS FRENOS DELANTEROS 131.6 X 71.4 MM MINI R56 R60 (ATE CERAMIC) SSF,1629,8,5,2,15
34119804735 *9,BALATAS FRENOS DELANTEROS 131X71 MM MINI R50 R53 (FERODO) SSF,1217,8,5,9,22
34119811538 *1,DISCO FRENOS DELANTEROS (L/R) 307X 24 MM MINI R60 R61 (FREY),1822,6,2,6,14
34119811538-1,DISCO DE FRENOS DELANTEROS MINI R60 307X24 MM PAGID,1371,9,5,7,21
3416580568,BALATAS DE FRENOS DELANTEROS BMW F30-N20 BMTSR,1777,7,4,9,20
34202920,BALATAS FRENOS DELANTEROS MERCEDES W210 PAGID,1414,7,0,1,8
34206868936,DISCO DE FRENOS TRASERO BMW F25 / N20 ( PAGID ),1749,7,5,8,20
34206868936 *1,DISCO DE FRENOS TRASERO BMW F25 - N20 (FREY),1966,4,6,0,10
34206868936-1,DISCO DE FRENOS TRASERO BMW F25 - N20 ( FREMAX ),1624,1,0,5,6
34206885600 *1,BALATAS FRENOS TRASEROS 123.0 X 60.6 MM BMW F40 F44 M MINI F54 F60 JCW (FREY),1382,8,9,8,25
34206885600 *5,BALATAS FRENOS TRASEROS 123.0 X 60.6 MM BMW F40 F44 M MINI F54 F60 JCW (AKEBONO EURO) SSF,1932,0,7,7,14
34206885600 *6,BALATAS FRENOS TRASEROS 123.0 X 60.6 MM BMW F40 F44 M MINI F54 F60 JCW (ATE) SSF,1408,2,3,2,7
34206888832 *1,BALATAS FRENOS TRASERO 98 X 55 MM BMW G20 G29 (FREY),1767,4,7,6,17
34206888835 *5,BALATAS FRENOS TRASEROS 111X73 MM BMW G20 G21 G29 (BOSCH) SSF,1743,2,0,1,3
34206888835 *6,BALATAS FRENOS TRASEROS 111X73 MM BMW G20 G21 G29 (ATE) SSF,1672,5,3,4,12
34206888835 *7,BALATAS FRENOS TRASEROS 111X73 MM BMW G20 G21 G29 (ATE CERAMIC) SSF,1204,0,8,1,9
34211159963,SEGURO DE BALATAS DE FRENO TRASERO BMW E46 ( CLIP ),1368,1,4,6,11
34211164501,BALATAS DE FRENOS TRASEROS BMW E46 325 i M54 TEXTAR 2193402,1577,6,5,1,12
34212284389 *1,BALATAS FRENOS TRASERAS 116X65 MM BMW F10 G01 G02 SERIE M (FREY),1719,1,9,4,14
34212284389 *5,BALATAS FRENOS TRASERAS 116X65 MM BMW F10 G01 G02 SERIE M (ATE) SSF,1273,7,7,6,20
34213332217,DISCO DE FRENOS TRASEROS BMW E83 / M54 ( PAGID 355112251 ),1885,6,2,9,17
34213332217 *1,DISCO FRENOS TRASEROS 320X22 MM BMW E83 (FREY),1268,1,0,7,8
34216753675,SEGURO DE BALATAS DE FRENOS TRASEROS BMW E90 / N54 ( ATE ),1898,9,1,2,12
34216753675 *1,SEGURO DE BALATAS DE FRENO TRASERO BMW E46 FREY,1554,3,7,0,10
34216753675-100,SEGURO DE BALATAS DE FRENOS TRASEROS BMW E90 / N54 FREY INACTIVO,1452,9,0,8,17
34216761239 *1,BALATAS FRENOS TRASEROS 123X45 MM BMW E46 E86 (FREY),1828,3,4,6,13
34216761239-6,BALATAS DE FRENOS TRASEROS BMW E46-M54 BREMBO P06025N,1876,6,0,7,13
34216761240-5,BALATAS FRENOS TRASEROS BMW E46 330 i  M54 TEXTAR 2148701,1304,5,4,9,18
34216761248 *1,BALATAS FRENOS TRASEROS 123X59 MM BMW E46 E39 E38 E53 E85 E52 (FREY),1858,0,8,1,9
34216761248 *3,BALATAS FRENOS TRASEROS 123X59 MM BMW E46 E39 E38 E53 E85 E52 (TRW GDB1530),1884,4,1,6,11
34216761248 *4,BALATAS FRENOS TRASEROS 123X59 MM BMW E38 E39 E46 E52 E53 E85 E86 (TEXTAR),1742,4,8,9,21
34216761248 *5 ,BALATAS FRENOS TRASEROS 123X59 MM BMW E46 E39 E38 E53 E85 E52 (ATE) SSF,1622,3,1,6,10
34216762871 *1,BALATAS FRENOS TRASEROS 123X44 MM MINI R50 R52 R53 (FREY),1789,1,2,9,12
34216762871 *5,BALATAS FRENOS TRASEROS 123X44 MM MINI R50 R52 R53 (JURID) SSF,1283,2,3,9,14
34216762871 *6,BALATAS FRENOS TRASEROS 123X44 MM MINI R50 R52 R53 (ATE) SSF,1702,5,6,2,13
34216763043 *1,BALATAS FRENOS TRASEROS 122X59 MM BMW E60 (FREY),1262,0,7,7,14
34216763043 *3,BALATAS FRENOS TRASEROS MERCEDES W203 3.0 L V6 (TRW GDB1727),1471,5,2,0,7
34216763043 *5,BALATAS FRENOS TRASEROS BMW E60 N52-N52N-N54 (JURID) SSF,1670,5,7,7,19
34216763043 *6,BALATAS FRENOS TRASEROS BMW E60 N52 N52N N54 (ATE) SSF,1562,6,3,5,14
34216763043-100,BALATAS FRENOS TRASEROS BMW E60 N52-N52N-N54 INACTIVO,1692,8,6,7,21
34216763827,DISCO DE FRENOS TRASEROS BMW E60 / N26 ( ZIMMERMAN 150346120 ),1584,0,3,8,11
34216763827-1,DISCO DE FRENOS TRASEROS BMW E60 / N62 ( FREMAX ),1780,2,6,8,16
34216764651 *1,DISCO FRENOS TRASEROS VENTILADO (L/R) 300 MM BMW E81 E90 (FREY),1803,7,7,1,15
34216764655,DISCO DE FRENOS VENTILADO TRASERO BMW E90 ( BREMBO 336 X 22 ),1491,4,5,1,10
34216767060,DISCO DE FRENOS TRASEROS BMW E39 (PAGID 298 MM.),1820,2,1,9,12
34216768471 *1,BALATAS FRENOS TRASEROS BMW 140X68 MM E82 E90 E60 E63 E65 E70 E71 F16 (FREY),1420,5,8,3,16
34216768471 *3,BALATAS FRENOS TRASEROS BMW 140X68 MM E82 E90 E60 E63 E65 E70 E71 F16 (TRW GDB1502),1790,9,5,3,17
34216768471 *5,BALATAS FRENOS TRASEROS BMW 140X68 MM E82 E90 E60 E63 E65 E70 E71 F16 (FERODO) SSF,1264,0,2,4,6
34216768471 *6,BALATAS FRENOS TRASEROS BMW 140X68 MM E82 E90 E60 E63 E65 E70 E71 F16 (ATE) SSF,1555,4,7,2,13
34216774692 *1,BALATAS FRENOS TRASEROS 123X48 MM BMW E81 E90 (FREY),1757,1,9,9,19
34216774692 *3,BALATAS FRENOS TRASEROS 123X48 MM BMW E81 E90 (TRW GDB2050),1992,5,6,5,16
34216774692 *5,BALATAS FRENOS TRASEROS 123X48 MM BMW E81 E90 (FERODO) SSF,1816,4,9,2,15
34216774692 *6,BALATAS FRENOS TRASEROS 123X48 MM BMW E81 E90 (ATE) SSF,1411,5,5,8,18
34216774692 *7,BALATAS FRENOS TRASEROS 123X48 MM BMW E81 E90 (JURID) SSF,1505,1,5,6,12
34216774987 *1,DISCO FRENOS TRASEROS (L/R) 259 X 10 MM MINI R50 R52 R53 R55 R56 R57 R58 R59 (FREY),1720,4,2,1,7
34216774987-1,DISCO DE FRENOS TRASEROS MINI R50-R52-R53-R56 PAGID,1923,6,1,5,12
34216776937 *1,BALATAS FRENOS TRASEROS 122X58 MM BMW E70 E71 (FREY),1654,4,2,6,12
34216776937 *3,BALATAS FRENOS TRASEROS 122X58 MM BMW E70 E71 (TRW GDB1730),1532,8,3,8,19
34216776937 *5,BALATAS FRENOS TRASEROS 122X58 MM BMW E70 E71 (ATE) SSF,1734,8,9,2,19
34216776937 *6,BALATAS FRENOS TRASEROS 122X58 MM BMW E70 E71 (FERODO) SSF,1657,9,5,1,15
34216776937-1,BALATAS DE FRENOS TRASEROS 122X57 BMW E70-N52N PAGID,1311,0,6,7,13
34216778168 *3,BALATAS FRENOS TRASEROS 123X45 MM BMW E46 E86 (TRW GDB1344),1522,1,0,6,7
34216778168 *5,BALATAS FRENOS TRASEROS 123X45 MM BMW E46 E86 (ATE) SSF,1650,9,0,4,13
34216778168 *6,BALATAS FRENOS TRASEROS 123X45 MM BMW E46 E86 (JURID) SSF,1414,2,0,8,10
34216778327 *1,BALATAS FRENOS TRASEROS 95X49 MM MINI R56-N14 TURBO (FREY),1281,0,0,4,4
34216778327 *3,BALATAS FRENOS TRASEROS 95X49 MM MINI R56-N14 TURBO (TRW GDB1766),1992,4,0,5,9
34216778327 *5,BALATAS FRENOS TRASEROS 95X49 MM MINI R56-N14 TURBO (ATE) SSF,1995,3,8,5,16
34216778327 *6,BALATAS FRENOS TRASEROS 95X49 MM MINI R56-N14 TURBO (JURID) SSF,1622,5,9,4,18
34216783-100,BALATA FRENO TRASERO BMW TRW GDB1602 INACTIVO,1371,4,0,8,12
34216784808 *1,BALATAS FRENOS TRASEROS 86X76 MM BMW E82 (FREY),1254,3,6,5,14
34216788183,BALATAS FRENOS TRASEROS 95X51 MM BMW E81 E87 PAGID T1445,1560,7,8,2,17
34216788183 *1,BALATAS FRENOS TRASEROS 95X51 MM BMW E81 E87 (FREY),1674,0,4,0,4
34216788183 *5,BALATAS FRENOS TRASEROS 95X51 MM BMW E81 E87 TEXTAR 2362303,1579,6,3,5,14
34216790762 *1,BALATAS FRENOS TRASEROS 123X58 MM BMW E90 E84 (FREY),1284,3,7,7,17
34216790762 *3,BALATAS FRENOS TRASEROS 123X58 MM BMW E90 E84 (TRW GDB1560),1506,1,1,7,9
34216790762 *5,BALATAS FRENOS TRASEROS 123X58 MM BMW E90 E84 (ATE CERAMIC) SSF,1297,0,0,9,9
34216790762 *6,BALATAS FRENOS TRASEROS 123X58 MM BMW E90 E84 (JURID) SSF,1674,4,9,1,14
34216790966 *1,BALATAS FRENOS TRASEROS BMW F07-F01 ( FREY ),1434,7,1,3,11
34216790966 *5,BALATAS FRENOS TRASEROS BMW F07-F01 ( JURID ) SSF,1941,3,1,0,4
34216791421 *3,BALATAS FRENOS TRASEROS 86X76 MM BMW E82 (TRW GDB1795),1339,0,6,8,14
34216791421 *5,BALATAS FRENOS TRASEROS 86X76 MM BMW E82 (ATE) SSF,1654,8,6,8,22
34216792225,DISCO DE FRENOS TRASERO 290 MM BMW F20 BREMBO,1286,7,4,2,13
34216792225 *1,DISCO FRENOS TRASEROS SOLIDO (L/R) 290 MM BMW F20 F22 (FREY),1744,5,8,2,15
34216792225-1,DISCO DE FRENOS TRASERO 290 MM BMW F20 FREMAX,1433,6,3,5,14
34216793246,DISCO DE FRENOS TRASEROS VENTILADO 345X24 MM BMW E70 PAGID,1984,7,0,8,15
34216794618 *1,ACTUADOR ELECTRICO FRENO ESTACIONAMIENTO (L/R) BMW E89 F06 F10 F11 F12 F13 I12 I15 F25 F23 (FREY),1886,3,9,3,15
34216794879,BALATAS FRENOS TRASEROS BMW E70-S63 PAGID T1683,1972,5,9,9,23
34216794879 *3,BALATAS FRENOS TRASEROS BMW E70-S63 (TRW GDB1892),1207,4,3,4,11
34216795318 *1,DISCO DE FRENOS TRASEROS 385x24 MM BMW E70 E71 F15 F16 (FREY),1329,9,7,5,21
34216796741 *1,BALATAS FRENOS TRASEROS 106X62 MM BMW I12 I15 E89 F25 F26 (FREY),1679,7,7,2,16
34216796741 *3,BALATAS FRENOS TRASEROS BMW F25-N20 (TRW GDB1840),1830,2,6,7,15
34216796741 *5,BALATAS FRENOS TRASEROS 106X62 MM BMW E89 F25 F26 L12 A L15 (JURID) SSF,1971,8,7,0,15
34216796741 *6,BALATAS FRENOS TRASEROS 106X62 MM BMW E89 F25 F26 L12 A L15 (FERODO) SSF,1535,2,8,9,19
34216796741-1,BALATAS DE FRENOS TRASEROS BMW F25-N20 TEXTAR 2456102,1568,6,4,7,17
34216797861,BALATAS FRENOS TRASEROS BMW Z4-E89 PAGID T1858,1521,6,0,4,10
34216799369 *2,DISCO FRENOS TRASEROS SOLIDOS (L/R) 300X20 MM BMW F39 F40 F44-F48 MINI F54 F60 (EMBLER),1839,8,1,3,12
34216799383,DISCO DE FRENOS TRASEROS MINI F56 / B38 ( HIPPER ),1480,5,8,9,22
34216799383 *1,DISCO FRENOS TRASEROS (L/R) 259X10 MM MINI F55 F56 F57 (FREY),1990,4,3,5,12
34216850569 *1,BALATAS FRENOS TRASEROS 123X44 MM BMW F20 F22 F30 F36 (FREY),1958,3,6,6,15
34216850569 *3,BALATAS FRENOS TRASEROS 123X44 MM BMW F20 F22 F30 F36 (TRW GDB1919),1843,3,1,9,13
34216850569 *5,BALATAS FRENOS TRASEROS 123X44 MM BMW F20 F22 F30 F36 (ATE) SSF,1707,7,7,3,17
34216850569 *6,BALATAS FRENOS TRASEROS 123X44 MM BMW F20 F22 F30 F36 PAGID T3138,1920,5,4,5,14
34216855002 *1,DISCO FRENOS TRASEROS 296 X 10 MM BMW E87 N46N (FREY),1949,9,9,2,20
34216855002-2,DISCO DE FRENOS TRASEROS BMW E87 - N46N ( PAGID ),1511,7,6,4,17
34216855002-3,DISCO DE FRENOS TRASEROS BMW E87 - N46N ( FREMAX ),1578,4,4,6,14
34216855004,DISCO DE FRENOS TRASERO 336 x22 CON CARGA EXTRA BMW E90 PAGID,1423,8,9,5,22
34216855004-6,DISCO DE FRENOS TRASERO 336 x 22 CON CARGA EXTRA BMW E90 FREMAX,1846,5,6,3,14
34216855005,DISCO DE FRENOS TRASEROS VENTILADOS 300 MM BMW E90 PAGID,1790,7,9,7,23
34216855005 *1,DISCO FRENOS TRASEROS VENTILADOS 300 MM BMW E90 (FREY),1606,0,4,5,9
34216855005-1,DISCO DE FRENOS TRASEROS VENTILADOS 300 MM BMW E90 FREMAX,1468,4,0,1,5
34216855007,DISCO DE FRENOS TRASERO 300X20 MM BMW E87-E90-F30  FREMAX,1594,5,8,9,22
34216855007-1,DISCO DE FRENOS TRASERO 300X20 MM BMW E87-E90-F30  PAGID,1682,6,3,1,10
34216855008 *1,DISCO FRENOS TRASEROS 300X20 MM BMW E81 E84 E87 E90-E93 (FREY),1480,6,2,9,17
34216859678,DISCOS DE FRENO TRASEROS 324 MM BMW E53 M54-M62 PAGID,1836,9,5,6,20
34216859678-1,DISCOS DE FRENO TRASEROS 324 MM BMW E53 M54-M62 FREY,1756,2,3,9,14
34216859917 *1,BALATAS FRENOS TRASEROS 123X48 MM BMW F48 MINI F55 ( FREY),1972,8,7,4,19
34216859917 *3,BALATAS FRENOS TRASEROS 123X48 MM BMW F48 MINI F55 (TRW GDB2063),1782,1,6,7,14
34216859917 *5,BALATAS FRENOS TRASEROS 123X48 MM BMW F48 MINI F55 (ATE) SSF,1930,0,3,0,3
34216859917 *6,BALATAS FRENOS TRASEROS 123X48 MM BMW F48 MINI F55 (JURID) SSF,1541,1,0,1,2
34216864052,DISCO DE FRENOS TRASEROS BMW E46 ( CENTRIC 320 x 22 MM ),1794,9,7,8,24
34216864052-1,DISCO DE FRENOS TRASEROS BMW E46 / M54 ( PAGID 355107691 ),1267,8,4,8,20
34216864056,DISCO DE FRENOS TRASERO BMW E46 ( PAGID 355124011 ),1207,6,5,8,19
34216864056-1,DISCO DE FRENOS TRASERO BMW E46 ( BREMBO 294 X 19 MM ),1725,8,7,7,22
34216864061 *1,DISCO DE FRENOS TRASEROS 320X20 MM BMW E60 E63 (FREY),1876,0,0,5,5
34216864061 *5 ,DISCO DE FRENOS TRASEROS 320X20 MM BMW E60 E63 (PAGID) SSF,1245,3,9,0,12
34216864900 *1,DISCO DE FRENOS TRASEROS 300X20 MM BMW F30 F31 F32 F33 F34 F36 (FREY),1821,2,1,7,10
34216864901,DISCO DE FRENOS TRASEROS BMW E90 / N52N ( ZIMMERMANN 150343720 ),1276,0,0,1,1
34216864901-1,DISCO DE FRENOS TRASEROS BMW E90 / N52N PERFORMANCE,1859,9,7,3,19
34216864903,DISCO DE FRENOS TRASEROS BMW E46-M54 BREMBO A5989,1657,3,6,4,13
34216864903 *1,DISCO FRENOS TRASEROS VENTILADO (L/R) 276 MM BMW E36 E46 (FREY),1683,0,6,8,14
34216864903-2,DISCO DE FRENOS TRASEROS BMW E46-M54 FREMAX,1978,6,5,4,15
34216867175 *1,BALATAS FRENOS TRASEROS 116X72 MM BMW G01 G02 (FREY),1922,3,4,3,10
34216867175 *3,BALATAS FRENOS TRASEROS 116X72 MM BMW G01 G02 (TRW GDB1869),1513,8,2,6,16
34216867175 *5,BALATAS FRENOS TRASEROS 116X72 MM BMW G01 G02 (ATE) SSF,1518,0,6,1,7
34216867175 *6,BALATAS FRENOS TRASEROS 116X72 MM BMW G01 G02 (JURID) SSF,1634,7,3,9,19
34216871300 *1,BALATAS FRENOS TRASEROS 100X45 MM MINI F55 F56 (FREY),1941,6,4,5,15
34216871300 *3,BALATAS FRENOS TRASEROS 100X45 MM MINI F55 F56 (TRW GDB2088),1346,5,1,9,15
34216871300 *5,BALATAS FRENOS TRASEROS 100X45 MM MINI F55 F56 (FERODO) SSF,1932,4,7,3,14
34216876422-100,BALATAS FRENO TRASERAS BMW F30 BMTSR inactivo,1700,5,7,3,15
34216885529 *6,BALATAS FRENOS TRASEROS 100X45 MM MINI F55 F56 (ATE) SSF,1772,8,3,9,20
34216886480 *1,DISCO DE FRENOS TRASEROS VENTILADO 345X24 MM BMW E70 E71 E72 F15 F16 (FREY),1891,5,2,3,10
34216887576 *1 ,BALATAS FRENOS TRASEROS 71.8 X 88.0 MM BMW F20M F22M F30M F32M (FREY),1879,2,6,4,12
34216887576 *3,BALATAS FRENOS TRASEROS 71.8 X 88.0 MM BMW F20M F22M F30M F32M (TRW GDB2028),1225,6,1,6,13
34216887576 *5,BALATAS FRENOS TRASEROS 71.8 X 88.0 MM BMW F20M F22M F30M F32M (ATE) SSF,1347,5,7,0,12
34216892641 *5,BALATAS FRENOS TRASERO 106.2 X 62.4 MM F10 F25 F26 E89 (FERODO) SSF,1676,6,4,8,18
34216892641 *6,BALATAS FRENOS TRASERO 106X62 MM F10 F25 F26 E89 (ATE) SSF,1290,2,8,8,18
34219808172 *1,BALATAS FRENOS TRASEROS 95X44 MM MINI R60 R61 (FREY),1615,4,0,5,9
34219808172 *3,BALATAS FRENOS TRASEROS 95X44 MM MINI R60 R61 (TRW GDB1612),1333,5,8,6,19
34219808172 *5,BALATAS FRENOS TRASEROS 95X44 MM MINI R60 R61 (FERODO) SSF,1604,3,2,1,6
34219808172 *6,BALATAS FRENOS TRASEROS 95X44 MM MINI R60 R61 (ATE) SSF,1796,9,9,7,25
34219808172 *7,BALATAS FRENOS TRASEROS 95X44 MM MINI R60 R61 (JURID) SSF,1312,4,6,2,12
34301166118,MANGUERA DE FRENO DELANTERO BMW X5 E53 TOPRAN,1469,2,4,9,15
34301166118 *1,MANGUERA LIQUIDO FRENOS DELANTERA (L/R) BMW E53 (FREY),1698,1,3,1,5
34336772930,CILINDRO MAESTRO DE FRENOS BMW E70,1568,4,2,1,7
34336772930-1,CILINDRO MAESTRO DE FRENOS BMW E70 FREY,1321,3,0,2,5
34336785666,CILINDRO PRINCIPAL DE FRENOS BMW E46 ATE,1370,2,5,4,11
34336785666-1,CILINDRO PRINCIPAL DE FRENOS BMW E46 FREY,1821,0,5,1,6
34351163207,SENSOR DE FRENOS TRASERO BMW E39 ( BMTR ),1238,2,4,2,8
34351163207-1,SENSOR DE FRENOS TRASERO BMW E39 FREY,1276,1,5,2,8
34351164371 *1,SENSOR BALATAS FRENOS DELANTERO (L/R) BMW E46 E85 (FREY),1254,2,7,2,11
34351164372,SENSOR BALATAS FRENOS TRASERO (L/R) BMW E46 (BMTR),1550,1,3,0,4
34351164372 *1,SENSOR BALATAS FRENOS TRASERO (L/R) BMW E46 (FREY),1874,0,6,7,13
34351164372-2,SENSOR BALATAS FRENOS TRASERO (L/R) BMW E46 ( BAMPIC ),1785,9,6,2,17
34351165579 *1,SENSOR BALATAS FRENOS DELANTERO (L/R) BMW E53 (FREY),1252,5,9,5,19
34351165579-1,SENSOR BALATAS FRENOS DELANTERO (L/R) BMW E53 BMTR,1406,6,0,2,8
34351165580 *1,SENSOR BALATAS FRENOS TRASERO (L/R) BMW E53 (FREY),1731,8,2,2,12
34351181337,SENSOR BALATAS FRENOS DELANTERO (L/R) BMW E36 BMTR,1841,6,0,8,14
34351181337-100,SENSOR DE BALATAS DE FRENOS DELANTEROS BMW E36-M52 FREY inactivo,1322,1,8,2,11
34351181337-2,SENSOR BALATAS FRENOS DELANTERO (L/R) BMW E36 URO,1901,9,0,7,16
34351181338 *1,SENSOR BALATAS FRENOS DELANTERO (L/R) BMW E36 (FREY),1862,1,6,9,16
34351182533,SENSOR BALATAS FRENOS TRASERO (L/R) BMW E36 BMTR,1267,5,9,3,17
34351182533 *1,SENSOR BALATAS FRENOS TRASERO (L/R) BMW E36 FREY,1633,7,8,8,23
34352229018,SENSOR BALATAS FRENOS DELANTERO (L/R) BMW E39 BMTR,1338,5,8,1,14
34352229018 *1,SENSOR BALATAS FRENOS DELANTERO (L/R) BMW E39 (FREY),1669,4,9,9,22
34353411756,SENSOR BALATAS FRENOS DELANTERO (L/R) BMW E83 BMTR,1222,3,6,0,9
34353411756 *1,SENSOR BALATAS FRENOS DELANTERO (L/R) BMW E83 (FREY),1492,2,4,9,15
34353411757 *1,SENSOR BALATAS FRENOS TRASERO (L/R) BMW E83 (FREY),1607,8,5,0,13
34356761448,SENSOR BALATAS FRENOS TRASERO (L/R) MINI R50 R52 R53 URO,1710,5,7,0,12
34356761448 *1,SENSOR BALATAS FRENOS TRASERO (L/R) MINI R50 R52 R53 (FREY),1900,3,7,0,10
34356761448-1,SENSOR BALATAS FRENOS TRASERO (L/R) MINI R50 R52 R53 TOPRAN,1757,8,0,2,10
34356761448-3,SENSOR BALATAS FRENOS TRASERO (L/R) MINI R50 R52 R53 OSSCA,1862,8,8,5,21
34356762252 *1,SENSOR BALATAS FRENOS DELANTERO (L/R) BMW E81 E90 (FREY),1582,3,4,8,15
34356764298 *1,SENSOR BALATAS FRENOS DELANTERO (L) BMW E60 E63 (FREY),1852,6,5,7,18
34356764299 *1,SENSOR BALATAS FRENOS TRASERO (L/R) BMW E60 E63 E64 (FREY),1314,3,2,2,7
34356771766 *1,SENSOR BALATAS FRENOS TRASERO (L/R) BMW E70 E71 (FREY),1273,9,4,9,22
34356773018-3,SENSOR BALATAS FRENOS TRASERO (L/R) MINI R55 R56 R57 KZR,1559,3,9,6,18
34356778037,SENSOR BALATAS FRENOS DELANTERO (L/R) BMW E65 E66 E67 BMTR,1706,6,8,7,21
34356778037 *1,SENSOR BALATAS FRENOS DELANTERO (L/R) BMW E65 E66 E67 (FREY),1920,7,8,0,15
34356778038,SENSOR BALATAS FRENOS TRASERO (L/R) BMW E65 E66 E67 BMTR,1587,9,8,7,24
34356778038 *1,SENSOR BALATAS FRENOS TRASERO (L/R) BMW E65 E66 E67 (FREY),1804,2,4,8,14
34356778175,SENSOR BALATAS FRENOS DELANTERO (L/R) MINI R50 R52 R53 TOPRAN,1842,6,6,7,19
34356778175 *1,SENSOR BALATAS FRENOS DELANTERO (L/R) MINI R50 R52 R53 (FREY),1669,0,0,7,7
34356789329,SENSOR BALATAS FRENOS DELANTERO (L/R) MINI R55 R56 R57 R59 GST,1773,5,6,8,19
34356789329 *1,SENSOR BALATAS FRENOS DELANTERO (L/R) MINI R55 R56 R57 R59 (FREY),1383,2,7,4,13
34356789329-1,SENSOR BALATAS FRENOS DELANTERO (L/R) MINI R55 R56 R57 R59 PEX,1677,2,3,4,9
34356789329-2,SENSOR BALATAS FRENOS DELANTERO (L/R) MINI R55 R56 R57 R59 TOPRAN,1824,4,6,7,17
34356789329-3,SENSOR BALATAS FRENOS DELANTERO (L/R) MINI R55 R56 R57 R59 OSCCA,1289,9,4,9,22
34356789330,SENSOR BALATAS FRENOS TRASERO (L/R) MINI R55 R56 R57 R58 (PAGID),1413,0,6,7,13
34356789330 *1,SENSOR BALATAS FRENOS TRASERO (L/R) MINI R55 R56 R57 R58 (FREY),1328,3,6,3,12
34356789330-1,SENSOR BALATAS FRENOS TRASERO (L/R) MINI R55 R56 R57 R58 TOPRAN,1895,3,4,7,14
34356789439-2,SENSOR BALATAS FRENOS DELANTERO (L/R) BMW E81 E90 TOPRAN,1545,6,6,3,15
34356789439-3,SENSOR BALATAS FRENOS DELANTERO (L/R) BMW E81 E90 KZR GERMANY,1301,2,1,0,3
34356789439-4,SENSOR BALATAS FRENOS DELANTERO (L/R) BMW E81 E90 BAMPIC,1638,1,0,5,6
34356789439-5,SENSOR BALATAS FRENOS DELANTERO (L/R) BMW E81 E90 OSCCA,1611,4,2,1,7
34356789439-9,SENSOR BALATAS FRENOS DELANTERO (L/R) BMW E81 E90 BMTR,1877,6,6,3,15
34356789440 *1,SENSOR BALATAS FRENOS DELANTERO (L/R) BMW E87 E90 (FREY),1842,3,8,8,19
34356789440-2,SENSOR BALATAS FRENOS DELANTERO (L/R) BMW E87 E90 OSSCA,1510,8,0,8,16
34356789440-7,SENSOR BALATAS FRENOS DELANTERO (L/R) BMW E87 E90 TOPRAN,1674,7,8,8,23
34356789441,SENSOR BALATAS FRENOS DELANTERO (L) BMW E84 E90 URO,1284,9,7,3,19
34356789441-2,SENSOR BALATAS FRENOS DELANTERO (L) BMW E84 E90 BMTSR,1603,4,4,6,14
34356789445- 100,SENSOR BALATAS FRENOS TRASERO (L/R) BMW E81 E87 E90 E93 BAMPIC inactivo,1340,1,4,1,6
34356789445-100,SENSOR DE BALATAS DE FRENOS TRASEROS BMW E90-N52 OSSCA inactivo,1241,3,7,5,15
34356789445-2,SENSOR BALATAS FRENOS TRASERO (L/R) BMW E81 E87 E90 E93 TOPRAN,1484,8,8,3,19
34356789445-3,SENSOR BALATAS FRENOS TRASERO (L/R) BMW E81 E87 E90 E93 BAPMIC,1749,9,7,9,25
34356789445-4,SENSOR BALATAS FRENOS TRASERO (L/R) BMW E81 E87 E90 E93 OSSCA,1229,0,4,1,5
34356789445-9,SENSOR BALATAS FRENOS TRASERO (L/R) BMW E81 E87 E90 E93 BMTRS,1504,6,5,6,17
34356789492,SENSOR BALATAS FRENOS DELANTERO (L) BMW E60 E63 BMTR,1591,0,1,0,1
34356789492-2,SENSOR BALATAS FRENOS DELANTERO (L) BMW E60 E63 TOPRAN,1830,4,1,9,14
34356789493,SENSOR BALATAS FRENOS TRASERO (L/R) BMW E60 E63 E64 BMTR,1208,6,9,0,15
34356789501 *1,SENSOR BALATAS FRENOS DELANTERO (L/R) BMW E70 E71 (FREY),1354,6,3,4,13
34356789505-9,SENSOR BALATAS FRENOS TRASERO (L/R) BMW E70 E71 BMTR,1245,2,8,3,13
34356790303,SENSOR BALATAS FRENOS DELANTERO (L) BMW F25 F26 BOWA,1231,2,7,1,10
34356790303 *1,SENSOR BALATAS FRENOS DELANTERO (L) BMW F25 F26 (FREY),1572,3,8,7,18
34356790303-1,SENSOR BALATAS FRENOS DELANTERO (L) BMW F25 F26 BMTR,1498,3,3,8,14
34356790303-3,SENSOR BALATAS FRENOS DELANTERO (L) BMW F25 F26 OSSCA,1937,4,5,3,12
34356790304,SENSOR BALATAS FRENOS TRASERO (L/R) BMW F25 F26 BMTR,1406,1,3,8,12
34356790304 *1,SENSOR BALATAS FRENOS TRASERO (L/R) BMW F25 F26 (FREY),1437,2,9,5,16
34356790304-2,SENSOR BALATAS FRENOS TRASERO (L/R) BMW F25 F26 OSSCA,1597,8,7,8,23
34356790304-3,SENSOR BALATAS FRENOS TRASERO (L/R) BMW F25 F26 TOPRAN,1219,0,4,7,11
34356790340 *1,SENSOR BALATAS FRENOS DELANTERO (L/R) BMW E84 (FREY),1385,8,9,1,18
34356790340-9,SENSOR BALATAS FRENOS DELANTERO (L/R) BMW E84 (BAMPIC),1509,1,8,2,11
34356791958,SENSOR BALATAS FRENOS DELANTERO (L/R) BMW F10 F01 BMTR,1457,5,6,9,20
34356791958 *1,SENSOR BALATAS FRENOS DELANTERO (L/R) BMW F10 F01 (FREY),1662,8,6,2,16
34356791958-2,SENSOR BALATAS FRENOS DELANTERO (L/R) BMW F10 F01 TOPRAN,1879,9,1,7,17
34356791962,SENSOR BALATAS FRENOS TRASERO (L/R) BMW F10 F11 TOPRAN,1739,8,3,0,11
34356791962 *1,SENSOR BALATAS FRENOS TRASERO (L/R) BMW F10 F11 (FREY),1830,8,0,5,13
34356792289 *1,SENSOR BALATAS FRENOS DELANTERO (L) BMW F20 F22 F30 F32 (FREY),1817,6,4,5,15
34356792289 *2,SENSOR BALATAS FRENOS DELANTERO (L) BMW F20 F22 F30 F32 OSSCA,1808,4,5,7,16
34356792289-100,SENSOR DE BALATAS DE FRENOS DELANTEROS BMW F30 BAMPIC INACTIVO,1318,9,3,4,16
34356792292,SENSOR BALATAS FRENOS TRASERO (L/R) BMW F20 F22 F30 F32 BMTR,1705,9,9,2,20
34356792292 *1,SENSOR BALATAS FRENOS TRASERO (L/R) BMW F20 F22 F30 F32 (FREY),1247,1,4,0,5
34356792292-1,SENSOR BALATAS FRENOS TRASERO (L/R) BMW F20 F22 F30 F32 BAMPIC,1619,2,6,8,16
34356792292-3,SENSOR BALATAS FRENOS TRASERO (L/R) BMW F20 F22 F30 F32 OSSCA,1408,9,6,3,18
34356792292-4,SENSOR BALATAS FRENOS TRASERO (L/R) BMW F20 F22 F30 F32 TOPRAN,1632,0,7,2,9
34356792560-3,SENSOR BALATAS FRENOS DELANTERO (L/R) BMW E87 E88 E90 E93 BAMPIC,1507,2,8,4,14
34356792561 *1,SENSOR BALATAS FRENOS DELANTERO (L) BMW E84 E90 (FREY),1847,8,9,4,21
34356792564 *1,SENSOR BALATAS FRENOS TRASERO (L/R) BMW E81 E90 (FREY),1922,6,1,1,8
34356792565,SENSOR BALATAS FRENOS TRASERO (L/R) BMW E84 BMTR,1936,0,5,8,13
34356792565 *1,SENSOR BALATAS FRENOS TRASERO (L/R) BMW E84 (FREY),1623,9,8,3,20
34356792566 *1,SENSOR BALATAS FRENOS TRASERO (L/R) BMW E89 (FREY),1680,4,3,3,10
34356792567,SENSOR BALATAS FRENOS DELANTERO (L) BMW E70 E71 F15 F16 BMTR,1644,8,4,3,15
34356792567 *1,SENSOR BALATAS FRENOS DELANTERO (L) BMW E70 E71 F15 F16 (FREY),1459,0,7,9,16
34356792568,SENSOR BALATAS FRENOS DELANTERO (L/R) BMW E70 F15 E71 F16 PAGID P8584,1791,2,9,0,11
34356792568 *1,SENSOR BALATAS FRENOS DELANTERO (L/R) BMW E70 F15 E71 F16 (FREY),1995,5,0,6,11
34356792568-1,SENSOR BALATAS FRENOS DELANTERO (L/R) BMW E70 F15 E71 F16 VAICO,1344,8,8,1,17
34356792572,SENSOR BALATAS FRENOS DELANTERO (L/R) MINI R55 R56 R57 R58 R59 BMTR,1548,6,4,5,15
34356792572 *1,SENSOR BALATAS FRENOS DELANTERO (L/R) MINI R55 R56 R57 R58 R59 (FREY),1905,7,3,7,17
34356792572-1,SENSOR BALATAS FRENOS DELANTERO (L/R) MINI R55 R56 R57 R58 R59 BOWA,1345,9,1,2,12
34356792572-3,SENSOR BALATAS FRENOS DELANTERO (L/R) MINI R55 R56 R57 R58 R59 BAMPIC,1843,9,1,3,13
34356792573,SENSOR BALATAS FRENOS TRASERO (L/R) MINI R55 R56 R57 R58 R59 PAGID 355251881,1244,6,4,3,13
34356792573 *1,SENSOR BALATAS FRENOS TRASERO (L/R) MINI R55 R56 R57 R58 R59 (FREY),1811,3,4,6,13
34356792573-1,SENSOR BALATAS FRENOS TRASERO (L/R) MINI R55 R56 R57 R58 R59 TOPRAN,1878,8,7,0,15
34356792573-2,SENSOR BALATAS FRENOS TRASERO (L/R) MINI R55 R56 R57 R58 R59 BAMPIC,1667,9,9,2,20
34356794285 *1,SENSOR BALATAS FRENOS DELANTERO (L/R) BMW E82 E88 (FREY),1950,5,3,5,13
34356865612 *1,SENSOR BALATAS FRENOS TRASERO (L/R) BMW F48 MINI F55 F56 F57 (FREY),1409,6,0,3,9
34356865612 *3,SENSOR BALATAS FRENOS TRASERO (L/R) BMW F48 MINI F55 F56 F57 (BOWA),1633,3,0,1,4
34356865612-1,SENSOR BALATAS FRENOS TRASERO (L/R) BMW F48 MINI F55 F56 F57 (PAGID 355252621),1434,7,3,0,10
34356865612-2,SENSOR BALATAS FRENOS TRASERO (L/R) BMW F48 MINI F55 F56 F57 (URO),1923,2,0,4,6
34356865612-3,SENSOR BALATAS FRENOS TRASERO (L/R) BMW F48 MINI F55 F56 F57 BAMPIC,1766,8,4,9,21
34356865612-4,SENSOR BALATAS FRENOS TRASERO (L/R) BMW F48 MINI F55 F56 F57 OSSCA,1225,4,7,9,20
34356865612-9,SENSOR BALATAS FRENOS TRASERO (L/R) BMW F48 MINI F55 F56 F57 (TOPRAN),1491,7,6,2,15
34356868612-5,SENSOR BALATAS FRENOS TRASERO (L(R) BMW F48 MINI F55 F56 F57 TOPRAN,1851,5,1,2,8
34356887827 *1,SENSOR BALATAS FRENOS DELANTERO (L) MINI F55 F56 F57 (FREY),1855,3,0,5,8
34356887827 *3,SENSOR BALATAS FRENOS DELANTERO (L) MINI F55 F56 F57 TOPRAN,1997,0,5,5,10
34356887827 *4,SENSOR BALATAS FRENOS DELANTERO (L) MINI F55 F56 F57 OSSCA,1277,8,6,9,23
34356887827 *5,SENSOR BALATAS FRENOS DELANTERO (L) MINI F55 F56 F57 (FEBI) SSF,1365,2,1,2,5
34356887827 *6,SENSOR BALATAS FRENOS DELANTERO (L) MINI F55 F56 F57 (VAICO),1385,5,4,7,16
34356887827-100,SENSOR DE BALATAS DE FRENOS DELANTEROS ( L ) MINI F56 ( PAGID ) INACTIVO,1913,2,9,7,18
34356888167,SENSOR BALATAS FRENOS DELANTERO (L/R) BMW F48 MINI F56 F57 TOPRAN,1601,0,1,7,8
34356888167 *1,SENSOR BALATAS FRENOS DELANTERO (L/R) BMW F48 MINI F56 F57 (FREY),1295,0,4,2,6
34356888167-2,SENSOR BALATAS FRENOS DELANTERO (L/R) BMW F48 MINI F56 F57 OSSCA,1242,3,3,7,13
34357836795-100,SENSOR DE BALATAS DELANTERAS BMW Z4 BMTR INACTIVO,1385,4,1,8,13
34359804833,SENSOR BALATAS FRENOS DELANTERO (L/R) MINI R60 BAMPIC,1880,7,3,9,19
34359804833 *1,SENSOR BALATAS FRENOS DELANTERO (L/R) MINI R60 (FREY),1446,0,4,1,5
34359804833-1,SENSOR BALATAS FRENOS DELANTERO (L/R) MINI R60 TOPRAN,1427,2,5,6,13
34359804834 *1,SENSOR BALATAS FRENOS TRASERO (L/R) MINI F60 (FREY),1510,6,2,2,10
34359804834-2,SENSOR BALATAS FRENOS TRASERO (L/R) MINI F60 KZR,1463,1,8,2,11
34359804834-3,SENSOR BALATAS FRENOS TRASERO (L/R) MINI F60 TOPRAN,1657,7,5,6,18
34359804834-4,SENSOR BALATAS FRENOS TRASERO (L/R) MINI F60 BAMPIC,1209,0,7,4,11
34410410825,JUEGO DE RESORTES DE FRENO DE MANO BMW E87 ATE,1232,5,6,4,15
34410410825-1,JUEGO DE RESORTES DE FRENO DE MANO BMW E87 FREY,1407,1,1,2,4
34411165020,CABLE DE FRENO DE MANO R BMW E46-M54 FEBI,1486,0,9,6,15
34411165020-1,CABLE DE FRENO DE MANO R BMW E46-M54 FREY,1206,5,6,0,11
34411165021,CABLE DE FRENO DE MANO L BMW E46-M54 FEBI,1710,2,9,3,14
34411165021-1,CABLE DE FRENO DE MANO L BMW E46-M54 FREY,1424,2,2,3,7
34416761292 *6,KIT 4 PZ BALATAS TRASERAS FRENO ESTACIONAMIENTO BMW 20X12X8 MM E81 E82 E84 E90 F32 (ATE) SSF,1719,2,8,6,16
3443685028-100,MODULO DE FRENO DE MANO BMW E70-N52 BEMQW INACTIVO,1373,1,6,5,12
34436850289 *1,MODULO ELECTRONICO ACTUADOR FRENO ESTACIONAMINETO BMW E70 E71 E72 (FREY),1804,5,3,6,14
34436850289B,MOTOR ELECTRICO PARA MODULO FRENO ESTACIONAMIENTO BMW E70  E71 (FREY),1200,8,8,1,17
34436856931 *9,MOTOR MODULO FRENO MANO BMW F01 A F04 (BMTSR),1648,9,3,8,20
34436856931-1,MOTOR DE MODULO DE FRENO DE MANO BMW F02 / N54 / N63 FREY,1386,8,6,2,16
34436874220 *1,MODULO ELECTRONICO ACTUADOR FRENO MANO BMW F15 F16 F85 F86 (FREY),1629,0,2,5,7
34436877316 *1,MOTOR MODULO FRENO MANO BMW F01 A F04 (FREY),1840,4,8,2,14
34511165467,SENSOR DE MODULO ABS BMW E46 ( BOSCH ),1870,0,1,1,2
34511165467-1,SENSOR DE MODULO ABS BMW E46 FREY,1702,1,3,0,4
34521163027,SENSOR DE FRENOS ABS DELANTERO ( L / R ) BMW E36 / M52 ( ATE ),1299,1,3,3,7
34521163027 *1,SENSOR FRENOS ABS DELANTERO (L/R) BMW E36 (FREY),1639,3,6,0,9
34521164370,SENSOR DE FRENOS ABS TRASERO L-R REDONDO BMW E46 BMTR,1226,8,6,1,15
34521164370 *1,SENSOR FRENOS ABS TRASERO (L/R) CABLE 960 MM SENSOR REDONDO BMW E46 (FREY),1703,7,0,3,10
34521164370 *5,SENSOR DE FRENOS ABS TRASERO L-R REDONDO BMW E46 (DELPHI) SSF,1747,3,9,6,18
34521164458,SENSOR DE BOOSTER BMW E46,1352,2,9,2,13
34521164458-1,SENSOR DE BOOSTER BMW E46 FREY,1294,1,3,9,13
34521165609,SENSOR DE FRENOS ABS DELANTERO ( L / R ) BMW E46 ( BMTR ),1931,7,8,2,17
34521165609 *1,SENSOR DE FRENOS ABS DELANTERO ( L - R ) BMW E46 FREY,2000,6,1,6,13
34521165609-1,SENSOR DE FRENOS ABS DELANTERO ( L / R ) BMW E46 ( DELPHI ),1333,8,7,1,16
34521165609-3,SENSOR DE FRENOS ABS DELANTERO ( L - R ) BMW E46 FAE,1448,7,5,6,18
34521182067,SENSOR ABS TRASERO E36 ATE,1862,6,9,1,16
34521182159-1,SENSOR DE FRENOS ABS DELANTERO BMW E39 / M52 FREY,1714,1,9,9,19
34521182159-4,SENSOR DE FRENOS ABS DELANTERO BMW E39 / M52 ( BMTR ),1436,2,4,9,15
34521182160,SENSOR DE FRENOS ABS TRASERO BMW E39 M52-M62 BMTR,1412,2,9,4,15
34521182160 *1,SENSOR DE FRENOS ABS TRASERO BMW E39 M52-M62 FREY,1510,3,9,5,17
34523405906,SENSOR DE FRENOS ABS DELANTERO BMW E83 / N46 ( BOSCH ),1499,8,9,1,18
34523405906-100,SENSOR DE FRENOS ABS DELANTERO BMW E83 / N46  (FREY ) INACTIVO,1529,2,0,8,10
34523420330,SENSOR DE FRENOS ABS DELANTERO BMW E83 / N46 ( BMTR ),1325,2,3,0,5
34523420330 *1,SENSOR DE FRENOS ABS DELANTERO BMW E83 / N46 FREY,1840,2,7,2,11
34523420331,SENSOR DE FRENOS ABS TRASERO BMW E83 / N46 ( BOSCH ),1863,3,8,7,18
34523420331 *1,SENSOR DE FRENOS ABS TRASERO BMW E83 / N46 FREY,1363,4,2,8,14
34523420331-1,SENSOR DE FRENOS ABS TRASERO BMW E83 / N46 ( BMTR ),1691,7,4,6,17
34526752681-1,SENSOR DE FRENOS ABS DELANTERO ( L ) BMW E46 ( BMTSR ),1829,2,5,1,8
34526752681-3,SENSOR DE FRENOS ABS DELANTERO ( L ) BMW E46 ( BREMI),1349,4,3,4,11
34526752702,SENSOR DE FRENOS ABS TRASERO BMW E46 330 BMTR,1860,6,3,8,17
34526752702-1,SENSOR DE FRENOS ABS TRASERO BMW E46 330 FREY,1372,7,4,3,14
34526756375,SENSOR DE FRENOS ABS DELANTERO BMW E39 / TM  ( BMTR ),1864,9,7,0,16
34526756375 *1,SENSOR FRENOS ABS DELANTERO (L/R) BMW E39 (FREY),1832,8,6,7,21
34526756376,SENSOR DE FRENOS ABS TRASERO BMW E39 TM BMTR,1596,1,9,0,10
34526756376-1,SENSOR DE FRENOS ABS TRASERO BMW E39 TM FREY,1738,3,5,8,16
34526756384 *1,SENSOR FRENOS ABS DELANTERO (L/R) CABLE 755 MM MINI COOPER R50 R52 R53 (FREY),1456,8,1,9,18
34526756384 *3,SENSOR FRENOS ABS DELANTERO (L/R) CABLE 755 MM MINI COOPER R50 R52 R53 (VDO),1579,2,9,3,14
34526756384 *5,SENSOR FRENOS ABS DELANTERO (L/R) CABLE 755 MM MINI COOPER R50 R52 R53 (TOPRAN) SSF,1961,8,5,9,22
34526756385 *1,SENSOR FRENOS ABS TRASERO (L/R) CABLE 905 MM MINI COOPER R50 R52 R53 (FREY),1750,6,5,8,19
34526758289 *3,SENSOR ABS FRENOS DELANTERO (L/R) BMW E65 E66 (BMTR),1536,2,6,9,17
34526760045-100,SENSOR DE FRENOS ABS DELANTERO BMW E60 / M54 / N52 / N62  FREY INACTIVO,1508,1,3,1,5
34526760045-9,SENSOR DE FRENOS ABS DELANTERO BMW E60 / M54 / N52 / N62  ( BMTR ),1768,2,6,3,11
34526760534 -A,SENSOR DE FRENOS ABS TRASERO BMW E53  BMTR,1252,0,6,8,14
34526762465,SENSOR DE FRENOS ABS DELANTERO BMW E87 ( BMTR ),1806,5,6,2,13
34526762465 *1,SENSOR DE FRENOS ABS DELANTERO BMW E87 ( FREY ),1284,0,1,8,9
34526762466,SENSOR DE FRENOS ABS TRASERO BMW E87 BMTR,1749,0,4,7,11
34526762466 *1,SENSOR DE FRENOS ABS TRASERO BMW E87 FREY,1563,0,2,9,11
34526764610,SENSOR DE FRENOS ABS TRASERO BMW E90 ( BMTRS ),1567,0,9,1,10
34526764610-1,SENSOR DE FRENOS ABS TRASERO BMW E90 ( FREY ),1479,3,3,0,6
34526764858,SENSOR DE FRENOS ABS DELANTERO BMW E90 BMTR,1803,3,9,2,14
34526764858-1,SENSOR DE FRENOS ABS DELANTERO BMW E90 FREY,1453,8,3,8,19
34526764859,SENSOR DE FRENOS ABS TRASERO BMW E90 BMTR,1677,0,7,5,12
34526764859 *1,SENSOR FRENOS ABS TRASERO BMW E90 (FREY),1320,2,8,5,15
34526771700,SENSOR DE FRENOS ABS DELANTERO BMW E60 / N52  ( BMTR ),1972,7,2,8,17
34526771700 *1,SENSOR FRENOS ABS DELANTERO (L/R) BMW E60 E61 (FREY),1509,6,8,1,15
34526771702,SENSOR DE FRENOS ABS DELANTERO BMW E60 / M54 / N52 / N62   BMTR,1642,2,0,2,4
34526771702 *1,SENSOR DE FRENOS ABS DELANTERO BMW E60 / M54 / N52 / N62 FREY,1986,9,6,8,23
34526771703,SENSOR DE FRENOS ABS TRASERO BMW E60 M54-N52-N62 BMTR,1752,7,6,3,16
34526771703 *1,SENSOR DE FRENOS ABS TRASERO BMW E60 M54-N52-N62 FREY,1935,8,2,7,17
34526771704 *1,SENSOR ABS FRENOS DELANTEROS (L/R) BMW E53 (FREY),1375,1,1,6,8
34526771704-1,SENSOR DE FRENOS ABS DELANTERO BMW E53 / M54 ( FEBI ),1989,7,6,6,19
34526771705 *1,SENSOR DE FRENOS ABS TRASERO BMW E53  FREY,1271,8,2,8,18
34526771776,SENSOR DE VELOCIDAD ABS BMW F16 TOPRAN,1601,5,6,8,19
34526771776 *1,SENSOR DE VELOCIDAD ABS BMW F16 (FREY),1689,6,0,3,9
34526771777,SENSOR DE FRENOS ABS TRASERO BMW E70 ( BMTR ),1653,2,0,8,10
34526771777 *1,SENSOR DE FRENOS ABS TRASERO BMW E70 FREY,1526,3,4,2,9
34526775864 *1,SENSOR FRENOS ABS DELANTERO (L/R) BMW F01 F02 F03 F04 (FREY),1231,7,0,3,10
34526775864 *9,SENSOR DE FRENOS ABS DELANTERO BMW F02 BMTR,1323,8,2,4,14
34526784766,MODULO DE ABS BMW E90 SEMINUEVO (GENUINO),1762,5,4,5,14
34526784901,SENSOR DE FRENOS ABS TRASERO BMW F10 BMTR,1687,7,6,3,16
34526784901 *1,SENSOR DE FRENOS ABS TRASERO BMW F10 FREY,1562,5,8,8,21
34526784902,SENSOR DE FRENOS ABS DELANTERO BMW F10 BMTR,1853,1,9,2,12
34526784902-1,SENSOR DE FRENOS ABS DELANTERO BMW F10 FREY,1852,3,5,7,15
34526784989 *1,SENSOR ABS FRENOS DELANTEROS (L/R) 620 MM BMW E84 (FREY),1992,0,1,9,10
34526785020-9,SENSOR DE FRENOS ABS DELANTERO BMW E90 N52-N54-N55 TOPRAN,1366,8,9,9,26
34526791223,SENSOR DE FRENOS ABS DELANTERO BMW F30 BMTRS,1861,8,8,4,20
34526791223 *1,SENSOR DE FRENOS ABS DELANTERO BMW F30 FREY,1708,2,3,9,14
34526791223-3,SENSOR DE FRENOS ABS DELANTERO BMW F30 TOPRAN,1542,5,7,1,13
34526791748,SENSOR DE FRENOS ABS DELANTERO BMW F30 BMTR,1211,7,6,8,21
34526791748 *1,SENSOR DE FRENOS ABS DELANTERO BMW F30 ( FREY,1329,2,7,6,15
34526792896 *1,SENSOR FRENOS ABS DELANTERO (R) BMW E46 (FREY),1798,3,5,3,11
34526792896 *5,SENSOR FRENOS ABS DELANTERO (R) BMW E46 (DELPHI) SSF,1930,8,3,3,14
34526792897 *1,SENSOR FRENOS ABS DELANTERO (L) BMW E46 (FREY),1675,3,7,8,18
34526792897-9,SENSOR DE FRENOS ABS DELANTERO ( L ) BMW E46 ( ATE ),1967,8,4,7,19
34526851500 *1,SENSOR FRENOS ABS DELANTERO (L/R) MINI R55 R56 R57 R58 R59 (FREY),1324,3,0,1,4
34526851500-1,SENSOR DE FRENOS ABS DELANTERO ( L / R ) MINI R56 ( TOPRAN ),1871,4,9,2,15
34526851501 *5,SENSOR FRENOS ABS TRASERO (L/R) MINI R55 R56 R57 R58 R59 (BOSCH) SSF,1623,1,8,7,16
34526853859,SENSOR DE FRENOS ABS DELANTERO BMW F02 BMTRS,1205,8,9,7,24
34526853859 *1,SENSOR FRENOS ABS DELANTERO (L/R) BMW F02 F03 F06 F07 F10 F11 F12 (FREY),1322,2,0,4,6
34526858467 *1,SENSOR FRENOS ABS TRASERO (L/R) MINI F39 F45 F46  F48 F55 F56 F57 (FREY),1985,5,0,7,12
34526858468 *1,SENSOR ABS FRENOS DELANTEROS (L/R) MINI F55 F56 F57 (FREY),1306,2,3,5,10
34526858468 *2,SENSOR ABS FRENOS DELANTEROS (L/R) MINI F55 F56 F57 (EMBLER),1848,5,0,4,9
34526869292,SENSOR BALATAS FRENOS DELANTERO (L/R) BMW F25 F26 BMTR,1743,8,6,1,15
34526869292 *1,SENSOR ABS FRENOS DELANTERO (L/R) BMW F25 F26 (FREY),1535,1,1,4,6
34526869292-5,SENSOR ABS FRENOS DELANTERO (L/R) BMW F25 F26 TOPRAN,1765,5,5,0,10
34526869293,SENSOR DE FRENOS ABS TRASERO BMW F25 ( BMTR ),1474,0,6,1,7
34526869293 *1,SENSOR FRENOS ABS TRASEROS (L/R) 653 MM BMW F25 F26 (FREY),1568,5,3,4,12
34526869320,SENSOR DE FRENOS ABS DELANTERO BMW F30 (BMTRS),1478,8,7,2,17
34526869320 *1,SENSOR DE FRENOS ABS DELANTERO BMW F30 ( FREY ),1202,9,0,2,11
34526869322,SENSOR DE FRENOS ABS TRASERO BMW F30 BMTR,1362,3,7,2,12
34526869322 *1,SENSOR DE FRENOS ABS TRASERO BMW F30  ( FREY ),1637,5,8,8,21
34526869322-2,SENSOR DE FRENOS ABS TRASERO BMW F30 VEMO,1705,9,9,8,26
34526869322-9,SENSOR DE FRENOS ABS TRASERO BMW F30 ATE,1498,5,6,8,19
34526870075 *1,SENSOR FRENOS ABS DELANTERO (L/R) 660 MM BMW E81 E90 (FREY),1514,3,4,0,7
34526870075-100,SENSOR DE FRENOS ABS DELANTERO BMW E90-N52 INACTIVO,1698,8,3,3,14
34526870075-7,SENSOR DE FRENOS ABS DELANTERO BMW E90-N52 BAMPIC,1950,5,2,4,11
34526870076,SENSOR DE FRENOS ABS TRASERO BMW E90-N52 ATE,1457,4,4,2,10
34526870076 *1,SENSOR ABS FRENOS TRASERO (L/R) BMW E81 E87 E82 E90 (FREY),1454,4,5,9,18
34526870076-3,SENSOR DE FRENOS ABS TRASERO BMW E90-N52 TOPRAN,1961,2,8,0,10
34526870077,SENSOR DE FRENOS ABS TRASERO BMW E90 BMTRS,1856,1,9,0,10
34526870077-1,SENSOR DE FRENOS ABS TRASERO BMW E90  (FREY ),1491,3,6,9,18
34526870077-2,SENSOR DE FRENOS ABS TRASERO BMW E90 BREMI,1223,3,3,8,14
34526880757 *2,SENSOR ABS FRENOS TRASERO (L/R) BMW F39 F45 F46 F48 F54-F60 (EMBLER),1331,0,4,5,9
34526884421 *1,SENSOR FRENOS ABS TRASERO (L/R) 802 MM BMW F20 F22 F30 F32 (FREY),1806,7,1,2,10
34526884421 *9,SENSOR DE FRENOS ABS TRASERO BMW F20 F30 F32 (BAMPIC),1322,5,8,9,22
34526884421-100,SENSOR DE FRENOS ABS TRASERO BMW F30 TOPRAN INACTIVO,1733,5,9,5,19
34526895657 *1,SENSOR ABS FRENOS DELANTERO (L/R) BMW F97 F98 G01 G02 (FREY),1267,4,3,4,11
346752683-100,SENSOR DE FRENOS ABS TRASERO L-R CUADRADO INACTIVO,1693,5,3,8,16
35-114062 *5,AMORTIGUADOR AIRE SUSPENSION DELANTERA (L/R) BMW E39 (BILSTEIN) SSF,1560,0,8,8,16
35178573 *3,FILTRO ACEITE MOTOR VOLVO (MAHLE OC204),1314,0,0,4,4
35426853178,MODULO DE PEDAL ACELERADOR CAMBIO AUTOMATICO SEMINUEVO MINI R56 ( HELLA ),1870,4,7,4,15
35427018,SENSOR DE OXIGENO MERCEDES W204 ( ORIGINAL ),1683,3,6,4,13
357919369F,SENSOR DE TEMPERATURA DE RADIADOR AUDI A6 GENUINO,1924,9,9,6,24
36000378 *5,RADIADOR ENFRIAMIENTO MOTOR VOLVO C30 C70 S40 V50 MOTOR T5 (NISSEN) SSF,1217,9,4,9,22
36000448,FLECHA HOMOCINETICA LADO RUEDA VOLVO S40 ( LUZAN,1471,5,4,7,16
36106856227 *1,SENSOR PRESION NEUMATICOS BMW E88 E90 F07 F06 E84 F25 F26 E70 E71 E89 (FREY),1644,1,1,0,2
36106881890 *1,SENSOR DE PRESION NEUMATICO BMW F20 F22 F30 F32 F48 F15 F16 MINI (FREY),1428,6,1,2,9
36118009703 *3,RIN LLANTA TRASERO BMW F20 F21 F22 F23 (GENUINO),1467,9,3,1,13
36136783536,EMBLEMA DE RIN BMW E46 68 MM,1465,2,6,2,10
3690201 *5,BUJE DE SUSPENSION TRASERA BMW M54 (LEMFORDER) SSF,1701,7,4,8,19
37106781843 *B,BOLSA AIRE SUSPENSION TRASERA (L/R) BMW F7 F0 F11 (EMBLER) TECH,1656,7,7,9,23
37106854787 *5,AMORTIGUADOR SUSPENSION ELECTRONICA DELANTERA (L) MINI F55 F56 F57 (BILSTEIN) SSF,1568,1,2,2,5
37106854787 *A,AMORTIGUADOR CON SENSOR SUSPENSION DELANTERA (L) MINI F55 F56 (EMBLER) TECH,1431,5,7,0,12
37106854788 *5,AMORTIGUADOR SUSPENSION ELECTRONICA DELANTERA (R) MINI F55 F56 F57 (BILSTEIN) SSF,1625,8,4,8,20
37106854788 *A,AMORTIGUADOR CON SENSOR SUSPENSION DELANTERA (R) MINI F55 F56 (EMBLER) TECH,1823,6,6,9,21
37106861419 *2,AMORTIGUADOR CON SENSOR SUSPENSION DELANTERA (L) MINI F54 (EMBLER),1630,7,1,2,10
37106861420 *2,AMORTIGUADOR CON SENSOR SUSPENSION DELANTERA (R) MINI F54 (EMBLER),1223,9,6,4,19
37106864762 *A,AMORTIGUADOR CON SENSOR SUSPENSION TRASERA (L/R) BMW F55 F56 (EMBLER) TECH,1805,7,7,6,20
37106869031 *A,AMORTIGUADOR SUSPENSION DELANTERA (L) BMW G05 (EMBLER) TECH,1693,2,0,7,9
37106869035 *A,AMORTIGUADOR AIRE SUSPENSION DELANTERA (L) BMW G07 (EMBLER) TECH,1292,1,1,7,9
37106869036 *A,AMORTIGUADOR AIRE SUSPENSION DELANTERA (R) BMW G07 (EMBLER) TECH,1208,5,4,4,13
37106874593 *A,AMORTIGUADOR AIRE SUSPENSION TRASERA (L) BMW G11 G12 (EMBLER) TECH,1970,1,9,5,15
37106874594 *A ,AMORTIGUADOR AIRE SUPENSION TRASERA (R) BMW G11 G12 (EMBLER) TECH,1244,1,4,2,7
37106875083-100,AMORTIGUADOR DE AIRE SUSPENSION DELANTERA ( L ) BMW F15 ( EMBLER ) INACTIVO,1895,1,0,7,8
37106875087 *1,AMORTIGUADOR CON SENSOR SUSPENSION TRASERA (L) BMW F15 F16 (FREY),1417,0,0,3,3
37106875088 *1,AMORTIGUADOR CON SENSOR SUSPENSION TRASERA (R) BMW F15 F16 (FREY),1274,6,3,0,9
37106875089 *A,AMORTIGUADOR CON SENSOR SUSPENSION TRASERA  (L) BMW F15,1659,6,5,6,17
37106875090 *A,AMORTIGUADOR CON SENSOR SUSPENSION TRASERA  (R) BMW F15,1661,2,2,5,9
37106881599 *A,AMORTIGUADOR CON SENSOR SUSPENSION DELANTERA (L) BMW F48 F49 (EMBLER) TECH,1670,1,6,1,8
37106881600 *A,AMORTIGUADOR CON SENSOR SUSPENSION DELANTERA (R) BMW F48 F49 (EMBLER) TECH,1413,1,5,9,15
37106884554 *A,AMORTIGUADOR CON SENSOR SUSPENSION TRASERA (L/R) BMW X1 F48 (EMBLER) TECH,1637,5,3,3,11
37106887152 *A,AMORTIGUADOR CON SENSOR SUSPENSION TRASERA (L/R) BMW G01 G02 (EMBLER) TECH,1700,6,4,3,13
37106887157 *2,AMORTIGUADOR CON SENSOR SUSPENSION DELANTERA (L) BMW G01 G02 (EMBLER) TECH,1310,2,0,4,6
37106887158 *2,AMORTIGUADOR CON SENSOR SUSPENSION DELANTERA (R) BMW G01 G02 (EMBLER) TECH,1494,7,9,1,17
37106899037 *A,AMORTIGUADOR AIRE SUSPENSION DELANTERA (L) BMW G11 G12 (EMBLER) TECH,1246,6,0,2,8
37106899038 *A,AMORTIGUADOR AIRE SUSPENSION DELANTERA (R) BMW G11 G12 (EMBLER) TECH,1722,1,8,1,10
37116757501 *A,AMORTIGUADOR AIRE SUSPENSION DELANTERA (L) BMW E53 (EMBLER) TECH,1381,2,3,7,12
37116757501 *B,BOLSA AIRE SUSPENSION DELANTERA (L) BMW E53 N62 (EMBLER) TECH,1493,6,2,6,14
37116757502 *A,AMORTIGUADOR AIRE SUSPENSION DELANTERA (R) BMW E53 (EMBLER) TECH,1929,5,9,0,14
37116757502 *B,BOLSA AIRE SUSPENSION DELANTERA (R) BMW E53 (EMBLER) TECH,1494,0,9,1,10
37116757502 *K,PAR BOLSA AIRE SUSPENSION DELANTERA BMW E53 N62 (EMBLER),1614,4,0,1,5
37116771932-1,BUJE DE BARRA ESTABILIZADORA DELANTERA BMW E70 FREY,1239,3,2,1,6
37116771932-100,BUJE DE BARRA ESTABILIZADORA DELANTERA BMW E70 INACTIVO,1515,6,6,0,12
37116775205,BARRA ESTABILIZADORA DE SUSPENSION BMW F02 SEMINUEVA,1332,2,3,7,12
37116775205-1,BARRA ESTABILIZADORA DE SUSPENSION BMW F02 FREY,1667,5,9,9,23
37116797027 *A,AMORTIGUADOR CON SENSOR SUSPENSION DELANTERA (L) BMW F25 F26 (EMBLER) TECH,1265,1,3,5,9
37116797028 *A,AMORTIGUADOR CON SENSOR SUSPENSION DELANTERA (R) BMW F25 F26 (EMBLER) TECH,1406,2,9,8,19
37116863147 *A,AMORTIGUADOR CON SENSOR SUSPENSION DELANTERA (L) BMW F01 F02 F07 (EMBLER) TECH,1768,8,2,5,15
37116863148 *A,AMORTIGUADOR CON SENSOR SUSPENCION DELANTERA (R) BMW F01 F02 F07 (EMBLER) TECH,1351,4,8,6,18
37116863173 *1,AMORTIGUADOR CON SENSOR SUSPENSION DELANTERA (L) BMW F15 F16 (FREY),1829,0,9,6,15
37116863174 *1,AMORTIGUADOR CON SENSOR SUSPENSION DELANTERA (R) BMW F15 F16 (FREY),1400,0,4,2,6
37116865539 *A,AMORTIGUADOR CON SENSOR SUSPENSION DELANTERA (L) BMW F20 F21 F22 F23 F30 F33 (EMBLER) TECH,1685,7,4,4,15
37116865540 *A,AMORTIGUADOR CON SENSOR SUSPENSION DELANTERA (R) BMW BMW F20 F21 F22 F23 F30 F33 (EMBLER) TECH,1772,9,3,4,16
37116875083 *A,AMORTIGUADOR CON SENSOR SUSPENSION DELANTERA (L) BMW F15 F16 (EMBLER) TECH,1643,2,1,7,10
37116875083-101,AMORTIGUADOR DE SUSPENSION DELANTERA L BMW F15-N63N FREY INACTIVO,1799,5,5,3,13
37116875084 *A,AMORTIGUADOR CON SENSOR SUSPENSION DELANTERA (R) BMW F15 F16 (EMBLER) TECH,1483,7,6,4,17
37116875084-100,AMORTIGUADOR CON SENSOR SUSPENSION DELANTERA (R) BMW F15 (FREY) INACTIVO,1915,9,2,6,17
37126750355 *B,BOLSA AIRE SUSPENSION TRASERA (L) BMW X5 E53 (EMBLER) TECH,1811,8,5,1,14
37126750356 *B,BOLSA AIRE SUSPENSION TRASERA (R) BMW X5 E53 (EMBLER) TECH,1316,2,8,3,13
37126785535 *A,AMORTIGUADOR AIRE CON SENSOR SUSPENSION TRASERA (L) BMW E65 (EMBLER) TECH,1837,2,7,8,17
37126785536 *A,AMORTIGUADOR AIRE CON SENSOR SUSPENSION TRASERA (R) BMW E65 (EMBLER) TECH,1475,6,0,4,10
37126785537 *A,AMORTIGUADOR AIRE SIN SENSOR SUSPENSION TRASERA (L) BMW E65 (EMBLER) TECH,1930,7,3,5,15
37126785538 *A,AMORTIGUADOR AIRE SIN SENSOR SUSPENSION TRASERA (R) BMW E65 (EMBLER) TECH,1701,2,5,3,10
37126790078 *1,BOLSA AIRE SUSPENSION TRASERA (L/R) BMW E70 E71 F15 F16 (FREY),1944,2,6,7,15
37126790078 *B,BOLSA AIRE SUSPENSION TRASERA (L/R) BMW E70 E71 F15 (EMBLER) TECH,1749,5,1,6,12
37126795013-100,BOLSA AIRE SUSPENSION TRASERA (L/R) BMW E70 F15 INACTIVO,1781,7,4,3,14
37126796929 *A,AMORTIGUADOR AIRE SUSPENSION TRASERA (L) BMW F02 F04 (EMBLER) TECH,1751,7,0,8,15
37126796929 *B,BOLSA DE AIRE SUSPENSION TRASERA (L/R) BMW F02 F04 (EMBLER) TECH,1938,7,9,6,22
37126796930 *A,AMORTIGUADOR AIRE SUSPENSION TRASERA (R) BMW F02 F04 (EMBLER) TECH,1218,7,4,5,16
37126799911 *A,AMORTIGUADOR CON SENSOR SUSPENSION TRASERA (L/R) BMW F25 F26 (EMBLER) TECH,1984,0,0,9,9
37126865541 *A,AMORTIGUADOR CON SENSOR SUSPENSION TRASERA (L/R) BMW F20 F21 F22 (EMBLER) TECH,1848,2,6,1,9
37126874513 *A,AMORTIGUADOR CON SENSOR SUPENSION TRASERA (L/R) BMW F30 (EMBLER),1406,3,7,8,18
37142288993 *5,MODULO ELECTRONICO CONTROL SUSPENSION TRASERA SEMINUEVO BMW E39 E53 (GENUINO) EBY,1934,4,6,5,15
37146754921,SENSOR DE NIVEL SUSPENSIO AUTO NIVEL 2 EJES SIN XENON BMW E53-M54,1811,0,8,4,12
37146754921-1,SENSOR DE NIVEL SUSPENSIO AUTO NIVEL 2 EJES SIN XENON BMW E53-M54 FREY,1659,1,4,4,9
37146763733,BARRA ESTABILIZADORA DELANTERA BMW E90 ( FREY ),1838,4,0,0,4
37146784696,SENSOR DE NIVEL SUSPENSIï¿½N  AUTO NIVEL BMW E53 ( 2 EJES CON XENON BMTR ),1492,3,1,8,12
37146784696 *1,SENSOR DE NIVEL SUSPENSIï¿½N  AUTO NIVEL BMW E53 2 EJES CON XENON (FREY),1808,6,7,2,15
37146784697 *1,SENSOR NIVELADOR LUCES XENON TRASERO (L/R) BMW E39 E46 E53 E60 E83 E85 E89 (FREY),1588,6,1,7,14
37146852254,BARRA DE REGULACION DE SUSPENSION BMW F30 GENUINO,1941,5,2,0,7
37146852254-1,BARRA DE REGULACION DE SUSPENSION BMW F30 FREY,1520,7,7,8,22
37146853753 *1,SENSOR DE ALCANCE DE LUCES E60 E70 Y E90 (FREY),1322,8,6,5,19
37146853754 *1,SENSOR NIVELADOR LUCES DELANTERO (L/R) BMW E84 E90 E70 E71 (FREY),1756,2,2,4,8
37146860843,SENSOR DE NIVEL DE SUSPENSION BMW F30 ( GENUINO ),1633,6,1,1,8
37146860843-1,SENSOR DE NIVEL DE SUSPENSION BMW F30 FREY,1439,2,9,6,17
37206784137 *V,BLOQUE VALVULAS AIRE SUSPENSION BMW F01 F02 F04 (EMBLER) TECH,1491,0,5,5,10
37206789450 *C,COMPRESOR AIRE SUSPENSION BMW F10 F11 SERIE 5 (EMBLER) TECH,1606,7,6,0,13
37206789938-100,BLOQUE VALVULAS AIRE SUSPENSION BMW E70 (EMBLER).. CYS INACTIVO,1666,1,3,1,5
37206859714 *C,COMPRESOR SUSPENSION AIRE BMW E70 E71 X5 X6 (EMBLER) TECH,1872,5,3,3,11
37206859714 *V,BLOQUE VALVULAS AIRE SUSPENSION BMW E70 (EMBLER) TECH,1314,2,5,5,12
37206861882 *1,BLOQUE VALVULAS AIRE SUSPENSION BMW G11 G12 (FREY),1573,5,4,1,10
37206875176 *1,COMPRESOR AIRE BMW F10 F11 SERIE 5 (FREY),1890,0,8,3,11
37206875177 *1,COMPRESOR AIRE SUSPENSION BMW F15 F16 F85 F86 (FREY),1384,0,1,3,4
37206875177 *C,COMPRESOR AIRE SUSPENSION BMW F15 (EMBLER) TECH,1243,6,2,1,9
37226787616 *C,COMPRESOR AIRE 2 RUEDAS SUSPENSION TRASERASERA BMW E39 E53 E65 (EMBLER) TECH,1766,3,0,8,11
37226787617 *C,COMPRESOR AIRE 4 RUEDAS SUSPENSION BMW E53 (EMBLER) TECH,1864,3,0,1,4
376705431,DEPOSITO DE ANTICONGELANTE E39 BEHR,1704,2,2,4,8
376705431-101,DEPOSITO DE ANTICONGELANTE E39 FREY INACTIVO,1430,7,4,4,15
376726131,ENFRIADOR DE ACEITE DE MOTOR VOLVO S40-V40 BMTRS,1589,5,7,2,14
376924061,ENFRIADOR DE ACEITE DE MOTOR MERCEDES BENZ W204 C250-R172-SLK250 BMTRS,1311,2,6,7,15
3981000070,ACTUADOR ELECTRONICO DE CLUTCH SMART FORTWO COUPE SACHS,1212,5,8,7,20
3981000070-1,ACTUADOR ELECTRONICO DE CLUTCH SMART FORTWO COUPE FREY,1754,0,5,0,5
39970689,TOMA DE TUBO DE VENTILACION MERCEDES W203 / M271 ( FEBI ),1773,2,0,5,7
3AA698451B *3,BALATAS FRENOS TRASEROS VW TIGUAN (TRW GDB1763),1777,0,9,7,16
3AA698451B *5,BALATAS FRENOS TRASEROS 105.5 X 56.3 MM AUDI VW SEAT (FERODO) SSF,1715,5,3,6,14
3AA698451B *6,BALATAS FRENOS TRASEROS 105.5 X 56.3 MM AUDI VW SEAT (JURID) SSF,1505,9,2,6,17
3AA698451B *7,BALATAS FRENOS TRASEROS 105.5 X 56.3 MM AUDI VW SEAT (ATE) SSF,1328,7,7,1,15
3AA919051L,BOMBA DE GASOLINA VW PASSAT TM CONTINENTAL VDO,1509,0,2,8,10
3B0121321 *5,TAPON DEPOSITO ANTICONGELANTE MOTOR 1.5 BARES AUDI VW SEAT (FEBI) SSF,1685,1,5,7,13
3B0121321-1,TAPON DE DEPOSITO DE ANTICONGELANTE AUDI A4 ( AFTERMARKET ),1363,7,2,1,10
3B0121321-100,TAPON DE DEPOSITO DE ANTICONGELANTE AUDI A4 VIKA INACTIVO,1719,2,2,9,13
3B0121321-2,TAPON DE DEPOSITO DE ANTICONGELANTE AUDI A4 B6-B7-B8-B9 BORSEHUNG,1927,3,9,1,13
3B0121321-3,TAPON DE DEPOSITO DE ANTICONGELANTE AUDI A4 B6-B7-B8-B9 URO,1755,0,9,6,15
3B0121321-4,TAPON DE DEPOSITO DE ANTICONGELANTE AUDI A4 ( CRP ),1647,5,6,6,17
3B0121321-6,TAPON DE DEPOSITO ANTICONGELANTE AUDI A4 (EMBLER),1534,9,1,1,11
3B0512131H *3,GOMA REBOTE AMORTIGUADOR TRASERO (L/R) AUDI A4 A6 S4 VW (BRUCK GERMANY),1679,9,4,2,15
3C0129620 *3,FILTRO ENTRADA AIRE MOTOR AUDI A3 1.4 TSI (MAHLE LX1566),1413,3,9,8,20
3C0698151H *3,BALATAS  FRENOS DELANTEROS VW TIGUAN (TRW GDB1918),1666,6,6,9,21
3C0698451F-1,BALATAS FRENOS TRASEROS VW TIGUAN AKEBONO,1217,8,8,4,20
3C0907521F,RESISTENCIA DE AIRE ACONDICIONADO AUDI A3 / 2.0L ( GENUINO ),1269,2,0,3,5
3C0907521F-1,RESISTENCIA DE AIRE ACONDICIONADO SEMINUEVO AUDI A3 / 2.0L ( GENUINO ),1228,6,6,3,15
3C3Z6A642-CA,ENFRIADOR DE ACEITE DE MOTOR FORD F750 2004-2007 BMTRS,1770,8,3,7,18
3D0965561D *3,BOMBA AGUA AUXILIAR ELECTRICA ENFRIAMIENTO MOTOR AUDI SEAT PORSCHE VW  (VIKA),1898,3,6,5,14
3L1Z18124 *B,BOLSA AIRE SUSPENSION DELANTERA (L/R) NAVIGATOR EXPEDITION 2003 A 2006 (EMBLER) TECH,1694,8,0,5,13
3L1Z18124 *KB,PAR BOLSA AIRE SUSPENSION DELANTERA (L/R) LINCOLN NAVIGATOR FORD EXPEDITION (EMBLER),1967,8,6,5,19
3L1Z18124-100,AMORTIGUADOR AIRE ADS SUSPENSION DELANTERA (R) NAVIGATOR EXPEDITION 2003 A 2006 (EMBLER) CYS INACTIVO,1570,6,9,8,23
3L1Z18124-101,BOLSA AIRE b SUSPENSION DELANTERA (L/R) NAVIGATOR EXPEDITION 2003 A 2006 (EMBLER) CYS INACTIVO,1354,4,4,3,11
3L1Z18124CA *A,AMORTIGUADOR AIRE CON ADS SUSPENSION DELANTERA (L/R) NAVIGATOR EXPEDITION 2003 A 2006 (EMBLER) TECH,1325,4,0,0,4
3L1Z18125AB *A ,AMORTIGUADOR AIRE ADS SUSPENSION TRASERA (L/R) NAVIGATOR EXPEDITION 2003 A 2006 (EMBLER) TECH,1999,8,4,4,16
3L1Z18125ï¿½-100,AMORTIGUADOR AIRE ADS SUSPENSION TRASERA (L) NAVIGATOR EXPEDITION 2003 A 2006 (EMBLER) CYS INACTIVO,1286,0,2,3,5
3Q0698151H *5,BALATAS FRENOS DELANTEROS 175.2 X 69.5 MM AUDI VW SEAT (FERODO) SSF,1247,6,5,8,19
3Q0698151H *6,BALATAS FRENOS DELANTEROS 175.2 X 69.5 MM AUDI VW SEAT (JURID) SSF,1926,5,9,0,14
3Q0698451N *5,BALATAS FRENOS TRASEROS 123.8 X 56.2 MM AUDI VW SEAT (FERODO) SSF,1865,6,1,5,12
3U2Z-5580-AA *SB,SEGURO SUPERIOR BOLSA AIRE SUSPENSON TRASERA (L/R) LINCOLN TOWN CAR LIMOUSINE (EMBLER),1290,3,1,6,10
3U2Z-5580-FA *B,BOLSA AIRE SUSPENSION TRASERA (L/R) LINCOLN MARK VIII (EMBLER) TECH,1843,9,8,9,26
3U2Z-5580-GA *B,BOLSA AIRE SUSPENSION TRASERA (L/R) FORD WINDSTAR 1995 2003 (EMBLER) TECH,1411,3,8,5,16
3U2Z-5580-HA *B,BOLSA AIRE SUSPENSION TRASERA (R) LINCOLN CONTINENTAL (EMBLER) TECH,1521,7,6,0,13
3U2Z-5580-KA *B,BOLSA AIRE 4X2 SUSPENSION TRASERA (L/R) NAVIGATOR EXPEDITION 1997 A 2002 (EMBLER) TECH,1373,5,7,1,13
3U2Z-5580-LA *B,BOLSA AIRE 4X4 SUSPENSION TRASERA (L/R) LINCOLN NAVIGATOR FORD EXPEDITION (EMBLER) TECH,1556,5,4,0,9
3U2Z-5580-NA *B,BOLSA AIRE SUSPENSION TRASERA (L) LINCOLN CONTINENTAL (EMBLER) TECH,1582,5,5,2,12
3U2Z-5580-PA *B,BOLSA AIRE SUSPENSION TRASERA (L/R) TOWN CAR MARQUIS CROWN VICTORIA (EMBLER) TECH,1864,2,3,7,12
3U2Z-5580-PA_,BOLSA AIRE SUSPENSION TRASERA (L/R) LINCOLN TOWN CAR MARQUIS CROWN VICTORIA descontinuado,1511,8,2,6,16
3U2Z-5581-KA *B,/,1594,4,0,3,7
3U2Z5580GA-B,PAR BOLSAS DE AIRE SUSPENSION TRASERA ( L-R ) FORD WINDSTAR 1995-2003,1255,0,6,4,10
3W5616039 *A,AMORTIGUADOR SUSPENSION DELANTERA (L) BENTLEY (EMBLER) TECH,1549,9,2,4,15
3W5616040 *A,AMORTIGUADOR CON ADS SUSPENSION DELANTERO (R) BENTLEY (EMBLER) TECH,1232,6,5,3,14
3W5616040H *B,BOLSA AIRE SUSPENSION DELANTERO (R) BENTLEY (EMBLER) TECH,1875,0,4,6,10
3W839601AA,FILTRO ENTRADA AIRE MOTOR JAGUAR XJ8 4.0 SUPER MANN C31130,1258,3,9,2,14
407758600 *5,SELLO DE JUNTA DE ADMISION VOLVO S40 (  VICTOR REINZ ),1214,8,8,9,25
4091790026,PROPELA DE TURBO CARGADOR PERKIN VOLVO T04 DORMAN ALEMAN,1282,3,7,2,12
41530028,SENSOR DE ARBOL DE LEVAS MERCEDES W202 / M111 ( GENUINO ),1806,8,8,2,18
41536928,SENSOR DE ARBOL DE LEVAS MERCEDES W203 / M111 ( BOSCH ),1211,2,8,0,10
4155010015 *1,TAPON DEPOSITO ANTICONGELANTE ENFRIAMIENTO MOTOR 1.4 BARES MERCEDES W415 SMART W453 (FREY),1808,8,6,0,14
41612990344,AMORTIGUADOR COFRE FUERZA 450 NEWTONS 345 MM (L/R) BMW E84 STABILUS,1953,5,6,3,14
41612990344 *1,AMORTIGUADOR COFRE FUERZA 450 NEWTONS 345 MM (L/R) BMW E84 FREY,1586,5,6,4,15
41626801258,AMORTIGUADOR CAJUELA 330 NEWTONS 500 MM (L/R) MINI R53 STABILUS,1331,6,6,8,20
41626801258-1,AMORTIGUADOR CAJUELA 330 NEWTONS 500 MM (L/R) MINI R53 BAPMIC,1491,1,2,1,4
4204900,BALATAS FRENOS DELANTEROS MECEDES W205 GENUINA,1213,2,2,3,7
43201803,DISCO DURO,1513,0,0,2,2
43212200,MEMORIA RAM,1635,2,6,5,13
4420022067,BALATAS FRENOS DELANTEROS MERCEDES R170 W202-W210 BREMBO P50023N,1413,1,5,0,6
4420052067 *3,BALATAS FRENOS DELANTEROS MERCEDES W203 C230K (TRW GDB1454),1420,0,1,4,5
44206220,BALATAS FRENOS DELANTEROS MERCEDES W216-W221 PAGID T1454,1553,7,4,4,15
4472410313 *1,SOPORTE DE MOTOR (R) MERCEDES VITO W447 (FREY),1322,2,8,3,13
4472410413 *1,SOPORTE DE MOTOR ( L ) MERCEDES VITO W447 (FREY),1761,7,0,5,12
4473201500 *1,AMORTIGUADOR AIRE SUSPENSION DELANTERA (L/R) VITO W447 (FREY),1342,1,7,0,8
4473264200 *1,AMORTIGUADOR AIRE SUSPENSION TRASERA (L/R) MERCEDES VITO W447 (FREY),1973,4,6,1,11
4473301407 *1,HORQUILLA SUSPENSION DELANTERA (L) SPRINTER VITO W447 (FREY),1415,0,6,3,9
4473301507 *1,HORQUILLA SUSPENSION DELANTERA (R ) SPRINTER VITO W447 (FREY),1406,9,0,2,11
4474200320 *1,BALATAS FRENOS TRASEROS MERCEDES W447 W448 (FREY),1739,2,0,0,2
4479056802 *1,SENSOR FRENOS ABS RUEDA TRASERA (L/R) VITO VIANO W447 (FREY),1832,8,0,6,14
4479057002 *1 ,SENSOR FRENOS ABS RUEDA DELANTERA (L/R) VITI VIANO W447 (FREY),1337,8,4,0,12
4505000729,CPU EAGLE WARRIOR MOD CG-05R0,1376,3,2,9,14
4505010003 *1,DEPOSITO ANTICONGELANTE MOTOR SMART FORTWO W450 W451 (FREY),1761,9,4,2,15
4505010003 *2,DEPOSITO ANTICONGELANTE MOTOR SMART FORTWO W450 W451 (EMBLER),1568,0,5,7,12
4512400109,SOPORTE MOTOR CENTRAL SMART FORTWO W451   CORTECO,1392,0,7,9,16
4512500062 *2,CILINDRO DE CLUTCH ESCLAVO MERCEDES W451 (EMBLER),1311,0,5,3,8
4513300010 *1,HORQUILLA SUSPENSION DELANTERA (L/R) SMART W451 2007 A 2015 (FREY),1836,8,7,7,22
4514210010 *3,BALATAS FRENOS DELANTEROS SMART ROADSTER (TRW GDB1365),1889,7,7,5,19
4515400017 *1,SENSOR FRENOS ABS TRASERO (L) SMART FORTWO W451 2010 A 2015 (FREY),1945,0,4,7,11
4533230000 *1,AMORTIGUADOR SUSPENSION DELANTERA (L/ R) SMART W453 (FREY),1445,3,0,0,3
4533230000 *3,AMORTIGUADOR SUSPENSION DELANTERA (L/ R) SMART W453 (ALKO),1751,4,2,5,11
4533260500 *1,AMORTIGUADOR SUSPENSION TRASERA (L/R) SMART W453 (FREY),1696,7,5,9,21
4533302900 *1,HORQUILLA SUSPENSION DELANTERA (L) SMART W453 FORFOUR 2016 A 2018 (FREY),1263,1,2,9,12
4533303000 *1,HORQUILLA SUSPENSION DELANTERA (R) SMART W453 FORFOUR 2016 A 2018 (FREY),1806,6,7,7,20
4533560000 *1,BALERO MASA RUEDA TRASERA (L/R) SMART W453 (FREY),1562,7,0,9,16
4539055400 *1 ,SENSOR FRENOS ABS DELANTERO (L/R) SMART FORTWO W453 2016 A 2019 (FREY),1525,8,9,0,17
4539064300 *1,MOTOVENTILADOR ENFRIAMIENTO MOTOR SMART W453 (FREY),1366,7,4,9,20
4544201920 *1,BALATAS FRENOS DELANTEROS 72 X 130 SMART FORFOUR 2005-2007 (FREY),1379,9,2,9,20
4575902,BOMBA AGUA MECANICA ENFRIAMIENTO MOTOR LAND ROVER LR3 RANGE ROVER (AIRTEX),1205,0,0,7,7
4602406718 *1,SOPORTE MOTOR (L/R) MERCEDES W463 4.0L 5.0L 5.5L (FREY),1645,6,7,3,16
4602407018 *1,SOPORTE TRANSMISION TRASERO MERCEDES W463 4.0L 5.0L 5.5L (FREY),1781,6,8,1,15
4635132,AMORTIGUADOR DE DIRECCION MERCEDES W123 ORIGINAL,1581,9,2,0,11
4636807508 *1,PARRILA PANEL VENTILAS AIRE ACONDIONADO MERCEDES W463 (FREY),1311,1,3,2,6
4638300018 *3,FILTRO POLEN AIRE CABINA GOLF MOTOR 1.4 TURBO (MAHLE LA120),1684,1,4,0,5
4638300018 *5,FILTRO POLEN AIRE CABINA CARBON ACTIVADO GOLF MOTOR 1.4 TURBO (MAHLE LAK120),1856,8,0,2,10
4639800164 *1,SOPORTE DE ELEVACION MERCEDES BENZ W463 FREY,1581,5,6,2,13
4659605015,NUCLEO DE TURBO CARGADOR PERKIN VOLVO T04 DORMAN ALEMAN,1283,7,1,7,15
47107110670,ENGRANE MOTOR QUEMA COCOS HUMMER H3 H3T 2006 Al 2010 ( EMBLER ),1254,0,2,5,7
4744015,BOBINA DE IGNICION RANGE ROVER SPORT 1a GEN BREMI,1537,3,7,8,18
4877146AH-100,AMORTIGUADOR DE AIRE SUSPENSION DELANTERA  ( R ) DODGE RAM ( EMBLER ) CYS INACTIVO,1585,6,3,6,15
4877147AA *B,BOLSA AIRE SUSPENSION DELANTERA (L/R) DODGE RAM 1500 PICKUP (EMBLER),1605,2,2,8,12
4877147AB *A,AMORTIGUADOR AIRE SUSPENSION DELANTERA (L/R) DODGE RAM (EMBLER) TECH,1701,7,5,6,18
4B0121055J,MANGUERA INFERIOR DE RADIADOR AUDI A4 1.8L HUTCHINSON,1532,9,9,2,20
4B0407515,BUJE CHICO BRAZO SUPER A4 A6 CORTECO,1649,9,4,1,14
4B0601170A7ZJ,EMBLEMA DE RIN AUDI A3 GENUINO,1737,1,9,1,11
4B0698151AF *5,BALATAS FRENOS DELANTEROS 156.3 X 74.0 MM AUDI VW SEAT (JURID) SSF,1890,3,8,3,14
4B0819439C *5,FILTRO AIRE CABINA AUDI A4 (AIRMATIC) SSF,1837,6,7,5,18
4C3Z-9P456-AA,ENFRIADOR DE ACEITE DE MOTOR FORD F250 F350 F450 F550 DIESEL 6.0 BMTRS,1337,1,6,9,16
4C3Z9P456AJ,ENFRIADOR DE ACEITE DE MOTOR DISEL TURBO FORD F450 TAIFA,1812,4,3,0,7
4E0407181B,BUJE DE BRAZO INFERIOR DE SUSPENSION DELANTERA AUDI A4 TOPRAN,1226,9,6,5,20
4E0407181B *5,BUJE BRAZO INFERIOR DELANTERO AUDI A4 A5 A6 A8 Q5  (CORTECO) SSF,1657,4,3,7,14
4E0407181B *6,BUJE DE BRAZO INFERIOR DE SUSPENSION DELANTERA AUDI A4 (FEBI) SSF,1681,6,7,4,17
4E0407182C,BUJE DE BRAZO DE SUSPENSION DELANTERA AUDI A6 CORTECO,1856,5,9,5,19
4E0407183,BUJE BRAZO DELANTERO L-R AUDI A8 OPTIMAL,1764,4,9,7,20
4E0616001G *A,AMORTIGUADOR AIRE SUSPENSION TRASERA (L) AUDI A8 S8 CODIGO 4E 2003 A 2010 (EMBLER) TECH,1452,3,2,1,6
4E0616002G *A,AMORTIGUADOR AIRE SUSPENSION TRASERA (R) AUDI A8 S8 CODIGO 4E 2003 A 2010 (EMBLER) TECH,1659,9,5,9,23
4E0616005D *C,COMPRESOR AIRE SUSPENSION AUDI A8 S8 2004 A 2010 (EMBLER) TECH,1353,4,4,6,14
4E0616039AF *B,BOLSA AIRE SUSPENSION DELANTERA (L/R) AUDI A8 S8 AUDI A8 S8 CODIGO 4E 2002 A 2010 (EMBLER) TECH,1645,2,8,9,19
4E0616039T *A,AMORTIGUADOR AIRE SUSPENSION DELANTERA (L) AUDI A8 S8 D3 4E QUATTRO (EMBLER) TECH,1286,3,4,1,8
4E0616040T *A,AMORTIGUADOR AIRE SUSPENSION DELANTERA (R) AUDI A8 S8 D3 4E QUATTRO (EMBLER) TECH,1727,9,8,8,25
4E0698151F,BALATAS FRENOS A4 A6 A8 BREMBO,1258,7,2,9,18
4F0121055F,MANGUERA INFERIOR DE RADIADOR AUDI A6 GENUINA,1700,7,9,0,16
4F0121101F,MANGUERA SUPERIOR DE RADIADOR AUDI A6 REIN,1715,0,6,2,8
4F0121101F-1,MANGUERA SUPERIOR DE RADIADOR AUDI A6,1540,6,2,7,15
4F0121403M *5,DEPOSITO ANTICONGELANTE ENFRIAMIENTO MOTOR AUDI A6 2005 A 2011 4.2 L V8 (URO) SSF,1379,9,8,6,23
4F0121403N,DEPOSITO DE ANTICONGELANTE AUDI A6 3.2L BEHR,1564,8,5,0,13
4F0133843 *3,FILTRO ENTRADA AIRE MOTOR AUDI A5 3.2 L (MAHLE LX1006/2D),1918,8,9,2,19
4F0201511E,FILTRO COMBUSTIBLE GASOLINA AUDI A4 2.0-3.2L MANN WK720/4,1441,1,9,1,11
4F0201511E *3,FILTRO COMBUSTIBLE GASOLINA AUDI A4 A6 R8 RS4 S4 S8 (MAHLE KL571),1947,5,0,7,12
4F0399151AP,SOPORTE DE TRANSMISION AUDI A6 ( LEMFOERDER ),1588,6,7,9,22
4F0616001J *B,BOLSA AIRE SUSPENSION TRASERA (L/R) AUDI ALL ROAD QUATTRO AVANT A6 C6 (EMBLER) TECH,1323,5,0,8,13
4F0616005E *2,COMPRESOR AIRE SUSPENSION AUDI A6 2004  A 2011 (EMBLER) TECH,1853,9,8,8,25
4F0616039N *A,AMORTIGUADOR AIRE SUSPENSION DELANTERA (L) AUDI ALL ROAD QUATTRO AVANT A6 C6 (EMBLER) TECH,1915,6,8,6,20
4F0616040N *A,AMORTIGUADOR AIRE SUSPENSION DELANTERA (R) AUDI ALL ROAD QUATTRO AVANT A6 C6 (EMBLER) TECH,1956,2,8,1,11
4G0133843 *3,FILTRO ENTRADA AIRE MOTOR AUDI A6 TFS (MAHLE LX2049/4),1436,0,4,5,9
4G0199381QG *2,SOPORTE HIDRAULICO MOTOR (R) AUDI A6 2016-2018 (EMBLER) GOG,1931,7,9,5,21
4G0407689C *5,ROTULA INFERIOR SUSTENSION DELANTERO (R ) AUDI A4 A5 (DELPHI) SSF,1352,8,7,8,23
4G0413031N *3,AMORTIGUADOR AIRE SUSPENSION DELANTERA (L/R) AUDI A6 A7 2.0 3.0 (BILSTEIN),1828,3,7,4,14
4G0615121B *5,SENSOR FRENOS DELANTERO AUDI A4 A5 (FEBI) SSF,1856,0,1,9,10
4G0616039AL *A,AMORTIGUADOR AIRE SUSPENSION DELANTERA (L/R) AUDI A6 S6 C7 A7 4G A8 4H 2011 A 2018 (EMBLER) TECH,1827,4,5,2,11
4G0698151S *5,BALATAS FRENOS DELANTEROS 193.6 X 74.0 MM AUDI VW SEAT (FERODO) SSF,1538,7,5,6,18
4G0907397P,BALASTRA DE CONTROL DE LUZ XENON AUDI A3 KEBODA,1339,7,7,7,21
4G0907397P-1,BALASTRA DE CONTROL DE LUZ XENON SEMINUEVA AUDI A3 GENUINA,1676,4,5,9,18
4G0907697D *2,BALASTRA MODULO ELECTRONICO LUZ XENON AUDI VW (EMBLER) MLL,1726,3,6,8,17
4H0407183BB,BUJE BRAZO INFERIOR DELANTERO AUDI A6 OPTIMAL,1618,6,7,6,19
4H0498625,KIT DE BALERO AUDI Q5 VIKA,1694,0,0,9,9
4H0616002N *A,AMORTIGUADOR AIRE SUSPENCION TRASERA (R) AUDI A8 S8 CODIGO 4H 2010 A 2018 (EMBLER) TECH,1870,2,7,1,10
4H0616039D *A,AMORTIGUADOR AIRE CON SENSOR SUSPENSION DELANTERA (L/R) AUDI A6 A7 A8 S6 S8 2011 A 2018 (EMBLER) TECH,1785,4,6,7,17
4H0616040D *A1,AMORTIGUADOR AIRE SUSPENSION DELANTERA (L/R) AUDI A6 S6 C7 A7 4G A8 CODIGO 4H 2011 A 2018 (EMBLER) TECH,1288,6,1,2,9
4H0616040D *B,BOLSA AIRE SUSPENSION DELANTERA (L/R) PORSCHE AUDI A8 S8 (EMBLER) TECH,1680,4,8,3,15
4K0133844D *5,FILTRO ENTRADA AIRE MOTOR 91 X 179 MM AUDI A6 A7 S6 S7 (HENGST) SSF,1524,7,7,9,23
4L0616019 *A,AMORTIGUADOR AIRE SUSPENSION TRASERA (L) Q7 2007 A 2015 CAYENNE (9PA) 2003 A 2009 TOUAREG (L7) 2004 A 2009 (EMBLER) TECH,1941,1,9,3,13
4L0616020 *A,AMORTIGUADOR AIRE SUSPENSION TRASERA (R) Q7 2007 A 2015 CAYENNE (9PA) 2003 A 2009 TOUAREG (L7) 2004 A 2009 (EMBLER) TECH,1286,5,8,3,16
4L0698007 *C,COMPRESOR AIRE SUSPENSION AUDIO Q7 CAYENNE TUAREG 2003 A 2010 (EMBLER) TECH,1475,0,7,7,14
4L1Z5A891AA *B,BOLSA AIRE SUSPENSION TRASERA (L/R) NAVIGATOR EXPEDITION 2003 A 2006 (EMBLER) TECH,1413,3,8,0,11
4M0133843C *6,FILTRO ENTRADA AIRE MOTOR 250 MM AUDI Q7 2017 A 2023 2.0 3.0 (HENGST) SSF,1363,5,0,4,9
4M0133843G *3,FILTRO ENTRADA AIRE MOTOR B AUDI Q7 Q8 RS Q8 SQ7 SQ8 2019 A 2024 PORSCHE VW (MAHLE LX3295/8) DGO,1361,3,8,6,17
4M0407505B *5,BRAZO RECTO SUPERIOR DELANTERO SUSPENSION DELANTERA (L) AUDI A6 A7 Q5 Q6 Q7 Q8 (FEBI) SSF,1500,8,6,8,22
4M0407509B *5,BRAZO RECTO SUPERIOR TRASERO SUSPENSION DELANTERA (L) AUDI A6 A7 Q5 Q6 Q7 Q8 (FEBI) SSF,1353,5,4,9,18
4M0407693E *3,BRAZO CURVO SUSPENSION DELANTERA (L) AUDI A8 Q7 Q8 VW (VIKA),1495,2,4,3,9
4M0407694E *3,BRAZO CURVO SUSPENSION DELANTERA (R) AUDI A8 Q7 Q8 VW (VIKA),1494,1,5,1,7
4M0413031T *A,AMORTIGUADOR DE AIRE SUSPENSION DELANTERA (L/R) AUDI Q7 (EMBLER) TECH,1414,2,6,9,17
4M0616031S *A,AMORTIGUADOR AIRE CON ADS SUSPENSION TRASERA (L/R) AUDI Q7 2016 A 2022 (EMBLER) TECH,1945,8,4,4,16
4M0616039AC *A,AMORTIGUADOR AIRE SUSPENSION DELANTERA (L) AUDI Q7 2016 A 2020 (EMBLER) TECH,1318,6,8,2,16
4M0616040AC *A,AMORTIGUADOR AIRE SUSPENSIï¿½N DELANTERA (R) AUDI Q7 2016 A2022 (EMBLER) TECH,1271,8,6,8,22
4M0698151BJ *5,BALATAS FRENOS DELANTEROS 194.0 X 74.0 MM AUDI VW SEAT (FERODO) SSF,1684,0,1,2,3
4M0698151BJ *6,BALATAS FRENOS DELANTEROS 194.0 X 74.0 MM AUDI VW SEAT (BOSCH) SSF,1357,9,8,0,17
4M0698451BM *5,BALATAS FRENOS TRASEROS 129.3 X 64.7 MM AUDI VW SEAT (FERODO) SSF,1585,1,3,5,9
4M0819439B *5,FILTRO POLEN AIRE CABINA AUDI A4 A5 A6 A8 Q5 Q8 R5 R6 R7 S4 S5 S6 S7 (AIRMATIC ) SSF,1671,2,5,5,12
4PK863-100,BANDA ACCESORIOS MOTOR 4PK863 MM BMW M52 M54 (FREY) INACTIVO,1335,7,4,8,19
4Z7513031A,"AMORTIGUADOR  (C5 CHASSIS, TYP 4B)",1358,1,7,5,13
4Z7513032A,"AMORTIGUADOR AUDI A6 ALLROAD (C5 CHASSIS, TYP 4B)",1251,9,0,5,14
4Z7616-051D *B,BOLSA AIRE SUSPENSION DELANTERA (L) AUDI A6 (EMBLER) TECH,1484,4,1,4,9
4Z7616007A *C,COMPRESOR AIRE SUSPENSION AUDI ALL ROAD QUATTRO AVANT A6 C5 (EMBLER) TECH,1547,1,9,4,14
4Z7616051A *B ,BOLSA AIRE SUSPENSION TRASERA (L) AUDI ALL ROAD QUATTRO AVANT A6 C5 (EMBLER) TECH,1721,0,4,9,13
4Z7616051B *A,AMORTIGUADOR AIRE SUSPENSION DELANTERA (L/R) AUDI A6 C5 ALL ROAD QUATTRO AVANT (EMBLER) TECH,1420,9,8,9,26
4Z7616051D *B1,BOLSA AIRE SUSPENSION DELANTERA (L/R) AUDI ALL ROAD QUATTRO AVANT A6 C5 (EMBLER) TECH,1363,8,3,4,15
4Z7616052A *B,BOLSA AIRE SUSPENSION TRASERA (R) AUDI ALL ROAD QUATTRO AVANT A6 C5 (EMBLER) TECH,1432,1,2,7,10
5,RADIADOR DE MOTOR AUDI A4 2.0 TFSI ( REACH,1394,4,2,5,11
50014550,FILTRO ACEITE MOTOR LAND ROVER LR2 KS,1333,8,3,4,15
501213727,CONTROL ELECTRONICO POSICION BMW 525 530 535 545 550 SEMINUEVO GENUINO,1222,4,6,3,13
50906433,SENSOR DE CIGUEï¿½AL AUDI A4 / 1.8L ( FAE ),1984,3,1,3,7
5101122AA *1,SENSOR DE POSICIï¿½N ARBOL DE LEVAS (FREY),1539,6,0,4,10
51110051069 *4,DEFENSA DELANTERA BMW F48 (EMBLER) YIW,1804,1,1,4,6
51112990186 *4,SOPORTE PARACHOQUES DELANTERO BMW E84 (EMBLER) YIW,1648,6,1,8,15
51112990368 *4,REJILLA CENTRAL DEFENSA DELANTERA INFERIOR BMW E84 (EMBLER) YIW,1857,1,5,5,11
51112990641 *4,MOLDURA DECORATIVA DELANTERO BMW E84 (EMBLER) YIW,1692,9,5,4,18
51112991506 *4,PARRILLA DELANTERA CENTRAL INFERIOR BMW E84 (EMBLER) YIW,1395,9,4,1,14
51112993305 *4,PARRILLA SUPERIOR DELANTERO NEGRO (L) BMW E84 (EMBLER) YIW,1298,1,3,0,4
51112993306 *4,PARRILLA SUPERIOR DELANTERO NEGRO (R) BMW E84 (EMBLER) YIW,1935,4,6,2,12
51112993307 *4,PARRILLA SUPERIOR DELANTERO PLATEADA (L) BMW E84 (EMBLER) YIW,1672,9,6,9,24
51112993308 *4,PARRILLA SUPERIOR DELANTERO PLATEADA (R) BMW E84 (EMBLER) YIW,1230,7,9,3,19
51112993566 *4,DEFENSA DELANTERA BMW E84 (EMBLER) YIW,1624,6,4,0,10
51113420091 *4,PARRILLA DELANTERA (L) BMW E83 (EMBLER) YIW,1867,9,2,2,13
51113420092 *4,PARRILLA DELANTERA (R) BMW E83 (EMBLER) YIW,1357,6,6,4,16
51114824421 *4,SOPORTE FARO LUZ NIEBLA DELANTERA (L) MINI F55 F56 F57 (EMBLER) YIW,1409,8,8,4,20
51114824422 *4,SOPORTE FARO LUZ NIEBLA DELANTERA (R) MINI F55 F56 F57 (EMBLER) YIW,1942,6,7,3,16
51117117757,PARRILLA CROMADA CON FONDO NEGRO ( L ) BMW Z4  9 REJILLAS ( EMBLER ),1611,6,8,7,21
51117117758,PARRILLA CROMADA CON FONDO NEGRO ( R ) BMW Z4 9 REJILLAS  ( EMBLER ),1390,1,2,1,4
51117134074 *4,REJILLA CENTRAL DEFENSA INFERIOR DELANTERA BMW E90 (EMBLER) YIW,1831,7,3,8,18
51117134081 *4,REJILLA DE VENTILACION ANTINIEBLA DELANTERA (L) BMW E90 (EMBLER) YIW,1601,0,7,0,7
51117134082 *4,REJILLA DE VENTILACION ANTINIEBLA DELANTERA (R) BMW E90 (EMBLER) YIW,1657,7,5,7,19
51117134091 *4,MOLDURA DE REJILLA VENTILACION LATERAL DELANTERA (L) BMW E90 (EMBLER) YIW,1231,0,6,0,6
51117134092 *4,MOLDURA DE REJILLA VENTILACION LATERAL DELANTERA (R) BMW E90 (EMBLER) YIW,1605,1,4,8,13
51117134095 *4,MOLDURA DE REJILLA VENTILACION DELANTERA CORTA BMW E90 (EMBLER) YIW,1670,8,6,8,22
51117154714 *4,REJILLA DE VENTILACION DELANTERA BMW E92 E93 (EMBLER) YIW,1659,6,1,6,13
51117159593 *4,PARRILLA DELANTERA INFERIOR (L) BMW E70 2007 AL 2010 (EMBLER) YIW,1821,0,5,1,6
51117159594 *4,PARRILLA DELANTERA INFERIOR (R) BMW E70 2007 AL 2010 (EMBLER) YIW,1344,5,2,6,13
51117159595 *4,REJILLA PARRILLA DELANTERA (L) BMW E70 (EMBLER) YIW,1612,8,2,7,17
51117159596 *4,REJILLA PARRILLA DELANTERA (R) BMW E70 (EMBLER) YIW,1899,7,2,4,13
51117159597 *4,PARRILLA CENTRAL DELANTERO BMW E70 E71 (EMBLER) YIW,1349,9,5,2,16
51117163956 *4,REJILLA FACIA DELANTERA INFERIOR BMW E70 2007 AL 2010 (EMBLER) YIW,1958,1,5,1,7
51117171345 *4,PARRILLA DELANTERA INFERIOR BMW E70 (EMBLER) YIW,1754,4,6,7,17
51117172402 *4,DEFENSA DELANTERA BMW E70 2007 AL 2010 (EMBLER) YIW,1202,3,1,3,7
51117198899 *4,REJILLA DE VENTILACION DELANTERA (L) BMW E90 (EMBLER) YIW,1243,7,8,9,24
51117198900 *4,REJILLA DE VENTILACION DELANTERA (R) BMW E90 (EMBLER) YIW,1778,8,1,2,11
51117198901 *4,PARRILLA INFERIOR DELANTERO LUZ ANTINIEBLA (L) BMW E90 (EMBLER) YIW,1262,7,4,6,17
51117198902 *4,PARRILLA INFERIOR DELANTERO LUZ ANTINIEBLA (R) BMW E90 (EMBLER) YIW,1293,3,5,1,9
51117198906 *4,REJILLA CENTRAL ESTANDAR DEFENSA DELANTERA BMW E90 (EMBLER) YIW,1241,8,5,0,13
51117204242 *4,DEFENSA DELANTERA BMW E90 (EMBLER) YIW,1241,0,3,0,3
51117210465 *4,REJILLA INFERIOR DEFENSA DELANTERA BMW F25 (EMBLER) YIW,1420,7,7,2,16
51117210466 *4,PARRILLA CENTRAL SUPERIOR DELANTERA BMW F25 (EMBLER) YIW,1448,4,5,1,10
51117210469 *4,REJILLA DE VENTILACION DELANTERA TIENE AGUJERO (L) BMW F25 (EMBLER) YIW,1590,6,7,9,22
51117210470 *4,REJILLA DE VENTILACION DELANTERA TIENE AGUJERO (R) BMW F25 (EMBLER) YIW,1588,3,7,7,17
51117210725 *4,PARRILLA DELANTERA COLOR NEGRO (L) BMW F25 (EMBLER) YIW,1635,3,0,8,11
51117210726 *4,PARRILLA DELANTERA COLOR NEGRO (R) BMW F25 (EMBLER) YIW,1787,6,3,0,9
51117222382 *4,DEFENSA DELANTERA BMW E70 2011 AL 2013 (EMBLER) YIW,1378,7,4,5,16
51117222716 *4,DEFENSA DELANTERA DELANTERA BMW E70 2011 AL 2013 (EMBLER) YIW,1666,5,3,5,13
51117222856 *4,PARRILLA INFERIOR CENTRAL DELANTERA BMW E70 2011 AL 2013 (EMBLER) YIW,1242,4,5,2,11
51117222859 *4,REJILLA DE VENTILACION DELANTERA (L) BMW E70  2011 AL 2013 (EMBLER) YIW,1578,9,1,1,11
51117222860 *4,REJILLA DE VENTILACION DELANTERA (R) BMW E70 2011 AL 2013 (EMBLER) YIW,1676,6,6,5,17
51117227889 *4,PARRILLA INFERIOR CENTRAL DELANTERO BMW E90 E93 (EMBLER) YIW,1547,3,3,2,8
51117227947 *4,REJILLA LUZ ANTINIEBLA DELANTERO (L) BMW E90 E93 (EMBLER) YIW,1533,0,0,4,4
51117227948 *4,REJILLA LUZ ANTINIEBLA DELANTERO (R) BMW E90 E93 (EMBLER) YIW,1367,9,5,9,23
51117237421 *4,PARRILLA DELANTERA COLOR PLATEADO (L) BMW F25 (EMBLER) YIW,1253,1,0,5,6
51117237422 *4,PARRILLA DELANTERA COLOR PLATEADO (R) BMW F25 (EMBLER) YIW,1452,2,3,4,9
51117245733 *4,PARRILLA INFERIOR DELANTERO BMW F20 F21 (EMBLER) YIW,1558,4,6,2,12
51117248788 *4,MOLDURA INFERIOR DEFENSA DELANTERA MINI R56 (EMBLER) YIW,1997,3,2,4,9
51117249595 *4,REJILLA DE VENTILACION DELANTERA (L) BMW F25 (EMBLER) YIW,1684,3,3,3,9
51117249596 *4,REJILLA DE VENTILACION DELANTERA (R) BMW F25 (EMBLER) YIW,1617,0,3,3,6
51117250785 *4,REJILLA CENTRAL DEFENSA DELANTERA MINI COOPER R56 (EMBLER) YIW,1727,4,1,9,14
51117261188 *4,DEFENSA DELANTERA BMW F25 (EMBLER) YIW,1547,2,1,0,3
51117279699 *4,MOLDURA CENTRAL DELANTERO BMW F30 F31 (EMBLER) YIW,1849,6,8,0,14
51117279700 *4,MOLDURA DE VENTILACION DELANTERA CROMADA BMW F30 F31 (EMBLER) YIW,1556,8,8,5,21
51117284812 *4,REJILLA ENTRADA DE AIRE COFRE DELANTERO BMW F30 F31 (EMBLER) YIW,1840,3,3,5,11
51117292968 *4,DEFENSA DELANTERA BMW F20 (EMBLER) YIW,1662,0,1,1,2
51117292971 *4,FACIA DEFENSA DELANTERA BMW F20 (EMBLER) YIW,1742,8,8,2,18
51117294475 *4,REJILLA CENTRAL INFERIOR DEFENSA DELANTERA BMW F15 (EMBLER) YIW,1935,0,0,8,8
51117294476 *4,PARRILLA CENTRAL SUPERIOR DEFENSA DELANTERA BMW F15 (EMBLER) YIW,1803,3,6,2,11
51117301566 *4,REJILLA CENTRAL CERRADA DEFENSA DELANTERA BMW F45 (EMBLER) YIW,1338,9,6,5,20
51117301567 *4,REJILLA CENTRAL ABIERTA DEFENSA DELANTERA BMW F45 (EMBLER) YIW,1606,7,7,2,16
51117301622 *4,MOLDURA DEFENSA DELANTERA INFERIOR MINI F56 (EMBLER) YIW,1560,3,5,9,17
51117303107 *4,PARRILLA DELANTERA PLATEADA (L) BMW F15 (EMBLER) YIW,1609,1,9,5,15
51117303108 *4,PARRILLA DELANTERA PLATEADA (R) BMW F15 (EMBLER) YIW,1817,9,0,8,17
51117303752 *4,REJILLA CENTRAL DEFENSA DELANTERA BMW E84 (EMBLER) YIW,1755,0,0,5,5
51117303753 *4,REJILLA CENTRAL DEFENSA DELANTERA E84 (EMBLER) YIW,1715,0,0,8,8
51117303755 *4,REJILLA DE VENTILACION ABIERTA DELANTERA (R) BMW E84 (EMBLER) YIW,1898,8,6,4,18
51117303755C *4,REJILLA DE VENTILACION CERRADA DELANTERA (R) BMW E84 (EMBLER) YIW,1986,9,3,0,12
51117303756 *4,REJILLA DE VENTILACION ABIERTA DELANTERA (L) BMW E84 (EMBLER) YIW,1947,0,6,9,15
51117303756C *4,REJILLA DE VENTILACION CERRADA DELANTERA (L) BMW E84 (EMBLER) YIW,1582,1,2,5,8
51117303757 *4,REJILLA DE VENTILACION DELANTERA CERRADA (L) BMW E84 (EMBLER) YIW,1470,4,9,4,17
51117303758 *4,REJILLA DE VENTILACION DELANTERA ABIERTA (R) BMW E84 (EMBLER) YIW,1905,8,3,7,18
51117303759 *4,MOLDURA DE VENTILACION DELANTERA BMW E84 (EMBLER) YIW,1216,9,3,5,17
51117303763 *4,CUBIERTA DE REJILLA VENTILACION DELANTERA LATERAL (L) BMW E84 (EMBLER) YIW,1818,1,8,5,14
51117303764 *4,CUBIERTA DE REJILLA VENTILACION DELANTERA LATERAL (R) BMW E84 (EMBLER) YIW,1471,3,2,7,12
51117308016 *4,ALERON INFERIOR DELANTERO BMW F15 (EMBLER) YIW,1791,3,6,0,9
51117317264 *4,PARRILLA DELANTERA COFRE CROMO MINI COOPER R56 (EMBLER) YIW,1979,9,6,8,23
51117337791 *4,MOLDURA INFERIOR DEFENSA DELANTERA MINI F55 F56 F57 (EMBLER) YIW,1944,4,9,6,19
51117337793 *4,REJILLA CENTRAL DEFENSA DELANTERA MINI COOPER F56 (EMBLER) YIW,1693,0,2,9,11
51117338491 *4,PARRILLA DELANTERA CENTRAL INFERIOR BMW F25 (EMBLER) YIW,1256,0,4,6,10
51117338571 *4,PARRILLA DELANTERA (L) BMW F25 F26 (EMBLER) YIW,1810,8,6,7,21
51117338572 *4,PARRILLA DELANTERA (R) BMW F25 F26 (EMBLER) YIW,1939,8,5,5,18
51117347945 *4,REJILLA DE VENTILACION EXTERIOR DELANTERA (L) BMW F25 (EMBLER) YIW,1255,6,0,3,9
51117347946 *4,REJILLA DE VENTILACION EXTERIOR DELANTERA (R) BMW F25 (EMBLER) YIW,1320,1,2,5,8
51117354773 *4,CUBIERTA DE REJILLA VENTILACION DELANTERA LATERAL BMW F48 F49 (EMBLER) YIW,1716,0,1,6,7
51117371726 *4,MOLDURA FACIA DELANTERA BMW F20 F21 (EMBLER) YIW,1935,5,6,9,20
51117371737 *4,PARRILLA CENTRAL DELANTERO BMW F20 F21 (EMBLER) YIW,1674,0,0,7,7
51117374051 *4,REJILLA DELANTERA BMW E84 (EMBLER) YIW,1315,5,2,5,12
51117379432 *4,DEFENSA DELANTERA MINI COOPER F55 F56 (EMBLER) YIW,1578,5,0,9,14
51117383353 *4,REJILLA CENTRAL DEFENSA DELANTERA BMW F48 F49 (EMBLER) YIW,1792,8,3,1,12
51117383363 *4,PARRILLA DELANTERO NEGRO CROMADO (L) BMW F48 (EMBLER) YIW,1693,0,7,4,11
51117383364 *4,PARRILLA DELANTERO NEGRO CROMADO (R) BMW F48 (EMBLER) YIW,1440,4,2,6,12
51117386155 *4,PARRILLA DELANTERA CENTRAL COFRE BMW F35 (EMBLER) YIW,1910,0,5,7,12
51117397626 *4,PARRILLA DELANTERA COFRE BMW F35 (EMBLER) YIW,1561,8,0,0,8
51117404171 *4,REJILLA CENTRAL DEFENSA DELANTERA BMW F52 (EMBLER) YIW,1817,6,6,6,18
51117404174 *4,REJILLA CENTRAL DEFENSA DELANTERA NEGRA BMW F52 (EMBLER) YIW,1832,4,4,0,8
51117419730 *4,CUBIERTA FACIA DELANTERA INFERIOR BMW F48 (EMBLER) YIW,1643,3,0,1,4
51117464205 *4,REJILLA DE VENTILACION DELANTERA CERRADA (L) BMW G20 G21 (EMBLER) YIW,1621,4,8,3,15
51117464206 *4,REJILLA DE VENTILACION DELANTERA CERRADA (R) BMW G20 G21 (EMBLER) YIW,1702,4,7,0,11
51117471521 *4,REJILLA DE VENTILACION DELANTERA (L) BMW G20 G21 (EMBLER) YIW,1608,0,2,7,9
51117471522 *4,REJILLA DE VENTILACION DELANTERA (R) BMW G20 G21 (EMBLER) YIW,1916,1,2,9,12
51117471523 *4,REJILLA DE VENTILACION DELANTERA CORTA BAJA (L) BMW G20 G21 (EMBLER) YIW,1215,3,0,9,12
51117471524 *4,REJILLA DE VENTILACION DELANTERA CORTA BAJA (R) BMW G20 G21 (EMBLER) YIW,1612,4,5,2,11
51118047365 *4,REJILLA CENTRAL DEFENSA DELANTERA BMW E90 (EMBLER) YIW,1663,4,3,0,7
51118089752 *4,REJILLA CENTRAL DEFENSA DELANTERA CON AGUJERO BMW G08 (EMBLER) YIW,1914,7,9,9,25
51118099656 *4,REJILLA DE VENTILACION DELANTERA BMW G05 (EMBLER) YIW,1799,2,6,3,11
51119449406 *4,REJILLA CENTRAL DEFENSA DELANTERA BMW G20 G21 (EMBLER) YIW,1227,4,4,9,17
51119449408 *4,REJILLA CENTRAL DEFENSA DELANTERA CON AGUJEROS BMW G20 G21 (EMBLER) YIW,1764,2,6,3,11
51119449409 *4,MOLDURA DEFENSA DELANTERA BMW G20 G21 (EMBLER) YIW,1289,8,1,5,14
51119451705 *4,REJILLA DE VENTILACION DELANTERA BMW F49 (EMBLER) YIW,1942,9,9,0,18
51119477635 *4,TOLVA CENTRAL DEFENSA DELANTERA BMW G08 (EMBLER) YIW,1763,3,7,9,19
51119477653 *4,REJILLA CENTRAL DEFENSA DELANTERA BMW G08 (EMBLER) YIW,1291,8,1,1,10
51120051082 *4,PARACHOQUES TRASERO BMW F48 F49 (EMBLER) YIW,1765,5,5,4,14
51120051085 *4,MOLDURA INFERIOR PARACHOQUES TRASERO BMW F48 F49 (EMBLER) YIW,1383,7,0,4,11
51120051087 *4,TABLERO PARACHOQUES TRASERO BMW F48 F49 (EMBLER) YIW,1278,8,5,0,13
51120051088 *4,TABLERO DE PARACHOQUES TRASERO INFERIOR UN AGUJERO BMW F48 F49 (EMBLER) YIW,1370,8,1,7,16
51120051089 *4,TABLERO DE PARACHOQUES TRASERO BMW F48 F49 (EMBLER) YIW,1266,6,8,2,16
51120051090 *4,TABLERO DE PARACHOQUES TRASERO DOS AGUJEROS BMW F48 F49 (EMBLER) YIW,1558,7,2,5,14
51127178280 *4,DEFENSA TRASERA BMW E70 (EMBLER) YIW,1410,2,6,6,14
51127227841 *4,ALERON TRASERO BMW E70 (EMBLER) YIW,1824,6,8,7,21
51127289756 *4,MOLDURA CENTRAL TRASERA BMW F30 F31 (EMBLER) YIW,1432,8,6,6,20
51127294756 *4,ALERON INFERIOR TRASERO BMW F15 (EMBLER) YIW,1374,6,8,6,20
51127338792 *4,TABLERO DE PARACHOQUES TRASERO BMW F25 F26 (EMBLER) YIW,1483,8,6,8,22
51127371758 *4,MOLDURA FACIA TRASERA BMW F20 F21 (EMBLER) YIW,1643,7,6,3,16
51127379982 *4,MOLDURA FACIA TRASERA BMW F48 (EMBLER) YIW,1777,2,5,2,9
51127407088 *4,TIRA DECORATIVA COLOR NEGRO TRASERA BMW F52 (EMBLER) YIW,1299,0,9,7,16
51127407089 *4,TIRA DECORATIVA PARACHOQUES BMW F52 (EMBLER) YIW,1934,4,9,2,15
51127413497 *4,MOLDURA DE PARACHOQUES TRASERO BMW F25 (EMBLER) YIW,1727,0,8,4,12
51127463621 *4,REJILLA DE VENTILACION TRASERA (L) BMW G20 G21 (EMBLER) YIW,1980,7,5,2,14
51127463622 *4,REJILLA DE VENTILACION TRASERA (R) BMW G20 G21 (EMBLER) YIW,1729,1,3,2,6
51127488349 *4,PROTECTOR PARA PARACHOQUES CORTO ALTO (L) BMW G20 (EMBLER) YIW,1306,9,3,7,19
51127488350 *4,PROTECTOR PARA PARACHOQUES CORTO ALTO (R) BMW G20 (EMBLER) YIW,1572,2,7,3,12
51127488351 *4,MOLDURA DE REJILLA TRASERA BAJA (L) BMW G20 (EMBLER) YIW,1962,7,4,9,20
51127488352 *4,MOLDURA DE REJILLA TRASERA BAJA (R) BMW G20 (EMBLER) YIW,1353,0,4,2,6
51127498523 *4,CANTONERA SALPICADERA DELANTERA  BMW G08 (EMBLER) YIW,1262,2,2,5,9
51127498523B,TIRA DE PARACHOQUES TRASERO NEGRO BMW G08 (EMBLER) YIW,1700,8,8,2,18
51128075077 *4,PROTECCION INFERIOR TRASERA BMW F30 F31 (EMBLER) YIW,1755,5,9,4,18
51128075714 *4,ALERON PARACHOQUES TRASERO INFERIOR BMW G20 G21 (EMBLER) YIW,1936,9,3,4,16
51128499218 *4,ALERON DE PARACHOQUES TRASERO BMW G20 G21 (EMBLER) YIW,1923,2,2,6,10
51135A1AC59 *4,PARRILLA CROMADA CON FONDO NEGRO SIN AGUJEROS DELANTERO BMW G08 (EMBLER) YIW,1610,1,8,8,17
51135A1AC60 *4,PARRILLA CROMADA CON FONDO NEGRO CON AGUJEROS DELANTERO BMW G08 (EMBLER) YIW,1752,0,4,1,5
51135A20762 *4,PARRILLA DELANTERA SUPERIOR RADIADOR BMW G08 (EMBLER) YIW,1484,5,0,5,10
51135A20763 *4,PARRILLA DELANTERA SUPERIOR BMW G08 (EMBLER) YIW,1950,9,3,9,21
51137042961,PARRILLA COFRE L BMW E46,1642,9,1,5,15
51137042962,PARRILLA COFRE R BMW E46,1278,7,7,2,16
51137113733 *4,REJILLA DELANTERA NEGRA (L) BMW E53 (EMBLER) YIW,1927,7,2,7,16
51137113734 *4,REJILLA DELANTERA NEGRA (R) BMW E53 (EMBLER) YIW,1274,3,2,1,6
51137117241 *4,REJILLA CORTA (L) BMW E90 (EMBLER) YIW,1766,9,3,1,13
51137117242 *4,REJILLA CORTA (R) BMW E90 (EMBLER) YIW,1976,7,8,2,17
51137120007,PARRILLA NEGRA ( L ) BMW E90 335i ( 11 REJILLAS ),1676,8,1,9,18
51137120007 *4,PARRILLA COFRE DELANTERA CROMADA (L) BMW E90 (EMBLER) YIW,1465,7,9,1,17
51137120008,PARRILLA NEGRA ( R ) BMW E90 335i ( 11 REJILLAS ),1476,5,3,0,8
51137120008 *4,PARRILLA COFRE DELANTERA CROMADA (R) BMW E90 (EMBLER) YIW,1803,5,9,6,20
51137124815,PARRILLA NEGRA ( L ) BMW E53 ( 7 REJILLAS ),1758,1,5,3,9
51137124815 *4,PARRILLA DELANTERA COLOR PLATEADO (L) BMW E53 (EMBLER) YIW,1532,5,8,6,19
51137124816,PARRILLA NEGRA ( R ) BMW E53 ( 7 REJILLAS ),1316,9,4,3,16
51137124816 *4,PARRILLA DELANTERA COLOR PLATEADO (R) BMW E53 (EMBLER) YIW,1317,8,6,2,16
51137149905 *4,MOLDURA BICEL CROMADO FARO LUZ DELANTERA (L) MINI R55 R56 R57 R58 R59 (EMBLER) YIW,1242,3,5,7,15
51137149905B,MOLDURA BICEL PIANO BLACK FARO LUZ DELANTERA (L) MINI R55 R56 R57 R58 R59 (EMBLER) YIW,1748,3,0,7,10
51137149906 *4,MOLDURA BICEL CROMADO FARO LUZ DELANTERA (R) MINI R55 R56 R57 R58 R59 (EMBLER) YIW,1431,6,1,2,9
51137149906B,MOLDURA BICEL PIANO BLACK FARO LIZ DELANTERA (R) MINI R55 R56 R57 R58 R59 (EMBLER) YIW,1567,0,3,5,8
"51137157275
 *4",PARRILLA DELANTERA COLOR NEGRO CROMADA (L) BMW E92 E93 (EMBLER) YIW,1726,8,0,0,8
51137157275 *4,PARRILLA DELANTERA COLOR NEGRO CROMADA (L) BMW E90 E91 E93 (EMBLER) YIW,1852,0,8,1,9
51137157276 *4,PARRILLA DELANTERA COLOR NEGRO CROMADA (R) BMW E90 E91 E93 (EMBLER) YIW,1462,1,2,5,8
51137157687,PARRILLA DE COFRE ( L ) BMW E70 ( NEGRO / CROMO ),1331,0,5,7,12
51137157687 *4,PARRILLA DELANTERA COLOR NEGRO (L) BMW E70 E71 (EMBLER) YIW,1813,5,4,5,14
51137157688,PARRILLA DE COFRE ( R ) BMW E70 ( NEGRO / CROMO ),1908,7,7,2,16
51137157688 *4,PARRILLA DELANTERA COLOR NEGRO (R) BMW E70 E71 (EMBLER) YIW,1212,4,4,1,9
51137185223 *4,PARRILLA DELANTERA COLOR PLATEADO (L) BMW E70 E71 (EMBLER) YIW,1699,4,1,3,8
51137185224 *4,PARRILLA DELANTERA COLOR PLATEADO (R) BMW E70 E71 (EMBLER) YIW,1648,9,7,5,21
51137201967,PARRILLA NEGRA ( L ) BMW E90 325i ( 12 REJILLAS ),1668,3,4,6,13
51137201967 *4,PARRILLA DELANTERA NEGRA CROMADA (L) BMW E90 (EMBLER) YIW,1776,6,8,0,14
51137201968 *4,PARRILLA DELANTERA NEGRA CROMADA (R) BMW E90 (EMBLER) YIW,1967,0,2,9,11
51137201969,PARRILLA CROMADA CON FONDO NEGRO ( L ) BMW E90 325i ( 12 REJILLAS ),1723,0,6,9,15
51137239021 *4,PARRILLA RIï¿½ONERA DELANTERA (L) BMW F20 (EMBLER) YIW,1478,3,4,2,9
51137239022 *4,PARRILLA RIï¿½ONERA DELANTERA (R) BMW F20 (EMBLER) YIW,1299,4,5,6,15
51137254967 *4,PARRILLA CON MARCO CROMADO DELANTERO (L) BMW E90 E93 (EMBLER) YIW,1739,8,2,9,19
51137254968 *4,PARRILLA CON MARCO CROMADO DELANTERO (R) BMW E90 E93 (EMBLER) YIW,1741,8,5,4,17
51137255411 *4,PARRILLA RIï¿½ONERA DELANTERA (L) BMW F30 F31 (EMBLER) YIW,1219,5,3,4,12
51137255412 *4,PARRILLA RIï¿½ONERA DELANTERA (R) BMW F30 F31 (EMBLER) YIW,1209,5,2,5,12
51137260497 *4,REJILLA RIï¿½ONERA DELANTERA (L) BMW F30 F31 (EMBLER) YIW,1938,4,7,3,14
51137260498 *4,REJILLA RIï¿½ONERA DELANTERA (R) BMW F30 F31 (EMBLER) YIW,1947,9,4,8,21
51137262117 *4,PARRILLA DELANTERA COLOR NEGRO (L) BMW F20 (EMBLER) YIW,1487,0,2,6,8
51137262118 *4,PARRILLA DELANTERA COLOR NEGRO (R) BMW F20 (EMBLER) YIW,1644,5,7,7,19
51137262119 *4,PARRILLA DELANTERA (L) BMW F20 F21 (EMBLER) YIW,1846,8,9,5,22
51137262120 *4,PARRILLA DELANTERA (R) BMW F20 F21 (EMBLER) YIW,1863,1,2,8,11
51137294485 *4,PARRILLA SUPERIOR DELANTERA (L) BMW F15 (EMBLER) YIW,1895,9,1,2,12
51137294486 *4,PARRILLA SUPERIOR DELANTERA (R) BMW F15 (EMBLER) YIW,1783,3,7,1,11
51137300543 *4,PARRILLA DELANTERO NEGRO BRILLANTE (L) BMW F45 F46 (EMBLER) YIW,1507,7,8,5,20
51137300544 *4,PARRILLA DELANTERO NEGRO BRILLANTE (R) BMW F45 F46 (EMBLER) YIW,1440,7,7,1,15
51137300586 *4,PARRILLA DELANTERA COFRE PIANO BLACK MINI COOPER F55 F56 (EMBLER) YIW,1897,7,8,4,19
51137300631 *4,MOLDURA BICEL CROMO FARO LUZ DELANTERA (L) MINI F55 F56 F57 (EMBLER) YIW,1218,9,0,7,16
51137300631B,MOLDURA BICEL PIANO BLACK FARO LUZ DELANTERA (L) MINI F55 F56 57 (EMBLER) YIW,1977,2,9,8,19
51137300632 *4,MOLDURA BICEL CROMO FARO LUZ DELANTERA (R) MINI F55 F56 F57 (EMBLER) YIW,1908,4,7,3,14
51137300632B,MOLDURA BICEL PIANO BLACK FARO LUZ DELANTERA (R) MINI F55 F56 F57 (EMBLER) YIW,1532,4,4,9,17
51137367421 *4,PARRILLA PLATEADA (L) BMW F25 F26 (EMBLER) YIW,1970,7,1,4,12
51137367422 *4,PARRILLA PLATEADA (R) BMW F25 F26 (EMBLER) YIW,1829,5,7,1,13
51137371685 *4,PARRILLA DELANTERA COLOR PLATEADO (L) BMW F20 F21 2015-2018 (EMBLER) YIW,1276,0,4,2,6
51137371686 *4,PARRILLA DELANTERA COLOR PLATEADO (R) BMW F20 F21 2015-2018 (EMBLER) YIW,1702,2,5,2,9
51137371747 *4,PARRILLA DELANTERA COLOR NEGRO (L) BMW F20 F21 (EMBLER) YIW,1264,0,4,8,12
51137371748 *4,PARRILLA DELANTERA COLOR NEGRO (R) BMW F20 F21 (EMBLER) YIW,1569,8,8,2,18
51137379609 *4,PARRILLA DELANTERA CROMADA (L) BMW F45 F46 (EMBLER) YIW,1746,2,8,7,17
51137379610 *4,PARRILLA DELANTERA CROMADA (R) BMW F45 F46 (EMBLER) YIW,1851,6,1,2,9
51137379611 *4,PARRILLA DELANTERO (L) BMW F45 (EMBLER) YIW,1908,3,3,1,7
51137379612 *4,PARRILLA DELANTERO (R) BMW F45 (EMBLER) YIW,1516,3,7,9,19
51137393456 *4,PARRILLA DELANTERA COFRE NEGRO CON FILO ROJO MINI COOPER F55 F56 (EMBLER) YIW,1982,1,8,5,14
51137397465 *4,PARRILLA DELANTERA (L) BMW G01 G02 (EMBLER) YIW,1830,0,4,0,4
51137397466 *4,PARRILLA DELANTERA (R) BMW G01 G02 (EMBLER) YIW,1555,7,7,4,18
51137449207 *4,MOLDURA MARCO PARRILA DELANTERA PIANO BLACK  MINI F55 F56 (EMBLER) YIW,1692,4,6,8,18
51137449432 *4,PARRILLA DELANTERA CROMADA BMW G20 G21 G28 (EMBLER) YIW,1229,2,1,8,11
51137454889 *4,REJILLA DELANTERA CON AGUJERO BMW G05 (EMBLER) YIW,1465,0,4,0,4
51137457041B *4,REJILLA RIï¿½ONERA DELANTERA COLOR CROMO CON AGUJEROS BMW G20 G21 (EMBLER) YIW,1822,9,6,2,17
51138072085C *4,REJILLA RIï¿½ONERA DELANTERA NEGRO SIN AGUJEROS BMW G20 G21 (EMBLER) YIW,1876,8,1,4,13
51138072086 *4,REJILLA RIï¿½ONERA DELANTERA NEGRO CON AGUJEROS BMW G20 G21 (EMBLER) YIW,1582,9,3,4,16
51138075665 *4,REJILLA RIï¿½ONERA DELANTERA NEGRA SIN AGUJEROS BMW G20 G21 (EMBLER) YIW,1335,2,6,8,16
51138096590 *4,REJILLA DELANTERA SIN AGUJERO BMW G05 (EMBLER) YIW,1852,2,5,6,13
51138397503,PARRILLA NEGRA L BMW E36,1426,5,4,1,10
51138397504,PARRILLA NEGRA R BMW E36,1342,8,3,5,16
51138412949,PARRILLA CROMO L BMW E36,1651,6,4,3,13
51138412950,PARRILLA CROMO R BMW E36,1372,6,5,1,12
51138493451 *4,PARRILLA DELANTERO CENTRO BMW F48 (EMBLER) YIW,1249,9,1,9,19
51139852115 *4,PARRILLA BMW F52 (EMBLER) YIW,1558,5,3,1,9
51141807495,OJAL DE EMBLEMA DE 82 MM BMW GENUINO,1481,1,1,4,6
51147025251,INSIGNIA CROMADA 325Li ( EMBLER ),1719,0,0,3,3
51147044207,EMBLEMA DE COFRE BMW 70 MM,1223,9,9,4,22
51147074721,INSIGNIA CROMADA 335i ( EMBLER ),1563,0,7,6,13
51147157696,EMBLEMA DE CAJUELA 95 MM BMW X5,1874,0,9,4,13
51147166214,INSIGNIA CROMADA 330i ( EMBLER ),1739,7,3,6,16
51147196559 *2,EMBLEMA CAJUELA 105 MM BMW E70 E71 (GENUINO),1666,5,5,5,15
51148132375 *1,EMBLEMA DE CAJUELA BMW 74 MM (GENUINA),1710,2,4,8,14
51148132375-1,KIT EMBLEMA DE CAJUELA 74MM-EMBLEMA COFRE 82MM BMW,1749,8,9,4,21
51148132375-2,EMBLEMA DE COFRE BMW 82 MM,1230,9,2,0,11
51148195153,INSIGNIA CROMADA 320i ( EMBLER ),1819,5,4,5,14
51167002319,BISEL MARCO ESPEJO LATERAL L BMW E53,1243,2,0,5,7
51167002320,BISEL MARCO ESPEJO LATERAL R BMW E53,1928,7,9,1,17
51167039897 *3,MOTOR ELECTRICO ESPEJO RETROVISOR (L/R) BMWï¿½E53ï¿½(GENUINO),1556,5,6,3,14
51167252893,LUNA DE ESPEJO L BMW E90 GENUINA,1812,6,5,7,18
51167252894,LUNA DE ESPEJO R BMW E90 GENUINA,1474,3,5,4,12
51168217953,PORTA VASOS  BMW E46 ( URO ),1952,7,2,2,11
51168238375,CUBIERTA DE ESPEJO LATERAL L BMW E46,1351,3,8,4,15
51168238376,CUBIERTA DE ESPEJO LATERAL R BMW E46,1518,8,4,5,17
51168256322,TAPA DE ESPEJO BMW E53 SEMINUEVO (ORIGINAL),1664,4,8,8,20
51168269025,BISEL MARCO DE ESPEJO LATERAL L BMW E46,1230,9,6,8,23
51168269026,BISEL MARCO DE ESPEJO LATERAL R BMW E46,1870,4,0,8,12
51168408797,LUNA DE ESPEJO CON DESEMPAï¿½ADOR ( L ) BMW E53 ( GENERICA ),1255,2,2,5,9
51168408798,LUNA DE ESPEJO CON DESEMPAï¿½ADOR ( R ) BMW E53 ( GENERICA ),1300,7,1,9,17
51217011241,ACTUADOR ELECTRICO DE CHAPA DELANTERO ( L ) BMW E46 FREY,1239,9,8,4,21
51217011242 *1,ACTUADOR ELECTRICO DE CHAPA DELANTERO (R) BMW E46 (FREY),1465,7,9,7,23
51217202143,KIT DE REPARACION DE ACTUADOR DE CHAPA ELECTRICO ( L ) BMW E90 (EMBLER),1366,5,4,6,15
51217202143 *1,CERRADURA CHAPA ACTUADOR ELECTRICO DELANTERO (L) BMW E60 E70 E81 E83 E90 F10 F22 F25 F32 MINI R60 (FREY),1239,6,7,4,17
51217202143 *2,CERRADURA CHAPA ACTUADOR ELECTRICO DELANTERO (L) BMW E60 E70 E81 E83 E90 F10 F22 F25 F32 MINI R60 (EMBLER),1847,1,8,3,12
51217202143-100,ACTUADOR ELECTRICO DE CHAPA DELANTERO ( L ) BMW E90 INACTIVO,1799,6,9,5,20
51217202146,KIT REPARACION ACTUADOR CHAPA ELECTRICA (R) BMW E90 (EMBLER),1276,6,2,6,14
51217202146 *1,CERRADURA CHAPA ACTUADOR ELECTRICO DELANTERO (R) BMW E60 E70 E81 E83 E90 F10 F22 F25 F32 MINI R60 (FREY),1706,7,6,8,21
51218243615 *1,MANIJA INTERNA DELANTERA O TRASERA (L) BMW E53 (FREY),1632,0,0,5,5
51218243616 *1,MANIJA INTERNA DELANTERA O TRASERA (R) BMW E53 (FREY),1586,6,3,6,15
51218243616-100,MANIJA DELANTERA O TRASERA INTERIOR ( R ) BMW E53 ( BMTSR ) INACTIVO,1221,1,4,5,10
51218244051,KIT DE CILINDRO PARA CHAPA BMW E46,1430,0,4,1,5
51218245461,MANIJA  EXTERNA DELANTERA ( L ) BMW E39 ( PLASTICO NEGRA URO ),1924,7,0,6,13
51218245461-1,MANIJA  EXTERNA DELANTERA L BMW E39 PLASTICO NEGRA FREY,1380,7,1,3,11
51218245462,MANIJA  EXTERNA DELANTERA-TRASERA  ( R )  BMW E39 ( PLASTICO NEGRA URO ),1710,9,6,6,21
51218245462-1,MANIJA  EXTERNA DELANTERA-TRASERA ( R )  BMW E39  PLASTICO NEGRA FREY,1946,0,3,4,7
51218257737,MANIJA DELANTERA EXTERIOR ( L ) BMW E53 ( FREY ),1477,5,2,5,12
51218257738 *1,MANIJA EXTERNA PUERTA DELANTERA O TRASERA (R) BMW E53 (FREY),1280,3,4,1,8
51218354417,BATERIA PARA LLAVE DE IGNICION BMW E46 VARTA 3.0 V CR2016,1425,6,7,6,19
51218402537,ACTUADOR PUERTA DELANTERA ( L ) BMW E53 FREY,1848,7,4,0,11
51218402540 *1,ACTUADOR DE CHAPA DELANTERA (R) BMW E53 (FREY),1902,8,4,2,14
51227011245 *1,ACTUADOR ELECTRICO CHAPA PUERTA TRASERA (L) BMW E46 (FREY),1639,5,3,1,9
51227011246,ACTUADOR ELECTRICO DE CHAPA TRASERO ( R ) BMW E46 FREY,1649,3,7,1,11
51227202147 *1,ACTUADOR ELECTRICO CHAPA TRASERA (L) BMW E60 E65 E70 E81 E83 E84 E90 F36 MINI R60 (FREY),1549,5,3,1,9
51227202148 *1,ACTUADOR ELECTRICO CHAPA TRASERA (R) BMW E60 E65 E70 E81 E83 E84 E90 F36 MINI R60 (FREY),1952,6,2,0,8
51227202148-100,ACTUADOR ELECTRICO CHAPA TRASERO ( R ) BMW E90 INACTIVO,1257,2,0,4,6
51228402601 *1,ACTUADOR ELECTRICO CHAPA PUERTA TRASERA (L) BMW E53 (FREY),1688,0,1,9,10
51228402602 *1,ACTUADOR ELECTRICO DE CHAPA TRASERO ( R ) BMW X5/E53 FREY,1778,5,4,5,14
51231908465,AMORTIGUADOR COFRE FUERZA 420 NEWTONS 255 MM (L/R) BMW E38 STABILUS,1529,0,7,9,16
51231908465-1,AMORTIGUADOR COFRE FUERZA 420 NEWTONS 255 MM (L/R) BMW E38 FREY,1872,6,7,0,13
51231960852,AMORTIGUADOR COFRE FUERZA 320 NEWTONS 367 MM (L/R) BMW E36 BMTR,1593,7,3,7,17
51231960852 *5,AMORTIGUADOR COFRE FUERZA 320 NEWTONS 367 MM (L/R) BMW E36 (STABILUS) SSF,1324,7,9,9,25
51231960852-1,AMORTIGUADOR COFRE FUERZA 320 NEWTONS 367 MM (L/R) BMW E36 FREY,1388,5,0,1,6
51231960852-3,AMORTIGUADOR COFRE FUERZA 320 NEWTONS 367 MM (L/R) BMW E36 TOPRAN,1271,5,5,9,19
51233400352 *1,AMORTIGUADOR COFRE FUERZA 720 NEWTONS 285 MM (L/R) BMW E83 (FREY),1838,6,5,6,17
51237008745,AMORTIGUADOR COFRE FUERZA 330 NEWTONS 313 MM (L/R) BMW E60-M54 BMTR,1494,0,0,3,3
51237008745 *1,AMORTIGUADOR COFRE FUERZA 330 NEWTONS 313 MM (L/R) BMW E60-M54 FREY,1333,5,7,7,19
51237008745-3,AMORTIGUADOR COFRE FUERZA 330 NEWTONS 313 MM (L/R) BMW E60-M54 TOPRAN,1403,7,5,9,21
51237016178,AMORTIGUADOR COFRE FUERZA 180 NEWTONS 672 MM (L/R) BMW Z4 E85 ( STABILUS ),1269,8,1,7,16
51237016178 *1,AMORTIGUADOR COFRE FUERZA 180 NEWTONS 672 MM (L/R) BMW Z4 E85 ( FREY ),1599,9,3,1,13
51237060529 *6,CHICOTE PALANCA LIBERACION A COFRE 1087 MM BMW E81 E84 E90 (AUTOPARTS) SSF,1427,7,4,0,11
51237060529 *7,CHICOTE PALANCA LIBERACION A COFRE 1087 MM BMW E81 E84 E90 (BAPMIC) SSF,1713,3,6,2,11
51237060550,AMORTIGUADOR COFRE FUERZA 330 NEWTONS 400 MM (L/R) BMW E90 (EMBLER),1668,8,4,9,21
51237060550 *1,AMORTIGUADOR COFRE FUERZA 330 NEWTONS 400 MM (L/R) BMW E90 (FREY),1422,1,4,4,9
51237060550-2,AMORTIGUADOR COFRE FUERZA 330 NEWTONS 400 MM (L/R) BMW E90 TOPRAN,1963,7,5,4,16
51237060552 *5,CHICOTE DELANTERO LIBERACION CHAPA DE COFRE MOTOR BMW E90 E91 (AUTOPA) SSF,1820,8,8,2,18
51237060552 *6,CHICOTE DELANTERO LIBERACION CHAPA DE COFRE MOTOR BMW E90 E91 (BAPMIC) SSF,1254,5,8,1,14
51237118370 *3,AMORTIGUADOR COFRE FUERZA 350 NEWTONS 374 MM (L/R) BMW E81 E87 E88 (TOPRAN),1692,3,9,3,15
51237118370 *5,AMORTIGUADOR COFRE FUERZA 350 NEWTONS 374 MM (L/R) BMW E81 E87 E88 (STABILUS) SSF,1822,5,6,3,14
51237148346,AMORTIGUADOR COFRE FUERZA 390 NEWTONS 410 MM (L/R) BMW E70 (HIGH QUALITY),1784,8,1,4,13
51237148346 *1,AMORTIGUADOR COFRE FUERZA 390 NEWTONS 410 MM (L/R) BMW E70 FREY,1242,6,5,4,15
51237148346-2,AMORTIGUADOR COFRE FUERZA 390 NEWTONS 410 MM (L/R) BMW E70 TOPRAN,1883,5,6,2,13
51237148346-5,AMORTIGUADOR COFRE FUERZA 390 NEWTONS 410 MM (L/R) BMW E70 OSSCA,1569,2,0,8,10
51237175020 *1,AMORTIGUADOR COFRE FUERZA 270 NEWTONS 577 MM (L/R) MINI R50 R52 R53 (FREY),1287,9,4,4,17
51237175020 *5,AMORTIGUADOR COFRE FUERZA 270 NEWTONS 577 MM (L/R) MINI R50 R52 R53 (STABILUS) SSF,1565,7,9,5,21
51237184603,CHICOTE DE LIBERACION DE COFRE BMW E87 GENUINO,1445,8,2,2,12
51237184603-1,CHICOTE DE LIBERACION DE COFRE BMW E87 FREY,1634,5,5,4,14
51237197474,CHICOTE DE LIBERACION DE COFRE BMW E65 AUTOPA Nï¿½ 2,1480,0,8,4,12
51237197474-1,CHICOTE DE LIBERACION DE COFRE BMW E65 FREY Nï¿½ 2,1590,8,2,5,15
51237200197 *1,AMORTIGUADOR COFRE FUERZA 395 NEWTONS 290 MM (L/R) BMW F07 FREY,1635,2,8,5,15
51237201904 *5,CHICOTE PALANCA LIBERACION A COFRE 1087 MM BMW E81 E84 E90 (GENUINO),1276,4,5,8,17
51237206644 *1,AMORTIGUADOR COFRE FUERZA 410 NEWTONS 278 MM (L/R) BMW F10 F11 (FREY),1978,5,3,1,9
51237210727 *1,AMORTIGUADOR COFRE FUERZA 680 NEWTOS 299 MM (L/R) BMW F25 F26 (FREY),1915,0,8,7,15
5123722551-100,AMORTIGUADOR DE COFRE BMW E87-N46 INACTIVO,1627,2,8,2,12
51237225518 *1,AMORTIGUADOR COFRE FUERZA 350 NEWTONS 374 MM (L/R) BMW E81 E82 E87 E88,1326,2,2,6,10
51237239233,AMORTIGUADOR COFRE FUERZA 610 NEWTONS 282 MM (L/R) BMW F30-N20 BMTR,1828,7,6,1,14
51237239233 *1,AMORTIGUADOR COFRE FUERZA 610 NEWTONS 282 MM (L/R) BMW F30-N20 (FREY),1648,1,5,9,15
51237285823 *1,AMORTIGUADOR COFRE FUERZA 390 NEWTONS 475 MM (L/R) BMW Z4 E89 (FREY),1898,3,4,7,14
51237294524 *1,AMORTIGUADOR COFRE FUERZA 495 NEWTONS 376 MM (L/R) BMW F15 F16 F85 F86 FREY,1929,3,8,7,18
51237308065 *1,AMORTIGUADOR COFRE FUERZA 495 NEWTONS 376 MM (L/R) BMW F15 F16 FREY,1307,0,9,8,17
51238119558,AMORTIGUADOR COFRE FUERZA 280 NEWTONS 415 MM (L/R) BMW E36 STABILUS,1859,7,3,6,16
51238119558-1,AMORTIGUADOR COFRE FUERZA 280 NEWTONS 415 MM (L/R) BMW E36 FREY,1423,0,7,1,8
51238150077,AMORTIGUADOR COFRE FUERZA 830 NEWTONS 327 MM (L/R) BMW E38 BMTR,1333,5,0,8,13
51238150077-1,AMORTIGUADOR COFRE FUERZA 830 NEWTONS 327 MM (L/R) BMW E38 FREY,1224,6,3,6,15
51238174866,AMORTIGUADOR COFRE FUERZA 680 NEWTONS 333 MM (L/R) BMW E39 BMTR,1873,0,8,0,8
51238174866 *1,AMORTIGUADOR COFRE FUERZA 680 NEWTONS 333 MM (L/R) BMW E39 (FREY),1663,5,1,9,15
51238202688,AMORTIGUADOR COFRE FUERZA 580 NEWTONS 316 MM (L/R) BMW E46 BMTR,1768,8,7,0,15
51238202688 *1,AMORTIGUADOR COFRE FUERZA 580 NEWTONS 316 MM (L/R) BMW E46 (FREY),1806,7,5,1,13
51238202688-2,AMORTIGUADOR COFRE FUERZA 580 NEWTONS 316 MM (L/R) BMW E46 TOPRAN,1835,2,6,0,8
51238202688-3,AMORTIGUADOR COFRE FUERZA 580 NEWTONS 316 MM (L/R) BMW E46 OSSCA,1656,2,1,7,10
51238208442 *5,CHICOTE DE LIBERACION DE CABINA A COFRE DE MOTOR 936 MM BMW E46 (AUTOPA) SSF,1815,1,8,7,16
51238208442 *6,CHICOTE DE LIBERACION DE CABINA A COFRE DE MOTOR 936 MM BMW E46 (BAPMIC) SSF,1631,5,9,5,19
51238208630 *5,CHICOTE CENTRAL LIBERACION COFRE DE CHAPA A CHAPA BMW E46 (AUTOPA) SSF,1725,1,2,1,4
51238208630 *6,CHICOTE CENTRAL LIBERACION COFRE DE CHAPA A CHAPA BMW E46 (BAPMIC) SSF,1572,2,3,6,11
51238218859 *5,CHICOTE LIBERACION DE CHAPA A COFRE 700 MM BMW E46 (AUTOPARTS) SSF,1468,8,1,0,9
51238218859 *6,CHICOTE LIBERACION DE CHAPA A COFRE 700 MM BMW E46 (BAPMIC) SSF,1467,1,9,7,17
51238238459,GANCHO DE SEGURIDAD DE COFRE L BMW E46 ORIGINAL,1456,2,6,8,16
51238238459-1,GANCHO DE SEGURIDAD DE COFRE L BMW E46 FREY,1388,0,1,2,3
51238397401,AMORTIGUADOR COFRE FUERZA 770 NEWTONS 345 MM (L/R) BMW E36 STABILUS,1642,8,0,3,11
51238397401-1,AMORTIGUADOR COFRE FUERZA 770 NEWTONS 345 MM (L/R) BMW E36 FREY,1907,0,4,9,13
51238402551,AMORTIGUADOR COFRE FUERZA 640 NEWTONS 289 MM (L/R) BMW E53 BMTR,1888,1,7,0,8
51238402551 *1,AMORTIGUADOR COFRE FUERZA 640 NEWTONS 289 MM (L/R) BMW E53 FREY,1966,7,4,1,12
51238402551-2,AMORTIGUADOR COFRE FUERZA 640 NEWTONS 289 MM (L/R) BMW E53 OSSCA,1523,4,2,2,8
51238402615 *5,CHICOTE PALANCA LIBERACION A COFRE 1035 MM BMW E53 (AUTOPA) SSF,1419,8,8,0,16
51238402615 *6,CHICOTE PALANCA LIBERACION A COFRE 1035 MM BMW E53 (BAPMIC) SSF,1837,3,1,6,10
51238403219 *5,CHICOTE LIBERACION COFRE LADO (R) 650 MM BMW E53 (AUTOPA) SSF,1658,2,0,9,11
51238403219 *6,CHICOTE LIBERACION COFRE LADO (R) 650 MM BMW E53 (BAPMIC) SSF,1355,6,5,1,12
51238408134 *5,CHICOTE LIBERACION DE CHAPA A COFRE (L) 710 MM BMW E53 (AUTOPAR) SSF,1889,8,7,6,21
51238408134 *6 ,CHICOTE LIBERACION DE CHAPA A COFRE (L) 710 MM BMW E53 (BAPMIC) SSF,1228,4,4,4,12
51241960862,AMORTIGUADOR CAJUELA 480 NEWTONS 295 MM (L/R) BMW E36 BMTR,1676,0,4,6,10
51241960862-1,AMORTIGUADOR CAJUELA 480 NEWTONS 295 MM (L/R) BMW E36 FREY,1644,5,7,3,15
51242990136,AMORTIGUADOR CAJUELA 460 NEWTONS 570 MM (L/R) BMW E84 OSSCA,1400,9,9,2,20
51242990136 *1,AMORTIGUADOR CAJUELA 460 NEWTONS 570 MM (L/R) BMW E84 FREY,1807,5,0,6,11
51242990136-1,AMORTIGUADOR CAJUELA 460 NEWTONS 570 MM (L/R) BMW E84 VAICO,1523,5,6,3,14
51243400379,AMORTIGUADOR CAJUELA 590 NEWTONS 625 MM (L/R) BMW E83 BMTR,1659,3,2,7,12
51243400379 *1,AMORTIGUADOR CAJUELA 590 NEWTONS 625 MM (L/R) BMW E83 FREY,1409,8,1,2,11
51247060622 *1,AMORTIGUADOR CAJUELA FUERZA 400 NEWTONS 412 MM (L/R) BMW E81 E87 (FREY),1257,4,4,9,17
51247177283,AMORTIGUADOR CAJUELA HIDRAULICO ( NO ELECTRICO ) 500 NEWTONS 522 MM (L/R) BMW X5 E70 OPTIMAL,1267,3,9,1,13
51247191255,AMORTIGUADOR CAJUELA 570 NEWTONS 283 MM (L/R) BMW E89 (FREY),1702,7,5,9,21
51247211289 *5,AMORTIGUADOR CAJUELA 610 NEWTONS 652 MM (L/R) BMW F25 (STABILUS) SSF,1666,8,9,7,24
51247239871 *1,AMORTIGUADOR CAJUELA 455 NEWTONS 467 MM (L/R) BMW F20 F21 (FREY),1395,3,5,1,9
51247250308 *1,AMORTIGUADOR CAJUELA 320 NEWTONS 370 MM (L/R) BMW E90-N52 FREY,1632,4,2,6,12
51247250308-1,AMORTIGUADOR CAJUELA 320 NEWTONS 370 MM (L/R) BMW E90-N52 OSSCA,1978,5,0,4,9
51247250308-2,AMORTIGUADOR CAJUELA 320 NEWTONS 370 MM (L/R) BMW E90-N52 URO,1628,8,9,6,23
51247250308-3,AMORTIGUADOR CAJUELA 320 NEWTONS 370 MM (L/R) BMW E90-N52 TOPRAN,1363,6,7,2,15
51247259763 *1,AMORTIGUADOR CAJUELA 120 NEWTONS 377 MM (L/R) BMW F30 F80 (FREY),1772,7,7,9,23
51247288721,AMORTIGUADOR COFRE FUERZA 560 NEWTONS 373 MM (L/R) BMW F07 FREY,1338,8,8,3,19
51247294199 *1,AMORTIGUADOR CAJUELA HIDRAULICO ( NO ELECTRICO ) 500 NEWTONS 522 MM (L/R) BMW X5 E70 (FREY),1607,0,0,0,0
51247300845 *1,AMORTIGUADOR CAJUELA 425 NEWTONS 483 MM (L/R) MINI F56 (FREY),1780,0,0,4,4
51247840617,ACTUADOR ELECTRICO DE CHAPA DE CAJUELA BMW E46-E60-E90 FREY,1207,1,4,4,9
51248230070,AMORTIGUADOR CAJUELA 420 NEWTONS 596 MM (L/R) BMW E36 BMTRS,1408,3,5,1,9
51248230070-1,AMORTIGUADOR CAJUELA 420 NEWTONS 596 MM (L/R) BMW E36 ( FREY ),1250,3,9,3,15
51248254281,AMORTIGUADOR CAJUELA 320 NEWTONS 350 MM (L/R) BMW E46 BMTR,1631,7,8,6,21
51248254281 *1,AMORTIGUADOR CAJUELA 320 NEWTONS 350 MM (L/R) BMW E46 (FREY),1847,5,4,9,18
51248399087,AMORTIGUADOR CAJUELA 720 NEWTONS 215 MM (L/R) BMW Z3-E36 TUFF SUPPORT,1717,5,8,0,13
51248399087-1,AMORTIGUADOR CAJUELA 720 NEWTONS 215 MM (L/R) BMW Z3-E36 FREY,1821,8,5,1,14
51248402405 *1,AMORTIGUADOR CAJUELA 530 NEWTONS 530 MM (L/R) BMW E53 (FREY),1680,7,6,6,19
51248410755,AMORTIGUADOR CAJUELTA TRASERO 215 MM BMW Z3 TUFF SUPPORT 614416,1334,3,3,0,6
51321938884 *6,SEGURO DESLIZABLE ELEVADOR CRISTALES DELANTEROS TRASEROS BMW E36 E85 E92  (GENUINO) SSF,1848,0,8,8,16
51337020659,ELEVADOR DE CRISTALES SIN MOTOR DELANTERO ( L ) (ELECTRICO) BMW E46 ( BMTR ),1235,3,2,3,8
51337020659 *1,MECANISMO ELEVADOR VENTANILLA DELANTERA (L) BMW E46  (FREY),1669,9,6,8,23
51337020660,REGULADOR DE VENTANA SIN MOTOR DELANTERO R ELECTRICO BMW E46 ( BMTR ),1817,4,0,7,11
51337020660 *1,MECANISMO ELEVADOR VENTANILLA DELATERA (R) BMW E46 (FREY),1367,2,3,4,9
51337296447,VIDRIO DE PUERTA LADO CONDUCTOR MINI COOPER 2016 ORIGINAL,1966,6,9,1,16
51357125060 *1,MECANISMO ELEVADOR CRISTALES VENTANILLA TRASERA (R) BMW E53 (FREY),1999,2,4,4,10
51358212099,REGULADOR DE VENTANA SIN MOTOR TRASERO ( L ) (ELECTRICO) BMW E46 ( BMTR ),1561,6,6,7,19
51358212099-1,REGULADOR DE VENTANA SIN MOTOR TRASERO ( L ) (ELECTRICO) BMW E46 FREY,1407,1,7,4,12
51438408157,MANIJA PALANCA DE LIBERACION DE COFRE BMW E53 ( GENUINA ),1761,7,1,8,16
51438408157-1,MANIJA PALANCA DE LIBERACION DE COFRE BMW E53 FREY,1917,5,2,2,9
51458266814 *6,GRAPA MOLDURAS TABLERO INTERIOR BMW E46 E65 E85 (GENUINO) SSF,1296,8,9,7,24
51538212100,REGULADOR DE VENTANA SIN MOTOR TRASERO ( R ) (ELECTRICO) BMW E46 ( BMTR ),1865,9,9,9,27
51538212100-1,REGULADOR DE VENTANA SIN MOTOR TRASERO ( R ) (ELECTRICO) BMW E46 FREY,1345,6,2,8,16
51713330867 *4,CANTONERA SALPICADERA TRASERA (L) BMW E83 (EMBLER) YIW,1689,3,2,3,8
51713330868 *4,CANTONERA SALPICADERA TRASERA (R) BMW E83 (EMBLER) YIW,1756,0,4,1,5
51713401807 *4,CANTONERA SALPICADERA DELANTERA (L) BMW E83 (EMBLER) YIW,1279,8,6,9,23
51713401808 *4,CANTONERA SALPICADERA DELANTERA (R) BMW E83 (EMBLER) YIW,1494,4,8,7,19
51717136167 *4,TOLVA GUARDA FANGOS SALPICADERA TRASERA (L) MINI R56 (EMBLER) YIW,1598,2,9,3,14
51717136168 *4,TOLVA GUARDA FANGOS SALPICADERA TRASERA (R) MINI R56 (EMBLER) YIW,1395,8,2,0,10
51717290789 *4,TOLVA GUARDA FANGOS SALPICADERA DELANTERA (L) MINI F55 F56 (EMBLER) YIW,1303,5,7,5,17
51717290790 *4,TOLVA GUARDA FANGOS SALPICADERA DELANTERA (R) MINI F55 F56 (EMBLER) YIW,1763,8,6,0,14
51749465188 *4,PARRILLA DE RADIADOR SUPERIOR DELANTERA BMW G20 G21 (EMBLER) YIW,1646,4,6,0,10
51749465528 *4,REJILLA DELANTERA CON AGUJERO DE VISION NOCTURNA BMW G05 (EMBLER) YIW,1264,6,5,5,16
51757343141 *4,TOLVA CUBIERTA INFERIOR MOTOR MINI F55 F56 (EMBLER) YIW,1951,0,4,6,10
51772990165 *4,CANTONERA SALPICADERA DELANTERA (L) BMW E84 (EMBLER) YIW,1678,7,7,3,17
51772990166 *4,CANTONERA SALPICADERA DELANTERA (R) BMW E84 (EMBLER) YIW,1742,4,9,0,13
51777157105 *4,CANTONERA SALPICADERA TRASERA (L) MINI R56 R57 R58 R59 (EMBLER) YIW,1797,2,7,0,9
51777157106 *4,CANTONERA SALPICADERA TRASERA (R) MINI R56 R57 R58 R59 (EMBLER) YIW,1424,9,9,1,19
51777158427 *4,CANTONERA SALPICADERA DELANTERA (L) BMW E70 (EMBLER) YIW,1863,3,9,5,17
51777158428 *4,CANTONERA SALPICADERA DELANTERA (R) BMW E70 (EMBLER) YIW,1286,8,1,4,13
51777181679 *4,CANTONERA SALPICADERA TRASERA (L) BMW G08 (EMBLER) YIW,1492,4,8,0,12
51777181680 *4,CANTONERA SALPICADERA TRASERA (R) BMW G08 (EMBLER) YIW,1702,4,8,8,20
51777210081 *4,CANTONERA SALPICADERA DELANTERA (L) BMW F25 (EMBLER) YIW,1621,8,1,5,14
51777210082 *4,CANTONERA SALPICADERA DELANTERA (R) BMW F25 (EMBLER) YIW,1312,1,6,2,9
51777210083 *4,CANTONERA SALPICADERA TRASERA (L) BMW F25 (EMBLER) YIW,1814,9,1,5,15
51777210084 *4,CANTONERA SALPICADERA TRASERA (R) BMW F25 (EMBLER) YIW,1528,6,5,8,19
51777238461 *4,TABLERO DE PARACHOQUES TRASERO BMW F25 (EMBLER) YIW,1951,0,9,6,15
51777294371 *4,MOLDURA SALPICADERA TRASERA (L) BMW F15 (EMBLER) YIW,1621,1,3,4,8
51777294372 *4,MOLDURA SALPICADERA TRASERA (R) BMW F15 (EMBLER) YIW,1687,0,9,0,9
51777294373 *4,CANTONERA SALPICADERA RUEDA DELANTERA (L) BMW F15 (EMBLER) YIW,1369,6,0,1,7
51777294374 *4,CANTONERA SALPICADERA RUEDA DELANTERA (R) BMW F15 (EMBLER) YIW,1801,6,8,9,23
51777300819 *4,CANTONERA SALPICADERA DELANTERA (L) MINI F55 F56 (EMBLER) YIW,1213,9,1,6,16
51777300820 *4,CANTONERA SALPICADERA DELANTERA (R) MINI F55 F56 (EMBLER) YIW,1942,8,3,7,18
51777332337 *4,CANTONERA SALPICADERA DELANTERA (L) BMW F48 F49 (EMBLER) YIW,1805,9,0,4,13
51777332338 *4,CANTONERA SALPICADERA DELANTERA (R) BMW F48 F49 (EMBLER) YIW,1437,1,5,9,15
51777349421 *4,CANTONERA SALPICADERA DELANTERA (L) MINI R56 (EMBLER) YIW,1237,2,6,4,12
51777349422 *4,CANTONERA SALPICADERA DELANTERA (R) MINI R56 (EMBLER) YIW,1605,4,7,2,13
51777376877 *4,CANTONERA SALPICADERA TRASERA (L) MINI F56 F57 (EMBLER) YIW,1526,1,4,9,14
51777376878 *4,CANTONERA SALPICADERA TRASERA (R) MINI F56 F57 (EMBLER) YIW,1698,1,5,7,13
51777378581 *4,CANTONERA SALPICADERA DELANTERA (L) BMW F15 (EMBLER) YIW,1469,8,9,2,19
51777378582 *4,CANTONERA SALPICADERA DELANTERA (R) BMW F15(EMBLER) YIW,1298,7,5,0,12
51777378583 *4,CANTONERA SALPICADERA TRASERA (L) BMW F15 (EMBLER) YIW,1255,7,6,5,18
51777378584 *4,CANTONERA SALPICADERA TRASERA (R) BMW F15 (EMBLER) YIW,1607,2,4,3,9
51777379531 *4,CANTONERA SALPICADERA TRASERA (L) BMW F48 F49 (EMBLER) YIW,1314,5,7,1,13
51777379532 *4,CANTONERA SALPICADERA TRASERA (R) BMW F48 F49 (EMBLER) YIW,1790,5,8,3,16
51779498813 *4,CANTONERA SALPICADERA DELANTERA (L) BMW G08 (EMBLER) YIW,1798,0,3,7,10
51779498814 *4,CANTONERA SALPICADERA DELANTERA (R) BMW G08 (EMBLER) YIW,1794,1,8,9,18
5264684 *5,BATERIA PARA LLAVE DE IGNICION SAAB 9-3 RAYOVAC 3.0 V CR1632 SSF,1438,4,2,4,10
53039700005,KIT DE JUNTAS DE TURBOCARGADOR AUDI A3-A4 1.8 L GENERICO,1412,9,3,6,18
53039700118,REPUESTO DE TURBO CARGADOR MINI R56 ( POWERTEC ),1289,2,6,3,11
53039700118 *2,TURBO CARGADOR CARTUCHO K03 MINI R56-N14 (EMBLER) GOG,1416,3,4,9,16
53039880029 *2,TURBO CARGADOR K03 AUDI A4 1.8 L  TURBO 20 VALVULAS (EMBLER),1988,2,4,6,12
53039880029 *3,TURBO CARGADOR K03 AUDI A4 B5 MOTOR 1.8 TURBO 20 VALVULAS (EMBLER) GOG,1915,3,5,0,8
5310311100 *5,TENSOR BANDA DISTRIBUCION MOTOR VOLVO S80 2.9 L 6 CIL (INA) SSF,1379,1,6,1,8
5320159100 *5,POLEA TENSORA BANDA DISTRIBUCION TIEMPO MOTOR (R) AUDI VW 2.7 2.8L V6 (INA) SSF,1562,6,5,4,15
5320232100 *5,POLEA TENSORA DE BANDA DE DISTRIBUCION FREELANDER 1a GEN. ( INA ),1542,9,2,3,14
5320242100 *5,POLEA RE ENVIO RAYADA 119 MM 6 RANURAS BANDA ACCESORIOS VOLVO S40 V40 1.9 L 4 CIL (INA) SSF,1770,9,3,6,18
5350183100 *5,POLEA SOBREGIRO 6PK ALTERNADOR BOSCH BMW N46 N46N N52 (INA) SSF,1643,4,6,0,10
535145157 ,BOMBA HIDRAULICA DE DIRECCION (EMBLER),1977,9,2,8,19
54201720,BALATAS FRENOS TRASEROS MERCEDES R170 W202-W210 PAGID T1014,1900,4,3,5,12
54206220,BALATAS FRENOS DELANTEROS MERCEDE W203 PAGID T5112,1575,2,9,9,20
5451240000000,CARCASA PARA LLAVE MITSUBISHI LANCER,1490,1,6,5,12
55186712,BOMBA DE DIRECCION HIDRAULICA FIAT STRADA,1898,5,3,6,14
55193743,ENFRIADOR DE ACEITE DE MOTOR PANDA PUNTO TIGRA MERIVA BMTRS,1204,2,9,0,11
552525010 *2,SOPORTE CENTRAL FLECHA CARDAN CAYENNE 1a GEN 2003 A 2010 (EMBLER) GOG,1713,2,6,4,12
55355603,ENFRIADOR DE ACEITE DE MOTOR CHEVROLET CRUZE BMTRS,1609,9,5,6,20
55355603-1,LIGA DE ENFRIADOR DE ACEITE DE MOTOR CRUZE / SONIC/ TRAX,1592,7,1,9,17
558601030 *5,BATERIA PARA LLAVE MERCEDES BMW AUDI VARTA 3.0 V CR2025 (RAYOVAC) SSF,1215,9,6,1,16
558601050,BATERIA PARA LLAVE DE IGNICION UNIVERSAL VARTA 1.5 V V13GA LR44,1326,5,7,5,17
558601065,BATERIA PARA LLAVE DE IGNICION UNIVERSAL VARTA 1.55 V V392,1428,0,9,2,11
56110-RAA-A01,BOMBA DE DIRECCION ASISTIDA HONDA ACCORD ACURA (EMBLER),1577,6,3,5,14
57070A,RETEN DE TURBINA VOLVO S40 TRANSMISIï¿½N AW 55-50 SN,1822,0,2,1,3
580453021,BOMBA DE GASOLINA BMW E34 BMTR REPUESTO,1258,4,2,6,12
58121350 *5,FAN CLUTCH ENFRIAMIENTO MOTOR AUDI A4 VW PASSAT (URO) SSF,1902,4,9,3,16
58198012,JUEGO DE JUNTAS DE CABEZA AUDI A4 1.8 TURBO 20 VALVULAS BMTRS ALEMAN,1350,4,2,0,6
58198012 *5,JUEGO DE JUNTAS DE CABEZA AUDI A4 1.8 TURBO 20 VALVULAS (VICTOR) SSF,1500,7,4,3,14
58350 *5,SENSOR ANGULO GIRO DIRECCION  BMW E46 E53 E83 (JURGEN LIEBISCH) SSF,1983,2,2,7,11
5C0129620B *6,FILTRO ENTRADA AIRE MOTOR 136 X 345 MM VW GOLF 1.4 JETTA 1.4 1.5 (MANN) SSF,1782,6,7,5,18
5C1423051H *3,DIRECCION ELECTRO ASISTIDA VW JETTA GLI GOLF GTI MK6 SEAT CUPRA AUDI A3 (GENUINA) HC,1855,8,0,7,15
5K0698151B *5,BALATAS FRENOS DELANTEROS 155.1 X 66.0 MM AUDI VW SEAT (FERODO) SSF,1624,2,5,3,10
5K0698451D *3,BALATAS FRENOS TRASEROS 109.2 X 53.3 MM AUDI VW SEAT (TRW GDB1841),1827,8,7,7,22
5K0698451D *5,BALATAS FRENOS TRASEROS 109.2 X 53.3 MM AUDI VW SEAT (BOSCH) SSF,1356,0,4,3,7
5K0959126,SENSOR DE PRESION DE AIRE ACONDICIONADO AUDI A3 ( GENUINO ),1257,6,1,4,11
5K0959126-1,SENSOR DE PRESION DE AIRE ACONDICIONADO AUDI A3 ( BORSEHUNG ),1424,8,7,7,22
5N0198093 *3,BOMBA AGUA AUXILIAR ELECTRICA ENFRIAMIENTO MOTOR AUDI A3 SEAT VW (PIERBURG),1223,4,7,5,16
5N0698151C *5,BALATAS FRENOS DELANTEROS 155.3 X 71.6 MM AUDI VW SEAT (ATE) SSF,1949,7,5,7,19
5N0698151C *7,BALATAS FRENOS DELANTEROS 105.5 X 55.9 MM AUDI VW SEAT (ATE) SSF,1373,3,3,3,9
5N096561 *2,BOMBA AGUA AUXILIAR ELECTRICA ENFRIAMIENTO MOTOR VW 2.0 TDI (EMBLER),1517,9,4,7,20
5Q0121321,TAPON DE DEPOSITO ANTICONGELANTE AUDI A3 A8 Q3 TT TOPRAN,1254,9,5,6,20
5Q0121407,DEPOSITO CONPENSACION REFRIGERANTE AUDI A3 TT (EMBLER),1990,0,5,6,11
5Q0121407-1,DEPOSITO CONPENSACION REFRIGERANTE AUDI A3 TT VIKA,1948,9,6,6,21
5Q0121407M *2,DEPOSITO ANTICONGELANTE AUDI A3 Q3 TT ATLAS GOLF TIGUAN (EMBLER) GOG,1370,9,5,6,20
5Q0121407M *5,DEPOSITO ANTICONGELANTE MOTOR AUDI A3 Q3  (URO) SSF,1931,5,8,1,14
5Q0122291DA *2,TOMA AGUA I GRIEGA BOMBA AGUA MOTOR AUDI VW (EMBLER) GOG,1718,0,7,4,11
5Q0127177 *3,FILTRO COMBUSTIBLE GASOLINA AUDI A3 Q3 (MAHLE KX492),1748,8,9,6,23
5Q0129620B,FILTRO ENTRADA AIRE MOTOR AUDI A3 1.4 TSI VIKA,1672,2,2,9,13
5Q0129620B *3,FILTRO ENTRADA AIRE MOTOR A3 Q2 Q3 TT (MAHLE LX3502),1497,5,5,6,16
5Q0129620B *5,FILTRO ENTRADA AIRE MOTOR 178 X 292 MM AUDI VW SEAT (MANN) SSF,1751,0,2,2,4
5Q0129620B-5,FILTRO ENTRADA AIRE MOTOR AUDI A3 Q2 Q3 TT MANN C30005,1506,9,1,8,18
5Q0407151R *3,HORQUILLA SUSPENSION DELANTERA (L) AUDI A3 SEAT VW (FEBI),1893,0,1,9,10
5Q0412331E *5,BASE AMORTIGUADOR SUSPENSION DELANTERA (L/R) AUDI A3 S3 TT GOLF ATLAS TIGUAN (LEMFOERDER) SSF,1948,8,9,9,26
5Q0413031ET *3,AMORTIGUADOR DE GAS SUSPENSION DELANTERA (L/R) AUDI A3 SEAT VW (VIKA),1921,7,5,2,14
5Q0513045BN *3,AMORTIGUADOR AIRE SUSPENSION TRASERA (L/R) AUDI Q2 CUPRA ATECA VW (BORSEHUNG),1448,7,1,9,17
5Q0513353G *3,BASE AMORTIGUADOR SUSPENSION TRASERA (L/R) AUDI A3 SEAT VW (BRUCK GERMANY),1788,3,9,7,19
5Q0615301F *2,DISCO FRENOS DELANTEROS VENTILADO (L/R) 312X156X50.0 MM AUDI VW SEAT (EMBLER) EMB,1355,1,8,4,13
5Q0615601D *2,DISCO FRENOS TRASEROS SOLIDO (L/R) 272X150X48.3 MM AUDI VW SEAT (EMBLER) EMB,1352,4,9,8,21
5Q0615601E *2,DISCO FRENOS TRASEROS VENTILADO (L/R) 310X150X48.5 MM AUDI VW SEAT (EMBLER) EMB,1824,4,8,2,14
5Q0615601G *2,DISCO FRENOS TRASEROS SOLIDO (L/R) 282X150X48.3 MM AUDI VW SEAT (EMBLER) EMB,1848,9,0,7,16
5Q0698451AK *5,BALATAS FRENOS TRASEROS 123.2 X 61.2 MM AUDI VW SEAT (FERODO) SSF,1355,1,5,0,6
5Q0698451AK *6,BALATAS FRENOS TRASEROS 123.2 X 61.2 MM AUDI VW SEAT (ATE) SSF,1930,0,2,3,5
5Q0819669 *3,1 PZ FILTRO POLEN AIRE CABINA CARBON ACTIVO AUDI A3 Q3 RS3 S3 TTS SEAT VW (MAHLE LAK888) DGO,1499,6,5,9,20
5Q0965567B *3,BOMBA AGUA AUXILIAR ELECTRICA ENFRIAMIENTO MOTOR AUDI TT SEAT VW (CALIDAD ORIGINAL),1215,2,3,2,7
5QM129620B *6,FILTRO ENTRADA AIRE MOTOR 170M X 270 MM VW GOLF 1.4 JETTA 1.4 1.5 (HENGST) SSF,1223,5,8,1,14
5WA121251H *5,RADIADOR ENFRIAMIENTO MOTOR AUDI A3 Q3 TT ARTEON GOLF JETTA TIGUAN (BEHR) SSF,1422,2,6,2,10
5WA698151N *5,BALATAS FRENOS DELANTERO 155.3 X 66.9 MM AUDI VW SEAT (FERODO) SSF,1204,2,2,6,10
5WA698451E *5,BALATAS FRENOS TRASEROS 122.9 X 52.2 MM AUDI VW SEAT (FERODO) SSF,1876,2,6,1,9
6,//.,1571,0,2,4,6
6011800065,ENFRIADOR DE ACIETE MERCEDES BENZ SPRINTER BMTRS,1414,3,9,7,19
6011800065 *1,ENFRIADOR ACEITE MOTOR SPRINTER OM611 2.7 L 5 CIL 2004 A 2006 5 CIL (FREY),1426,6,4,9,19
6013210350 *1,BUJE TORNILLOS ESTABILIZADOR TRASERO (L/R) SPRINTER W901 A W905 (FREY),1768,2,6,8,16
6014110197 *1,CUBRE POLVO FLECHA CARDAN SPRINTER W901 A W905 (FREY),1268,0,7,0,7
602010115 *3,FILTRO COMBUSTIBLE GASOLINA BORA 2.5L 5CIL (MAHLE KL156/3),1894,9,4,6,19
6029970046 *1,Anillo de sello para Mercedes-Benz  ( FREY ),1207,8,4,9,21
6040940504-3,FILTRO ENTRADA AIRE MOTOR MERCEDES W210-M112 KOLBENSCHMIDT 50013222,1762,1,0,4,5
6040940604 *3,FILTRO ENTRADA AIRE MOTOR MERCEDES W210-M112 (MAHLE LX517),1548,5,6,7,18
6040940904,FILTRO ENTRADA AIRE MOTOR MERCEDES BENZ R170 MANN C24106,1510,6,0,6,12
6040941304,FILTRO ENTRADA AIRE MOTOR MERCEDES W202-W163 MANN C30195/2,1746,8,0,1,9
6040941304 *3,FILTRO ENTRADA AIRE MOTOR MERCEDES W202-W163 (MAHLE LX4391),1702,8,3,7,18
6040942004,FILTRO ENTRADA AIRE MOTOR MERCEDES W210-M112 MANN C34175,1906,2,4,2,8
6052010101 *1,CARCASA BOMBA AGUA ENFRIAMIENTO MOTOR MERCEDES 901 M601 M602 (FREY),1461,5,8,7,20
6062020120 *1,polea tensora Palanca Dodge Sprinter Mercedes (FREY),1908,1,1,9,11
61-35355-00 *5,JUNTA CABEZA MOTOR MEDIDA STANDAR 1.50 MM FREELANDER 2002 A 2005 V6 2.5 L (VICTOR REINZ) SSF,1690,7,1,4,12
6110104520 *1,JUEGO JUNTAS MOTOR SPRINTER W901 (FREY),1841,7,0,5,12
6110160134 *1,SEPARADOR ACEITE MOTOR VALVULA PCV SPRINTER OM611 2.7 L 5 CIL 2002 A 2006 (FREY),1443,4,3,9,16
6110170539 *1,SOPORTE PARA INYECTORES DE COMBUSTIBLE MERCEDES BEMNZ W164 W251 W220 FREY,1436,5,0,1,6
6111550315 *1,POLEA ALTERNADOR MERCEDES SPRINTER (FREY),1488,1,0,7,8
6111800009 *1,FILTRO ACEITE MOTOR SPRINTER OM611 OM646 OM651 (FREY),1474,5,9,3,17
6111800009 *3,FILTRO ACEITE MOTOR SPRINTER OM611 OM646 OM651 (MAHLE OX153/D3),1292,3,2,5,10
6112000215 *1,TERMOSTATO ENFRIAMIENTO MOTOR 87ï¿½ SPRINTER OM611 (FREY),1314,5,2,7,14
6112000270 *1,TENSOR MECANICO BANDA ACCESORIOS MOTOR SPRINTER OM611 (FREY),1759,6,3,5,14
6112300265 *1,BOMBA REFORZADORA VACIO FRENOS SPRINTER OM611 2.7 L 5 CIL 2004 A 2006 (FREY),1984,6,8,4,18
6112340293 *1,POLEA CORREA DE TRANSMISIï¿½N (FREY),1237,9,1,6,16
61126989780 *1,CABLE BATERIA ROJO POSITIVO BMW E60 (FREY),1894,9,3,1,13
61129217004 *1,CABLE BATERIA ROJO POSITIVO BMW E70 E71 (FREY),1563,8,6,0,14
61129217017 *1,CABLE BATERIA ROJO POSITIVO BMW E81 E87 (FREY),1818,8,6,0,14
61129217031 *1,CABLE BATERIA ROJO POSITIVO BMW E82 E84 E88 E90 E91 E92 (FREY),1810,6,6,3,15
61129217036 *1,CABLE BATERIA ROJO POSITIVO BMW E82 F06 F07 F10 F11 F12 F13 (FREY),1974,3,7,2,12
61129225099 *1,CABLE BATERIA ROJO POSITIVO BMW F25 (FREY),1260,5,8,7,20
61129253111 *1,CABLE BATERIA ROJO POSITIVO BMW F20 F21 F22 F23 F87 (FREY),1889,5,2,6,13
61129259425 *1,CABLE BATERIA ROJO POSITIVO BMW F30 F31 F32 F33 F34 F36 F80 F82 F83 (FREY),1277,5,9,4,18
61129322056 *1,CABLE BATERIA ROJO POSITIVO BMW F15 F16 F85 F86 (FREY),1383,7,6,5,18
6113240350 *1,BUJE MUELLE SUSPENSION TRASERA (L/R) SPRINTER W901 A W905 (FREY),1717,5,9,9,23
61136900545,MODULO DE SUMINISTRO INTEGRADO BMW E53 ( ORIGINAL SEMINUEVO ),1243,1,9,1,11
61138377762,CONECTOR DE RESISTENCIA BMW E46 GENUINO,1715,5,4,8,17
61149119445,MODULO DISTRIBUIDOR DE ENERGIA BMW E90 / N52 ( ORIGINAL BMW ),1544,1,1,9,11
6119974792,BANDA ACCESORIOS MOTOR MEDIDA 6PK 2415 MM MERCEDES W210 W224 (FREY),1335,3,9,2,14
6120500058,4 SELLOS DE VALVULA ADMISION-ESCAPE MERCEDES MOTOR M112- M113 CORTECO,1811,7,7,8,22
6120500058 *1,4 SELLOS DE VALVULA ADMISION-ESCAPE MERCEDES MOTOR M112- M113 FREY,1907,5,8,4,17
61316945874,BOTON DE CRISTALES BMW E90-N52 BMTR,1567,2,3,2,7
61316945874-1,BOTON DE CRISTALES BMW E90-N52 FREY,1415,7,8,6,21
61316967601,INTERRUPTOR DE LUZ DE FRENO BMW E87 FACET,1879,1,3,1,5
61316967601-1,INTERRUPTOR DE LUZ DE FRENO BMW E87 FREY,1510,6,5,3,14
61318360421,INTERRUPTOR DE LUZ DE FRENO BMW E46 AFTERMARKET,1329,3,0,5,8
61318360421-1,INTERRUPTOR DE LUZ DE FRENO BMW E46 FREY,1844,2,1,7,10
61318361787,SENSOR DE TEMPERATURA DE RADIADOR 80/88 Gï¿½  C. BMW E36-Z3 FACET,1235,8,1,1,10
61318361787-1,SENSOR DE TEMPERATURA DE RADIADOR 80/88 Gï¿½  C. BMW E36-Z3 FREY,1641,2,2,8,12
61318368920,BOTON DE LUCES INTERMITENTES BMW E46 BMTR,1680,5,7,9,21
61318368920-1,BOTON DE LUCES INTERMITENTES BMW E46 FREY,1859,8,0,8,16
61318376440 *1,SENSOR DE TEMPERATURA DE RADIADOR BMW E36-Z3 M44 FREY,1861,5,0,7,12
61318376440-4,SENSOR DE TEMPERATURA DE RADIADOR BMW E36-Z3 M44 FACET,1911,3,9,7,19
61318376440-7,SENSOR DE TEMPERATURA DE RADIADOR BMW E36-Z3 M44 TOPRAN,1202,6,7,5,18
61318379091,SENSOR DE ANGULO DE GIRO DE DIRECCION BMW E90 ( ORIGINAL ),1260,8,3,9,20
61318379091-1,SENSOR DE ANGULO DE GIRO DE DIRECCION BMW E90 FREY,1645,0,2,5,7
61318383226 ,MODULO DE CONTROL DE FAROS BMW E46 SEMINUEVO (ORIGINAL),1662,6,2,1,9
61319122509,SENSOR DE ANGULO DE GIRO BMW E90 / N52 ( GENUINO ),1242,1,1,7,9
61319122509-1,SENSOR DE ANGULO DE GIRO BMW E90 / N52 FREY,1805,2,0,4,6
61319123049,SENSOR DE ANGULO DE GIRO DE DIRECCION BMW E90-N52 GENUINO,1763,8,2,0,10
61319123049-1,SENSOR DE ANGULO DE GIRO DE DIRECCION BMW E90-N52 FREY,1243,2,8,9,19
61319133028,MODULO DE CONTROL DE LUCES BMW E46 / M54 ( ORIGINAL ),1603,4,7,2,13
61319217329,CONTROLADOR DE VENTANA 4 BOTONES BMW E90 BMTR,1317,0,7,8,15
61319217329-1,CONTROLADOR DE VENTANA 4 BOTONES BMW E90 FREY,1402,6,7,1,14
61319217643,BATERIA PARA LLAVE DE IGNICION BMW F30 VARTA 3.0 V CR2450,1813,2,4,8,14
61319217643-2,BATERIA PARA LLAVE DE IGNICION BMW F30 STEREN 3.0 V CR2450,1290,1,8,7,16
61319253944-1,CONTROLADOR DE SISTEMA DE NAVEGACION SEMINUEVO BMW F25 FREY,1490,1,7,4,12
61319253944-7,CONTROLADOR DE SISTEMA DE NAVEGACION SEMINUEVO BMW F25 ( GENUINO ),1888,2,6,5,13
61326901961,INTERRUPTOR DE ENCENDIDO Y ARRANQUE BMW E46-M54 FEBI,1598,5,3,8,16
61326901961-1,INTERRUPTOR DE ENCENDIDO Y ARRANQUE BMW E46-M54 FREY,1360,7,2,4,13
61349308246,ENCENDEDOR DE CIGARROS BMW E90-N52 GENUINO,1936,3,4,9,16
61349308246-1,ENCENDEDOR DE CIGARROS BMW E90-N52 FREY,1660,7,8,7,22
61353452092,MODULO DE CONTROL DE LUCES MINI R56 / N14 ( ORIGINAL ),1459,9,2,0,11
61353456588,MODULO DE CONTROL DE LUCES MINI R56 (SEMINUEVO),1954,5,8,6,19
61353457582,MODULO PORTA FUSIBLES H4 SEMI NUEVO MINI COOPER R55-R56-57-61 GENUINO,1742,6,5,9,20
61353457597,MODULO DE CONTROL DE LUCES MINI COOPER R56 / N18 ( ORIGINAL ),1253,4,2,4,10
61356827072,MODULO DE CONTROL DE LUCES MINI R56 / N14 ( ORIGINAL,1470,1,3,0,4
61356914655,MODULO DE CONTROL DE LUCES BMW E53 / M54 ( ORIGINAL ),1818,7,6,2,15
61356920822,MODULO DE CARROCERIA BMW E53 ( SEMINUEVO),1932,6,0,5,11
61356938289,MODULO DE CONTROL DE LUCES BMW E53 / M62 ( ORIGINAL ),1221,9,6,1,16
61358364946,BATERIA PARA LLAVE DE IGNICION BMW E36 VARTA 3.0 V CR1220,1986,9,2,4,15
61358382454,MODULO INMOVILIZADOR BMW E39,1858,9,0,0,9
61358382454-1,MODULO INMOVILIZADOR BMW E39 FREY,1312,5,7,6,18
6135910000000,MODULO CAS DE ENCENDIDO BMW E90 E91 E92 E87 E81 VDO SEMI NUEVO,1377,7,8,7,22
61359159811,MODULO DE CONTROL DE LUCES BMW E90 ( ORIGINAL BMW ),1916,7,8,7,22
61359159826,MODULO DE CONTROL DE LUCES BMW E90 ( ORIGINAL ),1746,8,4,7,19
61366901469,RELEEVADOR DE POTENCIA BMW E46 GENUINO,1826,1,9,9,19
61366901469-1,RELEEVADOR DE POTENCIA BMW E46 FREY,1933,2,1,8,11
61366915327,RELEVADOR MULTIPROPOSITO DE 4 TERMINALES AZUL BMW VARIOS VEMO,1392,2,3,0,5
61366915327-1,RELEVADOR MULTIPROPOSITO DE 4 TERMINALES AZUL BMW VARIOS FREY,1316,9,9,9,27
61366980177,RELEVADOR DE LIMPIAPARABRISAS BMW E90 / N52  ( ORIGINAL ),1610,3,0,6,9
61366980177-1,RELEVADOR DE LIMPIAPARABRISAS BMW E90 / N52 FREY,1515,9,1,8,18
61367661503,RELEVADOR DE MOTOVENTILADOR SEMINUEVO BMW E70 / N52N ( GENUINO ),1447,4,3,6,13
61367661503-1,RELEVADOR DE MOTOVENTILADOR SEMINUEVO BMW E70 / N52N FREY,1360,7,8,5,20
61368373700,RELEVADOR BMW E46 / E90 / E87 ( VEMO ),1457,9,4,9,22
61368373700 *2,RELEVADOR BMW E46 / E90 / E87 FREY,1993,0,8,3,11
61515901,MARCHA MOTOR DE ARRANQUE MERCEDES W164 V8 5.0 L ( BMTR ),1323,0,9,0,9
61610037009,LIMPIAPARABRISAS DELANTERO  580 MM-500 MM BMW E46 SWF,1518,0,2,8,10
61610037009-1,LIMPIAPARABRISAS DELANTERO  580 MM-500 MM BMW E46 FREY,1728,5,5,4,14
61610420549,LIMPIAPARABRISAS DELANTERO BMW E87-N46 BOSCH A922S,1883,3,0,1,4
61610420549 *1,LIMPIAPARABRISAS DELANTERO BMW E87-N46 FREY A922S,1780,7,6,7,20
61612159627,LIMPIAPARABRISAS DELANTERO BMW E90-N52N BOSCH,1352,4,0,0,4
61612159627 *1,LIMPIAPARABRISAS DELANTERO BMW E90-N52N FREY,1715,3,2,4,9
61612241375 *1,BARRA DE ACOPLAMIENTO F30 FREY,1731,8,2,3,13
61619071613 *1,KIT 2 PLUMAS LIMPIA PARABRISAS BMW E46 (FREY),1346,7,2,3,12
61667238068 *1,TAPON DEPOSITO AGUA LIMPIA PARABRISAS BMW F01 F06 F10 (FREY),1758,9,6,6,21
61667264145 *1,TAPON DE RADIADOR BMW MINI COOPER E90 (FREY),1903,8,6,6,20
61678252738,DEPOSITO DE LIQUIDO LIMPIAPARABRISAS E53 X5 SEMINUEVO (ORIGINAL),1715,7,9,0,16
62116985644,CUADRO DE INSTRUMENTOS TABLERO BMW E46 / M54 ( AUTOMATICO ORIGINAL ),1879,9,7,2,18
62119155823,AT-CUADRO INSTRUMENTOS,1331,6,4,1,11
62431143 *5,SOPORTE DE MOTOR VOLVO DELANTERO ( R ) S40 1a GEN ( PRO PARTS ) SSF,1543,6,6,5,17
62432676 *5,SOPORTE MOTOR (R) VOLVO C30 C70 S40 V50 (PRO PARTS) SSF,1537,7,6,5,18
62432676 *6,SOPORTE MOTOR (R) VOLVO C30 C70 S40 V50 (FEBI) SSF,1845,5,3,2,10
62436498 *5,SOPORTE MOTOR (L) VOLVO C30 C70 S40 V50 (PRO PARTS) SSF,1506,0,2,9,11
62436498 *6,SOPORTE MOTOR (L) VOLVO C30 C70 S40 V50 (FEBI) SSF,1502,7,8,8,23
627484-1,BANDA DE DISTRIBUCION VOLVO S40 2a GEN. CONTINENTAL,1671,8,2,0,10
63112296305,FOCO DE XENON D2S BMW E46 8000 K,1252,0,9,5,14
63112296305 *2,KIT 2 PZ FOCO XENON D2S LUZ BLANCA 4500K 35W MERCEDES AUDI VW BMW MINI VOLVO (EMBLER) MLL,1506,1,1,8,10
63112296305 *3,KIT 2 PZ FOCO XENON D2S LUZ AZUL 7500K 35W MERCEDES AUDI VW BMW MINI VOLVO (EMBLER) MLL,1572,9,7,3,19
63112296305 *4,KIT 2 PZ FOCO XENON D2S LUZ BLANCA 5500K 35W MERCEDES AUDI VW BMW MINI VOLVO (EMBLER) MLL,1331,2,2,2,6
63112296305-1,FOCO DE LUZ XENON D2S SIN IGNITOR 4300 ( XENPLUS ),1213,9,1,3,13
63112296305-2,FOCO DE XENON D2S BMW E46 6000 K,1517,8,0,4,12
63112296305-3,FOCO DE XENON D2S BMW E46 1200 K,1894,0,6,1,7
63112338064 *3,KIT 2 PZ FOCO XENON D1S LUZ BLANCA XENON 5500K 35W MERCEDES AUDI VW BMW MINI VOLVO (EMBLER) MLL,1743,1,7,7,15
63112338064 *4,KIT 2 PZ FOCO XENON D1S LUZ AZUL XENON 7500K 35W MERCEDES AUDI VW BMW MINI VOLVO (EMBLER) MLL,1375,5,3,0,8
63117180050 *1,BALASTRA MODULO ELECTRONICO LUZ XENON D1S AUDI BMW E81 E82 E87 E88 VOLVO (FREY),1640,8,8,9,25
63117180050 *2,BALASTRA MODULO ELECTRONICO LUZ XENON D1S AUDI BMW E81 E82 E87 E88 VOLVO (EMBLER) MLL,1488,5,0,7,12
63117180050-100,BALASTRA DE CONTROL DE LUZ XENON BMW E87 INACTIVO,1375,5,4,2,11
63117182520 *2,BALASTRA MODULO ELECTRONICO LUZ XENON BMW MINI AUDI (EMBLER) MLL,1787,9,3,7,19
63117182520 *4,BALASTRA CONTROL LUZ XENON BMW E90 (ORIGINAL),1253,2,6,8,16
63117229671 *4,FARO LUZ HALOGENO DELANTERO (L) BMW F20 (EMBLER) YIW,1729,5,6,8,19
63117229672 *4,FARO LUZ HALOGENO DELANTERO (R) BMW F20 (EMBLER) YIW,1936,3,5,1,9
63117240791 *4,FARO LUZ XENON DELANTERO (L) BMW E70 (EMBLER) YIW,1844,7,0,1,8
63117240793 *4,FARO LUZ XENON DELANTERO (R) BMW E70 (EMBLER) YIW,1540,7,7,9,23
63117240799 *2,MODULO LED LUZ DIURNA OJO ANGEL (L/R) BMW E70 F06 F15 F16 F25 F32 F80 (EMBLER) MLL,1771,5,3,6,14
63117259523 *4,FARO LUZ HALOGENO DELANTERO (L) BMW F30 F31 (EMBLER) YIW,1884,4,7,8,19
63117259524 *4,FARO LUZ HALOGENO DELANTERO (R) BMW F30 (EMBLER) YIW,1702,3,1,8,12
63117271901,MODULO LED DE LUZ DIRECCIONAL DELANTERA ( L ) BMW F10 F11 ( XENPLUS ),1639,1,0,1,2
63117271902,MODULO LED DE LUZ DIRECCIONAL DELANTERA ( R ) BMW F10 F11 ( XENPLUS ),1225,0,7,5,12
63117290239 *4,FARO LUZ DELANTERA XENON (L) BMW E84 (EMBLER) YIW,1776,4,8,4,16
63117290240 *4,FARO LUZ DELANTERA XENON (R) BMW E84 (EMBLER) YIW,1973,5,0,3,8
63117296905,MODULO LED DE LUZ DIURNA DE OJO DE ANGEL ( L / R ) BMW F20 F21 ( XENPLUS ),1368,9,4,9,22
63117316147 *1,MODULO DE CONTROL DE FAROS BMW F30 ( FREY ),1974,4,2,4,10
63117317408 *2,BALASTRA MODULO ELECTRONICO LUZ XENON D1S MERCEDES BMW MINI VOLVO (EMBLER) MLL,1561,4,4,0,8
63117343876,MODULO LED DE LUZ DIURNA OJO DE ANGEL ( L / R ) BMW F10 F11 ( XENPLUS ),1449,9,8,6,23
63117354974 *3,MODULO LED LUZ BOMBILLA (L) BMW (EMBLER),1794,9,9,3,21
63117358393 *4,FARO LUZ HALOGENO LED DELANTERO (L) BMW F20 (EMBLER) YIW,1914,8,2,7,17
63117358394 *4,FARO LUZ HALOGENO LED DELANTERO (R) BMW F20 (EMBLER) YIW,1708,4,7,8,19
63117381137 *4,FARO LUZ LED DELANTERO (L) BMW F15 F16 (EMBLER) YIW,1713,7,1,1,9
63117381138 *4,FARO LUZ LED DELANTERO (R) BMW F15 F16 (EMBLER) YIW,1214,3,9,8,20
63117398766 *2,MODULO LED LUZ DIURNA OJO ANGEL (L/R) BMW F30 F31 F34 (EMBLER) MLL,1998,7,5,6,18
63117419615,MODULO LED DE LUZ FAROS DELANTEROS ( L / R ) BMW F30 F31 ( XENPLUS ),1918,6,6,5,17
63117419619,MODULO LED DE LUZ DIRECCIONAL DELANTERA ( L ) BMW F30 F31 F35 ( XENPLUS ),1374,8,7,9,24
63117419620,MODULO LED DE LUZ DIRECCIONAL DELANTERA ( R ) BMW F30 F31 F35 ( XENPLUS ),1483,7,2,2,11
63117419629 *4,FARO LUZ DELANTERO FONDO BLANCO (L) BMW F30 (EMBLER) YIW,1732,5,3,3,11
63117419629N *4,FARO LUZ DELANTERO FONDO NEGRO (L) BMW F30 (EMBLER) YIW,1637,4,9,0,13
63117419630 *4,FARO LUZ DELANTERO FONDO BLANCO (R) BMW F30 (EMBLER) YIW,1706,5,8,7,20
63117419630N *4,FARO LUZ DELANTERO FONDO NEGRO (R) BMW F30 (EMBLER) YIW,1241,6,3,5,14
63117457875 *2,UNIDAD CONTROL ELECTONICO LUCES LED BALASTRA BMW F20 F22 F30 F32 F15 F16 (XENPLUS) MLL,1803,0,4,8,12
63117457875 *22,UNIDAD CONTROL DE LUCES LED BMW F15 F16 F20 F22 F30 F32 (XENPLUS) MILL,1355,9,2,7,18
63118496153 *4,FARO LUZ DELANTERO FONDO NEGRO (L) BMW G20 (EMBLER) YIW,1971,0,2,1,3
63118496154 *4,FARO LUZ DELANTERO FONDO NEGRO (R) BMW G20 (EMBLER) YIW,1258,9,5,0,14
63122751875 *4,FARO LUZ DELANTERA CON TUBO DE LED (R) MINI R56 (EMBLER) YIW,1698,7,6,2,15
63122751876 *4,FARO LUZ DELANTERA CON TUBO DE LED (L) MINI R56 (EMBLER) YIW,1599,1,6,1,8
63126904048,FOCO PARA OJO DE ANGEL BMW E39-E83-E87 HELLA,1458,5,8,3,16
63126907488 *2,BALASTRA MODULO ELECTRONICO LUZ XENON D1S MERCEDES AUDI VW BMW (EMBLER) MLL,1247,9,5,4,18
63126919886 *2,IGNITOR ARRANCADOR LUX XENON D2S BMW E43 E63 E83 MINI R50 R52 R53 (EMBLER) MLL,1865,1,4,6,11
63126937223 *2,BALASTRA MODULO ELECTRONICO LUZ XENON D1S BMW MERCEDES AUDI VW (EMBLER) MLL,1331,9,3,2,14
63126938561 *2,BALASTRA MODULO ELECTRONICO LUZ XENON D1S AUDI BMW E87 VOLVO (EMBLER) MLL,1904,3,7,9,19
63126938561-101,BALASTRA DE CONTROL LUZ XENON BMW VOLVO AUDI INACTIVO,1919,8,7,3,18
63126948180 *2,BALASTRA MODULO ELECTRONICO LUZ XENON D1S BMW E90 E91 (EMBLER) MLL,1208,0,9,7,16
63127176068 *2,BALASTRA MODULO ELECTRONICO LUZ XENON D3S BMW E46 E63 E83 MINI R50 R53 R53 (EMBLER) MLL,1552,8,3,5,16
63127176068-100,BALASTRA DE CONTROL DE LUZ XENON D1S BMW E46 W203 JETTA V INACTIVO,1688,9,8,7,24
63127189312 *2,MODULO CONTROL ADAPTACION LUCES XENON SIN CODIFICAR BMW E46 E60 E65 E90 (EMBLER) MLLL,1776,8,8,7,23
63127189312-1,BALASTRA DE CONTROL DE LUZ XENON BMW E46-E90-E60-E65 ( XENPLUS ),1499,8,2,1,11
63127245813,MODULO LED DE LUZ DIRECCIONAL DELANTERA ( L ) BMW E90 E91 ( XENPLUS ),1637,7,4,9,20
63127245814,MODULO LED DE LUZ DIRECCIONAL DELANTERA ( R ) BMW E90 E91 ( XENPLUS ),1476,8,0,1,9
63127262731,MODULO LED DE LUZ DIURNA DE OJO DE ANGEL ( L / R ) BMW F07 F10 ( XENPLUS ),1276,7,2,9,18
63128380207,PORTALAMPARA DE FARO DE LUZ ALTA BMW E46 ( GENUINO ),1887,9,2,6,17
63137165847,CUARTO DELANTERO ( L ) BMW E46 ( NEGRO / AMBAR ),1670,2,4,9,15
63137165848,CUARTO DELANTERO ( R ) BMW E46 ( NEGRO / AMBAR ),1234,8,9,6,23
63137165853,CUARTO DELANTERO ( L ) BMW E46 (TITANIO 4 PUERTAS),1491,2,4,0,6
63137165854,CUARTO DELANTERO ( R ) BMW E46 (TITANIO 4 PUERTAS),1329,2,6,8,16
63137165860,CUARTO DELANTERO DERECHO AMBAR 4 PUERTAS  BMW E46,1483,8,5,2,15
63138353278 *3,LUZ INTERMITENTE DELANTERA (R) COLOR AMBAR BMW E36 (TYC),1356,7,8,3,18
63216907945 *3,CALAVERA LUZ TRASERA (L) BMW E46 (TYC),1251,2,3,1,6
63216907946 *3,CALAVERA LUZ TRASERA (R) BMW E46 (TYC),1436,9,7,0,16
63216945941 *2,KIT 2 PZ FOCO XENON D1S LUZ BLANCA XENON 4500K 35W MERCEDES AUDI VW BMW MINI VOLVO (EMBLER) MLL,1258,8,5,8,21
63216946533,INTER CALAVERA DE CAJUELA L BMW E46 4 PUERTAS BLACA-AMBAR,1236,7,9,5,21
63216946534,INTER CALAVERA DE CAJUELA R BMW E46 4 PUERTAS BLACA-AMBAR,1902,5,1,9,15
63217160780,FOCO DE ALOGENO BMW HELLA H7 12V-55W,1932,2,6,2,10
63217289428,CALAVERA TRASERA DERECHA BMW E90 NUEVA,1565,2,4,9,15
63217297413JRRL *4,CALAVERA TRASERA (L) JACK RED ROJAS MINI F55 F56 (EMBLER) YIW,1308,5,2,9,16
63217297413JSHL *4,CALAVERA TRASERA (L) JACK SMOKED HUMO MINI F55 F56 (EMBLER) YIW,1690,7,6,1,14
63217297413JSRL *4,CALAVERA TRASERA (L) JACK SMOKED RED MINI F55 F56 (EMBLER) YIW,1323,8,9,4,21
63217297414JRRR *4,CALAVERA TRASERA (R) JACK RED ROJAS MINI F55 F56 (EMBLER) YIW,1273,3,4,2,9
63217297414JSHR *4,CALAVERA TRASERA (R) JACK SMOKED HUMO MINI F55 F56 (EMBLER) YIW,1314,3,2,6,11
63217297414JSRR *4,CALAVERA TRASERA (R) JACK SMOKED RED MINI F55 F56 (EMBLER) YIW,1413,9,0,9,18
63218495331 *4,MOLDURA BICEL CALAVERA TRASERA (L) MINI F55 F56 (EMBLER) YIW,1464,4,8,7,19
63218495332 *4,MOLDURA BICEL CALAVERA TRASERA (R) MINI F55 F56 (EMBLER) YIW,1427,9,3,2,14
6363500010,EJE DE ACOPLAMIENTO MERCEDES W636-W639 FREY,1719,9,9,0,18
6364660424 *1,MANGUERA DIRECCION ALTA PRECION MERCEDES VITO VIANO OM636 (FREY),1203,7,7,5,19
6365010382 *1,MANGUERA DE ADMISION MERCEDES BENZ W636 FREY,1811,0,8,9,17
6365010482 *1,MANGUERA DE AGUA REFRIGERANTE MERCEDES BENZ W636 FREY,1782,4,7,6,17
6365010682 *1,MANGUERA REFRIGERANTE MERCEDES BENZ W636 FREY,1567,6,2,2,10
6365010782 *1,MANGUERA DE RADIADOR MERCEDES BENZ W636 FREY,1383,3,6,8,17
6368321023 *1,MANGUERA DE CALEFACCION  SPRINTER OM646 OM651 W636 FREY,1845,2,4,7,13
6368321423 *1,TUBO DE RETORNO DE MANGUERA SPRINTER OM646 OM651 W636 FREY,1553,6,0,6,12
6368321923 *1,MANGUITO DE REFRIGERACIï¿½N DE RADIADOR MERCEDES BENZ W636 FREY,1635,3,6,9,18
6392410413 *1,SOPORTE DE MOTOR (L) MERCEDES VITO W639 (FREY),1986,6,9,6,21
6393200404 *C,COMPRESOR AIRE SUSPENSION MERCEDES VITO W639 (EMBLER) TECH,1921,9,2,3,14
6393280201 *B,BOLSA AIRE SUSPENSION TRASERA (L/R) VITO VIANO (EMBLER) TECH,1298,6,3,4,13
6393301207 *1,HORQUILLA INFERIOR SUSPENSION DELANTERA (L) MERCEDES VITO W636 W639 (FREY),1988,3,7,6,16
6393301307 *1,HORQUILLA INFERIOR SUSPENSION DELANTERA (R) MERCEDES VITO W636 W639 (FREY),1851,2,2,9,13
6393506101,BUJE DE BRAZO TRASERO MERCEDES W639 FREY,1999,3,2,4,9
6394409734 *1,SENSOR FRENOS ABS RUEDA TRASERA (L) VITO VIANO W639 (FREY),1402,6,4,5,15
6394409834 *1,SENSOR FRENOS ABS RUEDA TRASERA (R) VITO VIANO W639 (FREY),1578,5,8,7,20
6395000193 *1,MOTOVENTILADOR DE MOTOR DELANTERO MERCEDES VITO W639 (FREY),1696,1,6,4,11
6395000593 *1,MOTOVENTILADOR DE MOTOR MERCEDES MERCEDES VITO W639 (FREY),1448,2,9,0,11
6395401017 *1,SENSOR FRENOS ABS RUEDA DELANTERA (L/R) VITO VIANO W639 (FREY),1884,9,7,2,18
6397200300 *1,CERRADURA CHAPA ACTUADOR ELECTRICO DELANTERO (L) SPRINTER VITO W639 (FREY),1389,3,3,6,12
6398322023 *1,MANGUERA DE BOMBA DE AGUA PARA MERCEDES-BENZ W636 W639 FREY,1468,8,7,8,23
6402000301 *1,BOMBA AGUA MECANICA ENFRIAMIENTO MOTOR MERCEDES W169 W245 M266 (FREY),1642,0,5,6,11
6411-100,FILTRO  AIRE DE CABINA BMW INACTIVO,1635,8,0,7,15
64113422665 *6,FILTRO POLEN AIRE CABINA CON CARBON ACTIVADO MINI R50 R55 R56 R57 R58 R59 R60 R61 (UNIFIL),1927,3,7,2,12
64113453729,BLOWER DE AIRE ACONDICIONADO BMW E46,1584,8,6,1,15
64113453729 *1,BLOWER SOPLADOR AIRE ACONDICIONADO BMW E46 (FREY),1251,1,1,7,9
64116823724 *5,KIT 2 PZ FILTROS POLEN AIRE CABINA SIN CARBON BMW F39 F45 F48 MINI F54 F55 F56 F57 F60 (MANN) SSF,1418,5,4,3,12
64116823724 *6,KIT 2 PZ FILTROS POLEN AIRE CABINA SIN CARBON BMW F39 F40 F45 F48 MINI F54 F55 F56 F57 F60 (MAHLE) SSF,1326,3,0,8,11
64116823725 *1,KIT 2 PZ FILTROS POLEN AIRE CABINA CARBON ACTIVO BMW F39 F40 F45 F48 MINI F54 F55 F56 F57 F60 (FREY),1547,8,1,9,18
64116834917 *1,BOMBA DE AGUA AUXILIAR BMW B48 G11 G12 G20 G30 G31 G32 (FREY),1576,9,8,5,22
64116834923 *1,BOMBA AGUA AUXILIAR ELECTRICA ENFRIAMIENTO MOTOR BMW F90-F93 G11-G16 G30-G32 (FREY),1247,8,7,0,15
641169-100,FILTRO DE AIRE DE CABINA BMW INACTIVO,1649,2,6,2,10
64116906652 *1,VALVULA SOLENOIDE CONTROL CALEFACCION BMW E53 E60 E65 M54 N52N N62N (FREY),1974,1,2,4,7
64116907811 *1,BOMBA AGUA AUXILIAR ELECTRICA ENFRIAMIENTO MOTOR  BMW E53 E60 M54 N62 M62 (FREY),1347,9,5,4,18
64116907811 *2,BOMBA AGUA AUXILIAR ELECTRICA ENFRIAMIENTO MOTOR BMW E53 E60 M54 N62 M62 (PIERBUG),1510,9,1,4,14
64116910544,VALVULA SOLENOIDE CONTROL DE CALEFACCION BMW E53 - N62  GENUINA,1390,6,2,7,15
64116910544 *1,VALVULA SOLENOIDE CONTROL CALEFACCION BMW E53 E70 E71 F15 F16 N20 N54 N55 N62 N62N N63N (FREY),1497,9,4,6,19
64116918873,RESISTENCIA DE AIRE ACONDICIONADO BMW E65-N62 BMTR,1675,3,6,8,17
64116918873-1,RESISTENCIA DE AIRE ACONDICIONADO BMW E65-N62 FREY,1661,6,5,4,15
64116923204 *1,ERIZO RESISTENCIA BLOWER AIRE ACONDICIONADO BMW E39 E46 E53 E83 (FREY),1293,9,5,7,21
64116923204 *2,ERIZO RESISTENCIA BLOWER AIRE ACONDICIONADO (BMW) E39 E46 E53 E83 (EMBLER),1461,0,6,1,7
64116923204 *5,ERIZO RESISTENCIA BLOWER AIRE ACONDICIONADO BMW E39 E46 E53 E83 (MAHLE) SSF,1380,9,9,6,24
64116923204-100,RESISTENCIA DE AIRE ACONDICIONADO ERIZO BMW E46 ( KZR GERMANY ) INACTIVO,1611,4,1,3,8
64116927898,MODULO DE AIRE ACONDICIONADO BMW E53,1364,2,2,7,11
64116927898-1,MODULO DE AIRE ACONDICIONADO BMW E53 FREY,1223,3,7,5,15
64116928246 *3,VALVULA SOLENOIDE CONTROL CALEFACCION BMW E87 N46 (EMBLER),1342,0,4,4,8
64116933663,SOPLADOR DE AIRE ACONDICIONADO BLOWER BMW E90 (EMBLER),1416,2,0,3,5
64116933663 *1,MOTOR SOPLADOR BLOWER AIRE ACONDICIONADO BMW E81 E82 E84 E87-E89 E90-E93 F25 F26 (FREY),1461,2,8,6,16
64116933663-2,SOPLADOR DE AIRE ACONDICIONADO BLOWER BMW E90 ( URO ),1977,8,6,7,21
64118369805,VALVULA SOLENOIDE CONTROL DE CALEFACCION BMW E46 - M54  FEBI,1983,5,0,1,6
64118369805 *1,VALVULA SOLENOIDE CONTROL DE CALEFACCION BMW E46 - M54  (FREY),1887,9,1,2,12
64118372493,BLOWER DE AIRE ACONDICIONADO BMW E39 FREY,1456,7,2,5,14
64118375792,VALVULA DE AGUA HVAC BMW E36,1958,2,7,3,12
64118375792-1,VALVULA DE AGUA HVAC BMW E36 FREY,1539,2,6,2,10
64119069895 *3,FILTRO POLEN AIRE CABINA BMW E36-M52 (MAHLE LA80),1205,3,8,0,11
64119163329 *1,KIT 2 PZ. FILTRO POLEN AIRE CABINA CARBON ACTIVO BMW F01 F10 F12 (FREY),1977,2,4,4,10
64119237159,FILTRO POLEN AIRE CABINA X3 F25 X4 F26 KOLBENSCHMIDT,1258,3,4,9,16
64119237159 *1,FILTRO POLEN AIRE CABINA BMW X3 F25 X4 F26 (FREY),1521,3,3,2,8
64119237159 *3,FILTRO POLEN AIRE CABINA BMW X3 F25 X4 F26 (MAHLE LA873/S),1864,2,3,5,10
64119237159 *4,FILTRO POLEN AIRE CABINA BMW X3 F25 X4 F26 (FEBI),1908,1,0,4,5
64119237159-1,FILTRO POLEN AIRE CABINA X3 F25 X4 F26 TOPRAN,1618,0,4,9,13
64119237554 *1,FILTRO POLEN AIRE CABINA CARBON ACTIVO BMW F20 F22 F30 F32 (FREY),1939,0,6,3,9
64119237555 *3,FILTRO POLEN AIRE CABINA CARBON ACTIVO BMW F20 F22 F30 F32 (MAHLE LAK812),1946,8,4,3,15
64119237555 *5,FILTRO POLEN AIRE CABINA CARBON ACTIVO BMW F20 F22 F30 F32 (HENGST) SSF,1331,9,8,6,23
64119248294-100,FILTRO POLEN AIRE CABINA CARBON ACTIVO BMW E70 E71 F16 INACTIVO,1814,3,2,2,7
64119265892,RESISTENCIA DE AIRE ACONDICIONADO  BMW  E90-F25-E70 BMTR,1985,7,3,9,19
64119265892-1,RESISTENCIA DE AIRE ACONDICIONADO  BMW  E90-F25-E70 FREY,1494,6,5,4,15
64119272642 *3,KIT 2 PZ. FILTRO POLEN AIRE CABINA CARBON ACTIVO BMW F01 F10 F12 (MAHLE LAK467/S),1838,7,5,3,15
64119366403 *1,FILTRO AIRE CABINA BMW G11 G12 G30 G31 G32 (FREY),1461,5,4,6,15
64119382885 *1,FILTRO POLEN AIRE CABINA CARBON ACTIVO BMW G20 G01 G02 G29 (FREY),1946,6,0,4,10
64200120,BALATAS FRENOS TRASEROS MERCEDES W211 BREMBO CERAMICA P50052N,1702,3,8,4,15
6420162120 *1,JUNTA CABEZA MOTOR (R) MEDIDA STANDAR 1.20 MM DIAMETRO 84 MM SPRINTER OM642 (FREY),1351,3,1,1,5
6420162220 *1 ,JUNTA CABEZA MOTOR (L) MEDIDA STANDAR 1.20 MM DIAMETRO 84 MM SPRINTER OM642 (FREY),1372,8,9,3,20
64206220-1,BALATAS FRENOS DELANTEROS 131X69 MM  MERCEDES W203 BREMBO P50045N,1515,0,3,6,9
6420900552-1,FILTRO COMBUSTIBLE GASOLINA MERCEDES MANN  WK842/23x,1752,2,2,6,10
6420902352 *3,FILTRO COMBUSTIBLE DIESEL MERCEDES BENZ SPRINTER (MAHLE KL490/1D),1732,4,5,0,9
6420920401 *3,FILTRO COMBUSTIBLE GASOLINA MERCEDES W245 W203 (MAHLE KL228/2D),1500,1,2,3,6
6420940000 *1,FILTRO POLEN AIRE CABINA ( KIT 2 PIEZAS ) MERCEDES W164-X164 (FREY),1960,3,3,0,6
6420980037 *1,COLECTORES DE ASPIRACIï¿½N MERCEDES BENZ W203 W211 FREY,1209,1,8,9,18
64216910757 *1,MANGERA DE RADIADOR BMW N54 FREY,1802,3,3,6,12
64216910758 *1,MANGUERA DE RADIADOR N46 FREY,1381,7,3,7,17
64216911000 *1,MANGUERA DE RADIADOR M54 FREY,1216,3,5,4,12
64216918912,MANGUERA DE RETORNO DE RADIADOR BMW E53-N62 GENUINA,1775,8,5,2,15
64216918912 *1,MANGUERA AGUA CALEFACCION RETORNO A MOTOR BMW E53 (FREY),1388,5,6,5,16
64216928590 *2,MANGUERA AGUA DE ENFRIADOR ANTICONGELANTE BMW E81 E82 E84 E87-E93 (EMBLER),1698,9,5,2,16
64216932051,MANGERA DE RADIADORBMW N62 FREY,1664,9,9,5,23
64216938433,MANGUERA DE RADIADOR N52 FREY,1398,0,3,1,4
64216951946,MANGUERA DE RETORNO RADIADOR BMW E90 N52 DAYCO,1800,5,3,4,12
64216960026,MANGUERA RADIADOR CALENTADOR BMW E90 N52 GENUINO,1600,1,3,4,8
64216983858 *1,MANGUERA AGUA CALEFACCION A ENFRIADOR ACEITE MOTOR BMW E84 E88 E90 N54 N55 (FREY),1499,5,9,4,18
64216983858 *5,MANGUERA AGUA CALEFACCION A ENFRIADOR ACEITE MOTOR BMW E84 E88 E90 N54 N55 (ORIGINAL BMW),1818,8,4,8,20
6421800165 *1,ENFRIADOR DE ACEITE MERCEDES / SPRINTER2500 W164 W211 R320 E320 FREY,1922,9,6,1,16
64218376153,MANGUERA DE DEPOSITO DE ANTICONGELANTE BMW E46-M54 REIN,1894,3,0,2,5
64218376153-1,MANGUERA DE DEPOSITO DE ANTICONGELANTE BMW E46-M54 FREY,1558,2,2,6,10
64218409064 *1,TUBO PARA VALVULA DE AGUA Y RADIADOR BMW M54 FREY,1960,4,9,4,17
64219178427 *1,MANGUERA RADIADOR CALENTADOR BMW E90 N52 (FREY),1214,8,0,9,17
64219178427 *2,MANGUERA RADIADOR CALENTADOR BMW E90 N52 (EMBLER),1494,8,5,3,16
6422000215 *1,TERMOSTATO DE MOTOR MERCEDES W164 (FREY),1203,3,1,4,8
6422000420 *1,SOPORTE VENTILADOR DE RADIADOR SPRINTER 9060 FREY,1925,1,3,8,12
6423754-100,FILTRO DE AIRE DE CAA BMW INACTIVO,1447,3,6,5,14
6429050000 *1,SENSOR POSICION CIGUEï¿½AL MOTOR MERCEDES M156 M272 M273 SPRINTER OM642 (FREY),1436,6,8,4,18
6429050000 *5,SENSOR POSICION CIGUEï¿½AL MOTOR MERCEDES M156 M272 M273 SPRINTER OM642 (BREMI),1652,8,7,5,20
6429050200 *1,SENSOR DE PRESION DIFERENCIA DE ESCAPE MERCEDES BENZ W463 W251 FREY,1254,7,7,2,16
64312218428-1,FILTRO POLEN AIRE CABINA BMW E53 AIRMATIC,1658,5,9,7,21
64312284828 *1,FILTRO AIRE CABINA BMW F25 F26 (FREY),1656,5,0,6,11
64316835406 *1,KIT 2 PZ FILTROS POLEN AIRE CABINA SIN CARBON BMW F39 F45 F48 MINI F54 F55 F56 F57 F60 (FREY),1886,3,4,1,8
64316835406 *3,KIT 2 PZ FILTROS POLEN AIRE CABINA SIN CARBON BMW F39 F45 F48 MINI F54 F55 F56 F57 F60 (KOLBENSCHMIDT),1607,4,7,4,15
643169-100,FILTRO DE AIRE DE CABINA INACTIVO,1646,4,5,8,17
64316945586 *1,KIT 2 PZ. FILTRO POLEN AIRE CABINA CARBON ACTIVO BMW E70 E71 E72 F16 (FREY),1782,2,9,5,16
64316945586 *3,KIT 2 PZ. FILTRO POLEN AIRE CABINA CARBON ACTIVO BMW E70 E71 E72 (MAHLE LAK221/S),1783,2,5,8,15
643190719-100,FILTRO DE AIRE DE CABINA BMW E83 MANN INACTIVO,1765,5,1,3,9
64319071935 *2,FILTRO POLEN AIRE CABINA CARBON ACTIVADO BMW E46 E83 (AIRMATIC),1456,0,6,7,13
64319071935 *3,FILTRO POLEN AIRE CABINA CARBON ACTIVADO BMW E46 E83 (MAHLE LAK197),1455,3,0,7,10
64319127515,FILTRO POLEN AIRE CABINA MINI R56-N14 MANN CU4436,1687,2,2,3,7
64319127515 *5,FILTRO POLEN AIRE CABINA MINI R56 - N14 (CORTECO) SSF,1559,6,6,9,21
64319127516 *1,FILTRO POLEN AIRE CABINA CARBON ACTIVO MINI R50 R52 R53 R55 R56 R57 R58 R59 R60 R61 (FREY),1417,3,4,2,9
64319127516 *3,FILTRO POLEN AIRE CABINA CARBON ACTIVO MINI R50 R55 R56 R57 R58 R59 R60 R61 (MAHLE) DGO,1327,8,9,7,24
64319127516 *4,FILTRO POLEN AIRE CABINA CON CARBON ACTIVADO MINI R50 R55 R56 R57 R58 R59 R60 R61 (MAHLE LAK171),1329,1,7,6,14
64319127516 *5,FILTRO POLEN AIRE CABINA CARBON ACTIVO MINI R50 R55 R56 R57 R58 R59 R60 R61 (MANN) SSF,1399,2,3,4,9
64319142115 *1,FILTRO POLEN AIRE CABINA CON CARBON ACTIVO BMW E81 E82 E84 E87 E88 E90 E91 E92 E93 (FREY),1408,0,4,3,7
64319142115 *3,FILTRO POLEN AIRE CABINA CARBON ACTIVO BMW E81 E84 E90 (MAHLE LAK248),1634,3,9,1,13
64319171858 *1,KIT 2 PZ. FILTRO POLEN AIRE CABINA CARBON ACTIVO BMW E60 E63 (FREY),1277,7,1,4,12
64319171858 *3,1 PZ FILTRO POLEN AIRE CABINA CARBON ACTIVO BMW E60 E63 (MAHLE LAK197),1900,4,8,4,16
64319194098 *1,FILTRO POLEN AIRE CABINA BMW E70 E71 E72 F15 F16 F85 F86 (FREY),1650,6,2,9,17
64319195193 *3,FILTRO POLEN AIRE CABINA BMW Z4 E85 MAHLE LAK234,1978,0,6,2,8
643192157-100,FILTRO POLEN AIRE CABINA CARBON ACTIVO INACTIVO,1658,7,3,8,18
643192165-100,FILTRO DE AIRE DE CABINA BMW E46-M54 INACTIVO,1257,1,1,4,6
64319224085 *1,FILTRO POLEN AIRE CABINA BMW E53 RANGER ROVER 3a GEN 2002 A 2012 (FREY),1936,5,5,4,14
64319224085 *3,FILTRO POLEN AIRE CABINA BMW E53 RANGER ROVER 3a GEN 2002 A 2012 (MAHLE LAK62),1641,6,1,5,12
64319237157 *1,KIT 2 PZ. FILTRO POLEN AIRE CABINA CARBON ACTIVO BMW F25 F26 (FREY),1562,1,4,7,12
64319257504 *1,FILTRO POLEN AIRE CABINA CARBON ACTIVADO BMW E46 E83 (FREY),1447,7,2,7,16
64319257504 *3,FILTRO POLEN AIRE CABINA BMW E83 (MAHLE LAK102),1958,0,4,5,9
643193135-100,FILTRO DE AIRE DE CABINA BMW E90-N5 INACTIVO,1591,8,1,9,18
64319313517 *3,FILTRO POLEN AIRE CABINA BMW E81 E84 E90 (MAHLE LA248),1689,1,6,0,7
64319313519 *5,FILTRO POLEN AIRE CABINA CARBON ACTIVO BMW E81 E84 E90 (CORTECO) SSF,1332,6,1,1,8
64319313519-1,FILTRO POLEN AIRE CABINA BMW E90-N52 MANN CU8430,1913,4,3,2,9
64508364093,MOTOVENTILADOR BMW E36-M44 ACM ALEMAN,1898,1,1,2,4
64508364093-1,MOTOVENTILADOR BMW E36-M44 ACM ALEMAN  FREY,1900,7,8,0,15
64509154072 *1,COMPRESOR DE AIRE ACONDICIONADO E70 E71 F01 F02 F03 F06 F07 F10 F11 F13 F15 F16 F85 F86 (FREY),1566,9,2,4,15
64509174803 *1,COMPRESOR DE AIRE ACONDICIONADO E60 530I N52N (FREY),1440,4,1,0,5
64526824483 *1 ,COMPRESOR AIRE ACONDICIONADO BMW N20 F18 F35 F30 E84 (FREY),1820,0,1,2,3
64526826879 *1 ,COMPRESOR AIRE ACONDICIONADO BMW MINI B38 G12 G11 F52 F4 (FREY),1407,8,9,1,18
64526918000 *C,COMPRESOR AIRE ACONDICIONADO BMW E53 (EMBLER),1736,8,2,6,16
64526956716 *C,COMPRESOR AIRE REMANUFACTURADO  BMW E90 (ORIGINAL),1586,7,4,5,16
64529122618 *1,COMPRESOR AIRE SUSPENSION BMW E81 E82 E84 E87 E88 E90 E91 E92 E93 (FREY),1283,8,1,4,13
64529165808 *1,COMPRESOR AIRE ACONDICIONADO BMW N52N N53 (FREY),1837,0,8,9,17
64529182793 *2,COMPRESOR DE AIRE ACONDICIONADO BMW E87 N46 (EMBLER) GOG,1203,8,2,5,15
64529185144 *C,COMPRESOR AIRE REMANUFACTURADO BMW E70 (ORIGINAL),1342,5,6,4,15
64529185145 *1,COMPRESOR AIRE SUSPENSION BMW E70 (FREY),1227,3,0,7,10
64529222308 *1,COMPRESOR AIRE SUSPENSION BMW F20 F21 F30 F31 (FREY),1529,8,8,9,25
64529222308 *C,COMPRESOR AIRE ACONDICIONADO BMW F20 F30 N13 (GENUINO),1573,3,0,2,5
64529223694 *C,COMPRESOR AIRE ACONDICIONADO BMW F20 (DENSO),1460,5,7,1,13
64529299328 *1 ,COMPRESOR AIRE ACONDICIONADO BMW MINI B48 F35 F34 F30 F20 (FREY),1322,5,3,3,11
64529299329 *1,COMPRESOR AIRE SUSPENSION BMW F20-F23 F30-F36 (FREY),1404,4,4,3,11
64536909257,SENSOR DE PRESION DE AIRE ACONDICIONADO BMW E46,1384,3,0,2,5
64536909257-1,SENSOR DE PRESION DE AIRE ACONDICIONADO BMW E46 FREY,1947,7,0,0,7
64538377614,RADIADOR AIRE ACONDICIONADO BMW E46 SEMINUEVO (ORIGINAL),1302,8,7,0,15
64538381543,RADIADOR DE AIRE ACONDICIONADO E53 SEMINUEVO (ORIGINAL),1393,7,3,0,10
64539181464,SENSOR DE PRESION DE AIRE ACONDICIONADO MINI COOPER R50 GENUINO,1665,0,4,7,11
64539181464-5,SENSOR DE PRESION DE AIRE ACONDICIONADO MINI COOPER R50 TOPRAN,1259,9,2,6,17
64542228432,MOTOVENTILADOR SEMINUEVO BMW Z3-E36 M52 GENUINO,1728,3,8,5,16
64542228432 *1,MOTOVENTILADOR SEMINUEVO BMW Z3-E36 M52 FREY,1244,2,1,3,6
64546921379,MOTOVENTILADOR BMW E65-N62 BMTR,1807,0,1,2,3
64546921379 *1,MOTOVENTILADOR BMW E65-N62 FREY,1209,1,9,7,17
64546921381,MOTOVENTILADOR DE MOTOR BMW E53-M62 BMTR,1310,7,6,7,20
64546921381 *1 ,MOTOVENTILADOR ENFRIAMIENTON MOTOR BMW E53 M54 M62 (FREY),1895,2,5,2,9
64546921381-1,MOTOVENTILADOR DE MOTOR BMW E53 M62 TOPAZ,1590,7,3,7,17
64546921395,MOTOVENTILADOR BMW E39-M52 BMTR,1927,4,8,7,19
64546921395 *1,MOTOVENTILADOR BMW E39-M52 FREY,1410,1,1,1,3
64548373957,MOTOVENTILADOR BMW E46- M52 NFR,1352,1,7,2,10
6460100762 *1,SEPARADOR ACEITE MOTOR PCV VITO W639 (FREY),1328,6,3,5,14
6460101462 *1,SEPARADOR ACEITE MOTOR VALVULA PCV SPRINTER OM646 (FREY),1700,9,2,7,18
6460161905 *1,TAPA PUNTERIAS MOTOR VITO OM646 (FREY),1875,8,5,4,17
6460701532 *1 ,MANGUERA RETORNO COMBUSTIBLE DIESEL VITO VIANO SPRINTER OM646 (FREY),1823,3,9,1,13
6460920501 *3,FILTRO COMBUSTIBLE GASOLINA MERCEDES-BENZ (MAHLE KL313),1214,3,9,8,20
6460960199/VV14 *2,TURBO CARGADOR CARTUCHO MERCEDES SPRINTER 2.2 (EMBLER) GOG,1946,2,5,5,12
6460980083 *1,MANGUERA DE RADIADOR MERCEDEZ SPRINTER W906 (FREY),1204,7,3,1,11
6462001001 *1,BOMBA AGUA MECANICA ENFRIAMIENTO MOTOR SPRINTER OM646 VITO VIANO OM646 2.1 L 4 CIL (FREY),1736,3,1,4,8
6462300365 *1,BOMBA REFORZADORA VACIO FRENOS SPRINTER OM646 VITO VIANO OM646 (FREY),1892,0,8,6,14
6472000101 *1,BOMBA AGUA MECANICA ENFRIAMIENTO MOTOR SPRINTER OM611 2.7 L 5 CIL (FREY),1373,8,2,1,11
6510100830 *1,TAPA PUNTERIAS MOTOR SPRINTER VITO OM651 (FREY),1304,2,1,0,3
6510101472 *1,VARILLA BAYONETA NIVEL ACEITE MOTOR SPRINTER OM651 (FREY),1599,6,6,0,12
6510101672 *1,VARILLA BAYONETA NIVEL ACEITE MOTOR MERCEDES M271 M272 M274 (FREY),1840,0,6,0,6
6510108918 *1,TAPA PUNTERIAS MOTOR SPRINTER VITO OM651  (FREY),1404,9,2,7,18
6510160021 *1,JUNTA TAPA PUNTERIAS MOTOR SPRINTER VITO OM646 OM651  (FREY),1259,3,5,7,15
6510160321 *1,JUNTA TAPA PUNTERIAS MOTOR SPRINTER VITO OM646 OM651 (FREY),1339,9,6,7,22
6510300020 *1,KIT 4 PZ BIELAS CIGUEï¿½AL MOTOR MEDIDA STANDAR  SPRINTER OM651 2.1 L 4 CIL SPRINTER VITO VIANO OM646 (FREY),1880,8,9,1,18
6510300020B,1 PZ BIELA CIGUEï¿½AL MEDIDA STANDAR MOTOR SPRINTER OM651 2.1 L 4 CIL SPRINTER VITO VIANO OM646,1779,7,4,8,19
6510300060 *1,KIT METALES BIELA MOTOR SPRINTER VITO VIANO OM651 2.1 L 4 CIL (FREY),1366,4,2,3,9
6510300060B,KIT 8 METALES BIELA MOTOR SPRINTER VITO VIANO OM651 2.1 L 4 CIL (FREY),1797,4,9,7,20
6510300124 *1,KIT 3 PZ ANILLOS PARA UN PISTON MOTOR SPRINTER OM651 (FREY),1865,2,2,7,11
6510300703 *1,POLEA DAMPER CIGï¿½Eï¿½AL MOTOR SPRINTER OM651 (FREY),1754,5,5,8,18
6510302501 *1,CIGUEï¿½AL MOTOR MEDIDA STANDAR  SPRINTER OM651 2.1 L 4 CIL SPRINTER VITO VIANO OM646 (FREY),1406,4,3,3,10
6510305105 *1 ,VOLANTE MOTRIZ DOBLE MASA SIN KIT CLUTCH SPRINTER W906 OM651 (FREY),1235,6,8,5,19
6510330701 *1,METALES COJINETE BANCADA MOTOR MEDIDA 0.50 SPRINTER OM651 2.1 L (FREY),1846,4,8,8,20
6510520000 *1,ENGRANE DISTRIBUCION MOTOR (L/R) SPRINTER OM651 2.1 L (FREY),1756,8,0,8,16
6510700132 *1,MANGUERA RETORNO COMBUSTIBLE DIESEL SPRINTER VITO VIANO W639 (FREY),1531,9,4,9,22
6510702432 *1,MANGUERA RETORNO COMBUSTIBLE DIESEL VITO VIANO SPRINTER OM651 (FREY),1552,3,8,3,14
6510702432-100,MANGUERA DE DESBORDAMIENTO DEL INYECTOR DE COMBUSTIBLE E200 SPRINTER INACTIVO,1941,3,3,7,13
6510703033 *1,TUBO RIEL COMBUSTIBLE DIESEL SPRINTER OM651 (FREY),1879,1,0,8,9
6510900000 *1,MANGUERA ENTRADA AIRE MOTOR MERCEDES W156 W176 W246 (FREY),1684,9,4,9,22
6510900005 *1,BOMBA DE VACIO MERCEDES BENZ W166 W636 FREY,1704,4,0,5,9
6510900037 *1,MULTIPLE ADMISION ENTRDA AIRE MOTOR SPRINTER OM651 (FREY),1431,7,8,1,16
6510900148 *1,SENSOR MASA AIRE MOTOR MAF SPRINTER W906 OM651 (FREY),1705,5,7,3,15
6510901552 *1,FILTRO COMBUSTIBLE DIESEL CON SENSOR MAGUERA DE PURGA SPRINTER W906 OM651 (FREY),1908,8,5,9,22
6510901552B,FILTRO COMBUSTIBLE DIESEL SIN SENSOR SIN MAGUERA DE PURGA SPRINTER W906 OM651 (FREY),1258,5,4,0,9
6510902952 *1,FILTRO COMBUSTIBLE DIESEL CON SENSOR CON CABLE SPRINTER W906 OM651 (FREY),1881,6,9,9,24
6510902952 *3,FILTRO COMBUSTIBLE DIESEL CON SENSOR CON CABLE (MAHLE KL912),1237,4,0,0,4
6510903037 *1,COLECTOR ADMISION AIRE MOTOR MERCEDES SPRINTER OM651 (FREY),1527,0,3,1,4
6510903152 *1,FILTRO COMBUSTIBLE DIESEL CON SENSOR SIN CABLE SPRINTER W906 OM651 (FREY),1665,7,2,5,14
6510904737-100,MULTIPLE ADMISION AIRE MOTOR SPRINTER OM651 INACTIVO,1401,8,8,4,20
6511410369 *1,ACTUADOR VALVULA EGR VACIO MERCEDES BENZ W906 (FREY),1922,5,6,8,19
6511800115 *1,SENSOR PRESION ACEITE MOTOR SPRINTER VITO VIANO OM651 2.1 L 4 CIL (FREY),1934,4,0,4,8
6511800610 *1,ENFRIADOR CON TOMA ACEITE MOTOR SPRINTER OM651 (FREY),1893,0,2,6,8
6511800665 *1,ENFRIADOR ACEITE MOTOR SIN TOMA ACEITE SPRINTER OM651 (FREY),1786,0,9,2,11
6511802001 *1,BOMBA ACEITE MOTOR DIESEL SPRINTER VITO VIANO OM651 2.1 L 4 CIL (FREY),1238,3,1,0,4
6511802801 *1,BOMBA ACEITE MERCEDES BENZ OM651 (FREY),1800,6,1,7,14
6511840480B,JUNTA CARTER ACEITE MOTOR MERCEDES SPRINTER W906 (FREY),1384,3,9,7,19
6512000270 *1,POLEA REENVIO BANDA ACCESORIOS MOTOR  26X65 MM SPRINTER VITO OM651 (FREY),1452,4,4,1,9
6512000370 *1,POLEA REENVIO LISA BANDA ACCESORIOS MOTOR 65X26X8 MM SPRINTER OM651 (FREY),1543,2,1,5,8
6512000456 *1,TOMA REFRIGERANTE FILTRO COMBUSTIBLE DIESEL SPRINTER VITO VIANO OM651 (FREY),1860,9,0,0,9
6512000456-100,CARCASA ENFRIAMIENTO FILTRO COMBUSTIBLE DIESEL SPRINTER OM651 INACTIVO,1250,3,4,5,12
6512000615 *1,TERMOSTATO ENFRIAMIENTO MOTOR SPRINTER OM651 (FREY),1689,1,9,0,10
6512000670 *1,POLEA REENVIO BANDA ACCESORIOS 6 RANURAS 64 MM SPRINTER OM651 (FREY),1205,4,0,8,12
6512000770 *1,POLEA REENVIO BANDA ACCESORIOS MOTOR 26X54 MM SPRINTER VITO OM651 (FREY),1758,7,7,5,19
6512000970 *1,POLEA TENSORA BANDA MERCEDES SPRINTER (FREY),1469,6,0,7,13
6512001370 *1,TENSOR BANDA ACCESORIOS MERCEDES M271 M272 M276 SPRINTER OM651 (FREY),1918,0,2,3,5
6512001870 *1,TENSOR MECANICO BANDA ACCESORIOS POLEA 65MM SPRINTER VITO VIANO OM651 OM646 (FREY),1909,7,1,0,8
6512001870 *2,TENSOR MECANICO BANDA ACCESORIOS POLEA 65MM SPRINTER VITO VIANO OM651 OM646 (EMBLER),1883,2,1,4,7
6512001901 *1,BOMBA AGUA MECANICA ENFRIAMIENTO MOTOR 7 ORIFICIOS CON VENTILACION SPRINTER OM651 2.1 L 4 CIL (FREY),1285,9,7,3,19
6512002301 *1,BOMBA AGUA MECANICA ENFRIAMIENTO MOTOR 8 ORIFICIOS CON POLEA LISA SPRINTER VITO VIANO OM651 2.1 L 4 CIL. (FREY),1762,7,6,3,16
6512003501 *1,BOMBA AGUA MECANICA ENFRIAMIENTO MOTOR VITO VIANO W639 W447 OM651 2.1 L 4 CIL (FREY),1889,4,8,7,19
6512005101 *1,BOMBA AGUA MECANICA ENFRIAMIENTO MOTOR 8 ORIFICIOS CON VENTILACION SPRINTER OM651 2.1 L 4 CIL (FREY),1917,2,2,0,4
6512006000-100,CARCASA DE FILTRO DE COMBUSTIBLE DE ACEITE DE MOTOR SPRINTER W166 INACTIVO,1445,8,3,2,13
6512031682 *1,MANGUERA AGUA ENFRIAMIENTO MOTOR TERMOSTATO MERCEDES OM651 OM646 OM642 (FREY),1634,1,8,0,9
65126982299,AMPLIFICADOR DE SONIDO HI FI (DSP)  BMW E90,1901,3,2,2,7
6512913308301,CAJA DE DISCOS BMW E90 E91 SEMINUEVA (ORIGINAL),1860,9,9,0,18
6519050200 *1,SENSOR DIFERENCIAL PRESION COMBUSTIBLE SPRINTER OM651 (FREY),1875,4,9,8,21
65422218,SENSOR DE OXIGENO TRASERO MERCEDES W204 ( BMTR ),1593,0,9,1,10
65816936953 *1,SENSOR TEMPERATURA AMBIENTE BMW E46 E81 E90 F25 F30 (FREY),1736,6,8,7,21
65816936953 -3,SENSOR DE TEMPERATURA AMBIENTE BMW E46 OSSCA,1547,7,4,9,20
65816936953-2,SENSOR DE TEMPERATURA AMBIENTE BMW E46 TOPRAN,1586,3,7,1,11
65816936953-9,SENSOR DE TEMPERATURA AMBIENTE BMW E46 URO,1891,3,8,7,18
65829267955,CONTROLADOR DE SISTEMA DE NAVEGACION SEMINUEVO BMW F30 ( GENUINO ),1628,9,5,1,15
65829267955-1,CONTROLADOR DE SISTEMA DE NAVEGACION  BMW F30 FREY,1436,2,4,2,8
6600900101 *3,FILTRO POLEN AIRE CABINA SMART FORTWO (MAHLE LX2034),1594,3,3,2,8
66126912985,BATERIA PARA LLAVE DE IGNICION BMW E46 VARTA 3.0 V CR2032,1795,4,5,2,11
66206989068,SENSOR DE ESTACIONAMIENTO BMW E53-M54 BMTR,1355,3,7,8,18
66206989068-1,SENSOR DE ESTACIONAMIENTO BMW E53-M54 FREY,1384,3,4,2,9
66206989069,SENSOR DE ESTACIONAMIENTO BMW E83 BMTR,1784,0,5,5,10
66206989069-1,SENSOR DE ESTACIONAMIENTO BMW E83 FREY,1500,2,0,9,11
66209139868,SENSOR DE ESTACIONAMIENTO BMW E70 BMTR,1480,4,6,2,12
66209139868 *1,SENSOR DE ESTACIONAMIENTO BMW E70 FREY,1614,1,4,8,13
66216902181,SENSOR DE ESTACIONAMIENTO BMW E39 BMTR,1442,0,4,6,10
66216902181 *1,SENSOR DE ESTACIONAMIENTO BMW E39 FREY,1415,4,2,5,11
66340CLC-1,KIT FOCOS DE LUZ XENON D3S CON IGNITOR 4300K ( XENPLUS ),1701,0,8,6,14
6673200073 *1,BUJE BARRA ESTABILIZADORA TRASERA (L/R) 12X32X36 MM SPRINTER W906 VW CRAFTER 2006 A 2016 (FREY),1749,8,3,7,18
66821*5,BOMBA GASOLINA MECANICA ALTA PRESION MERCEDES M276 (BOSCH) SSF,1797,0,6,2,8
67127298309 *1,BOMBA AGUA DEPOSITO PARABRISAS BMW F44 G20 G12 G02 G09 (FREY),1996,1,4,2,7
67128362154-100,BOMBA DE AGUA LIMPIAPARABRISAS-CHISGUETEROS BMW E46 ( BMTSR ) INACTIVO,1236,3,0,7,10
67128377430 *1,BOMBA AGUA LIMPIAPARABRISAS CHISGUETERO BMW E90 (FREY),1537,5,9,2,16
67128377430 -2,BOMBA AGUA LIMPIAPARABRISAS CHISGUETERO BMW E90 BMTR,1658,4,9,2,15
67128377987 *1,BOMBA AGUA LIMPIAPARABRISAS AUDI W210 (FREY),1319,5,1,1,7
67327562594,MOTOVENTILADOR DE 600W BMW F25 ( GENUINO ),1251,0,9,9,18
67327562594 *1,MOTOVENTILADOR DE 600W BMW F25 FREY,1847,4,4,1,9
6740273406,CAJA DE FILTRO DE ACEITE 2.5 MANN+HUMMEL,1601,8,9,4,21
67628362063,MOTOR DEL ELEVADOR DE CRISTALES ( L ) BMW E53 ( GENUINO ),1790,2,4,8,14
67628362063 *1,MOTOR DEL ELEVADOR DE CRISTALES ( L ) BMW E53 FREY,1499,9,7,7,23
67628362064,MOTOR DEL ELEVADOR DE CRISTALES ( R ) BMW E53 ( GENUINO ),1551,3,6,6,15
67637217792 *1,BOMBA AGUA ELECTRICA ENFRIAMIENTO MOTOR BMW F20 F21 (FREY),1686,5,8,8,21
68025160AA,ENFRIADOR DE ACEITE DE TRANSMISION AUTOMATICA JEEP PATRIOT BMTRS,1863,8,1,6,15
68029912AE *B,BOLSA AIRE SUSPENSION TRASERA (L/R) JEEP GRAND CHEROKEE (EMBLER) TECH,1954,3,7,7,17
68059904AD *A,AMORTIGUADOR AIRE SUSPENSION DELANTERA (R) GRAND CHEROKEE 2011 A 2016 (EMBLER) TECH,1684,6,0,0,6
68059905AD *A,AMORTIGUADOR AIRE SUSPENSION DELANTERA (L) GRAND CHEROKEE 2011 A 2016 (EMBLER) TECH,1473,7,9,4,20
68059905AD *B,BOLSA AIRE SUSPENSION DELANTERA (L/R) JEEP GRAND CHEROKEE (EMBLER) TECH,1907,6,7,0,13
68059905AD *C,COMPRESOR AIRE SUSPENSION JEEP GRAND CHEROKEE (EMBLER) TECH,1971,6,2,6,14
68059905AD-100,AMORTIGUADOR AIRE SUSPENSION DELANTERA (L) JEEP GRAND CHEROKEE (EMBLER) CYS INACTIVO,1203,2,8,8,18
68087233AA *V,BLOQUE VALVULAS CONTROL AIRE SUSPENSION GRAND CHEROKEE (EMBLER) TECH,1895,2,4,6,12
68248948AA *B,BOLSA AIRE SUSPENSION TRASERA (L/R) DODGE RAM (EMBLER) TECH,1419,5,1,1,7
68253204AA *A,AMORTIGUADOR AIRE SUSPENSION DELANTERA (R) GRAND CHEROKEE 2016 A 2020 (EMBLER) TECH,1318,2,3,5,10
68253205AA *A,AMORTIGUADOR AIRE SUSPENSION DELANTERA (L) GRAND CHEROKEE 2016 A 2020 (EMBLER) TECH,1454,9,3,7,19
6842273 *5,RETEN CIGUEï¿½AL DELANTERO 47X35X7 VOLVO C30 C70 S40 S60 S80 V40 V60 (ELRING) SSF,1809,6,8,0,14
6842347 *5,TORNILLO DE CABEZA DE MOTOR VOLVO S40 2a GEN. ( VICTOR REINZ ) SSF,1367,1,1,9,11
6843112,RETEN DE FLECHA IZQUIERDA TRANSMISION AUTOMATICA VOLVO S40 GENUINO,1609,8,9,9,26
6900947004 *3,FILTRO ENTRADA AIRE MOTOR MAHLE MERCEDES-BENZ (MAHLE  LX513/1),1331,9,8,4,21
6C0513025AN,AMORTIGUADOR DE SUSPENSION TRASERA AUDI A1 2015 SACHS,1605,1,6,1,8
6C1Q6B624,ENFRIADOR DE ACEITE FORD TRANSIT BMTR,1765,4,1,0,5
6C1Q6B624AC,ENFRIADOR DE ACEITE DE MOTOR SIN FILTRO FORD TRANSIT MK7 2.2 DIESEL TAIFA,1415,0,3,9,12
6C1Q6B624AC-1,ENFRIADOR DE ACEITE DE MOTOR FORD TRANSIT MK7 2.2 DIESEL CON FILTRO BMTRS,1982,6,1,4,11
6D109119-3,BANDA DE DISTRIBUCION AUDI A4 2.0 L TOPRAN,1953,1,6,5,12
6G929601AB-7,FILTRO ENTRADA AIRE MOTOR LAND ROVER  LR2 MANN,1510,4,6,4,14
6H105561F,METALES DE CENTRO EN ESTANDAR AUDI A4-2.0L ( KOLBENSCHMIDT 77907600 ),1828,9,8,9,26
6K0129620B,FILTRO ENTRADA AIRE MOTOR SEAT IBIZA 1.6L 4 CIL MANN C37132,1977,9,8,2,19
6K0129620B *3,FILTRO ENTRADA AIRE MOTOR SEAT IBIZA 1.6L 4 CIL (MAHLE LX997),1375,5,1,5,11
6K906036M *3,INYECTOR COMBUSTIBLE VOLKSWAGEN AUDI (GENUINO),1517,5,5,2,12
6L743C098BC *A,AMORTIGUADOR AIRE SIN ADS SUSPENSION DELANTERA (L) NAVIGATOR EXPEDITION 2003 A 2006 (EMBLER) TECH,1229,2,0,4,6
6PK1350 *1,BANDA ACCESORIOS SUPERCARGADOR MEDIDA 6PK 1350 MM MERCEDES M271 KOMPRESSOR (FREY),1244,6,3,2,11
6PK1555 *5,BANDA ACCESORIOS MOTOR 6PK1555 FREELANDER 2002 A 2005 V6 2.5 L (CONTITECH) SSF,1727,5,5,6,16
6PK2130 *1,BANDA ACCESORIOS AIRE ACONDICIONADO MEDIDA 6PK 2130 MM MERCEDES W222 M256 (FREY),1560,5,9,6,20
6PK2380 *1,BANDA ACCESORIOS MOTOR MEDIDA 6PK 2380 MM MERCEDES W203 W220 M113 (FREY),1654,4,5,4,13
6PK2415 *1,BANDA ACCESOROS MOTOR MEDIDA 6PK 2415 MM MERCEDES W210 W124 (FREY),1448,4,4,4,12
6Q0121407B,DEPOSITO DE ANTICONGELANTE AUDI A1 SEAT IBIZA POLO VAICO,1904,3,6,0,9
6Q0122291F,TOMA DE AGUA AUDI TT / VW JETTA ( FEBI ),1213,9,9,7,25
6Q0201051C,FILTRO COMBUSTIBLE GASOLINA BORA 2.5L 5CIL MANN WK69,1689,8,7,7,22
6Q0201051J-9,FILTRO COMBUSTIBLE GASOLINA SEAT IBIZA 1.6-1.8L MANN WK69/2,1495,4,2,8,14
6Q0423156AB,ELECTROBOMBA DE DIRECCION HIDRAULICA SEAT IBIZA,1863,1,4,3,8
6Q0820367,FILTRO POLEN AIRE CABINA GOLF MOTOR 1.4 TURBO MANN CU2545,1669,4,5,2,11
6Q0820367-1,FILTRO POLEN AIRE CABINA GOLF MOTOR 1.4 TURBO TOPRAN,1795,7,9,9,25
6R0129620A,FILTRO ENTRADA AIRE MOTOR AUDI A1 A3 MANN C15008,1646,0,1,9,10
6R0129620A *3,FILTRO ENTRADA AIRE MOTOR AUDI A1 A3 (MAHLE LX2831),1545,7,7,5,19
6R0820367 *3,FILTRO POLEN AIRE CABINA CON CARBON AUDI VW SEAT (MAHLE LA809),1528,8,7,7,22
6R0919051G *2,BOMBA GASOLINA ELECTRICA 5 PINES AUDI A1 1.2 TFSI SEAT VW (EMBLER),1215,3,6,2,11
6R0919051G *3,BOMBA GASOLINA ELECTRICA 5 PINES AUDI A1 1.2 TFSI SEAT VW (INJETECH),1772,5,5,3,13
6R0965561A *2,BOMBA AGUA AUXILIAR ELECTRICA ENFRIAMIENTO MOTOR VW SEAT AUDI (EMBLER) GOG,1509,7,3,9,19
6Y0129620,FILTRO ENTRADA AIRE MOTOR VOLKSWAGEN GOL 1.6L MANN C2295/2,1222,9,1,8,18
70-38942-00 *5,JUNTA TAPA DISTRIBUCION MOTOR 5 IRIFICIOS AUDI VW SEAT 2.0 TFSI TSI (VICTOR REIZ) SSF,1721,2,6,0,8
702702580 *2,BOMBA AGUA ELECTRICA ENFRIAMIENTO MOTOR VOLVO S60 S60 X/C S80 S90 V60 V60 X/C V90 X/C XC40 XC60 XC70 XC90 (EMBLER),1643,0,3,1,4
702702580 *5,BOMBA AGUA ELECTRICA ENFRIAMIENTO MOTOR VOLVO S60 S60 X/C S80 S90 V60 V60 X/C V90 X/C XC40 XC60 XC70 XC90 (PIERBURG) SSF,1254,5,2,9,16
703933600 *5,JUNTA O RING SEPARADOR ACEITE MOTOR PCV VOLVO C30 C70 S40 S60 V50 V60 XC60 XC70 2.5 L 5 CIL  (VICTOS REINZ) SSF,1398,1,0,6,7
706414501 *1,KIT ENGRANES GUIAS TENSOR DISTRIBUCION MOTOR SPRINTER VITO OM651 2.1 L (FREY),1430,3,2,4,9
7066310000 *3,FILTRO ENTRADA AIRE MOTOR AUDI Q7 MAHLE LX3233/6,2000,0,5,3,8
7119905857,TUERCA DE BOMBA DE ACEITE BMW E46-M54 GENUINO,1400,6,4,4,14
712934900 *5,JUNTA MULTIPLE ESCAPE GASES MOTOR MERCEDES M111 (VICTOR REINZ) SSF,1759,8,3,4,15
714129100,JUNTA DE CARTER DE MOTOR BMW E90-N55 VICTOR REINZ,1883,7,6,1,14
714129100-100,JUNTA DE CARTER DE MOTOR BMW E90-N55  FREY INACTIVO,1992,8,6,0,14
7200756,ENFRIADOR DE ACEITE DE TRANSMISION AUTOMATICA ( 2 TUBOS ) NISSAN SENTRA TF-1119 BMTRS,1287,8,3,4,15
7200756-1,ENFRIADOR DE ACEITE DE TRANSMISION AUTOMATICA ( 2 TUBOS ) NISSAN SENTRA TF-1119,1690,6,0,4,10
72436824 *5,BASE AMORTIGUADOR SUSPENSION DELANTERA (L/R) VOLVO S40 V40 (PRO PARTS) SSF,1930,2,2,7,11
729451 *1,MANGUERA FRENO MERCEDES SPRINTER W906 (FREY),1922,8,1,6,15
7297413-1,CALAVERA TRASERA PARA MINI F56 (L) SEMINUEVA ORIGINAL,1504,6,8,9,23
73612 *5,JUNTA TUBO RETORNO LUBRICACION TUBO CARGADOR VOLVO C70 S40 S60 S70 S80 V40 V70 XC70 XC90 (EL RING) SSF,1929,4,2,5,11
75095,BUJIA DE PLATINO VOLVO S40 2a GEN NGK,1710,7,5,8,20
7520007 *1,KIT SELLOS ENFRIADOR ACEITE MOTOR SPRINTER OM651 (FREY),1797,9,6,4,19
75421318,SENSOR DE TEMPERATURA MERCEDES  CLASE C ( OSSCA ),1348,3,9,8,20
7560481,TAPON DE LLENADO DE ACEITE SEMI NUEVO GENUINO N52N,1705,7,9,0,16
756365502,PALANCA SELECTORA DE CAMBIOS SEMINUEVA PARA BMW (GENUINO),1473,5,6,0,11
756467802,MULTIPLE DE ADMISION BMW E90 SEMINUEVO (ORIGINAL),1811,7,0,0,7
78102200,SERVICIOS POSTALES DE PAQUETEO Y COURRIER (ENVIO),1681,6,8,6,20
78102200GE,GUIA ELECTRONICA ENVIOS,1684,4,6,0,10
78102200GE-1,Guia Electronica de Envios,1661,8,8,7,23
78103224,MANGUERA VENTILACION DE CARTER AUDI A4 URO,1802,2,8,8,18
786825-0001,TURBO CARGADOR CARTUCHO CHEVROLET CRUZE-SONIC 1.4 GTC1446 KZR GERMANY,1583,7,6,4,17
7D0698151B,BALATAS FRENOS DELANTEROS VW  2.5L GDB1367,1587,7,8,7,22
7H0927803,SENSOR ABS DELANTERO  (L) AUDI A3 (BREMI),1955,4,6,5,15
7L0121407F *2,DEPOSITO ANTICONGELANTE ENFRIAMIENTO MOTOR AUDI PORSCHE VW 3.6 L 4.2 L  (EMBLER) GOG,1569,8,6,1,15
7L0129620 *3,FILTRO ENTRADA AIRE MOTOR AUDI Q7 CAYENNE TOUAREG 8 CIL 4.2L (MAHLE LX792) SSF,1485,4,6,1,11
7L0129620 *5,FILTRO ENTRADA AIRE MOTOR AUDI Q7 CAYENNE TOUAREG 8 CIL 4.2L (HENGST) SSF,1431,3,1,7,11
7L0129620 *6,FILTRO ENTRADA AIRE MOTOR AUDI Q7 CAYENNE TOUAREG 8 CIL 4.2L (MANN) SSF,1441,4,0,4,8
7L0129620A *5,FILTRO ENTRADA AIRE MOTOR 186 X 388 MM AUDI VW (HENGST) SSF,1705,9,1,6,16
7L0407021B,HORQUILLA DE SUSPENSION DELANTERA SUPERIOR L-R AUDI Q7 TUAREG BENDIX,1857,4,8,1,13
7L0407021B-1,HORQUILLA DE SUSPENSION DELANTERA SUPERIOR L-R AUDI Q7 TUAREG LEMFORDER,1443,9,2,2,13
7L0407021B-2,HORQUILLA DE SUSPENSION DELANTERA SUPERIOR L-R AUDI Q7 TUAREG BFGERMANY,1778,0,8,2,10
7L04070221B,HORQUILLA DE SUSPENSION DELANTERA SUPERIOR ( L / R ) AUDI Q7 TUAREG ( BENDIX ),1247,9,6,4,19
7L0407077 *5,BUJE HORQUILLA SUPERIOR DELANTERA (L/R) TUAREG CAYENNE Q7 (OEM) SSF,1894,5,9,3,17
7L0407182B,BUJE HORQUILLA INFERIOR DELANTERA TUAREG CAYENNE Q7 CORTECO,1938,5,1,6,12
7L0407182G *5,BUJE DE HORQUILLA INFERIOR DELANTERO (L/R) AUDI Q7 (MEYLE) SSF,1965,4,2,4,10
7L0407182G-1,BUJE DE HORQUILLA INFERIOR DELANTERO AUDI Q7 BFGERMANY,1332,8,6,8,22
7L0407183A,BUJE DE HORQUILLA AUDI Q7-VW TAUREG 3.0L LEMFORDER,1843,4,0,5,9
7L0411317BX,TORNILLO ESTABILIZADOR SUSPENSION DELANTERA (L/R) CAYENNE (OPTIMAL),1402,3,8,3,14
7L0412327A *BA,BASE AMORTIGUADOR SUSPENSION DELANTERA (L/R) Q7 CAYENNE TOUAREG (EMBLER) TECH,1791,8,2,1,11
7L0412333A *5,BUJE DE HORQUILLA INFERIOR DELANTERA EXTERIOR (L/R)  PORSCHE CAYENNE (DELPHI) SSF,1953,2,2,2,6
7L0498287,BALERO DE RUEDA TRASERA Q7-VW TAUREG 3.0L PRECISION,1458,6,7,0,13
7L0498287-1,BALERO DE RUEDA TRASERA Q7-VW TAUREG 3.0L FAG,1922,0,7,7,14
7L0498287-2,BALERO DE RUEDA TRASERA Q7-VW TAUREG 3.0L VIKA,1842,8,8,8,24
7L0521102M ,CARDAN DE ARBOL DE TRANSMISION DELANTERO SEMINUEVO VW TOUAREG (GENUINO),1963,1,7,4,12
7L0521102N,EJE TRANSMISION TRASERO AUDI Q7 VW TOUAREG PORSCHE CAYENNE (EMBLER),1354,3,4,3,10
7L0521403 *2,JUNTA GOMA CARDAN 152X110 AUDI Q7 VW TUAREG 2004 A 2010 PORSCHE 9PA (EMBLER) GOG,1933,9,1,6,16
7L0521403 *5,JUNTA GOMA CARDAN 152X110 AUDI Q7 VW TUAREG 2004 A 2010 PORSCHE 9PA (FEBI) SSF,1743,6,9,7,22
7L0698151AG *3,BALATAS FRENOS DELANTEROS 190.0 X 106.3 MM PORSCHE AUDI VW SEAT (TRW GDB1548),1480,4,7,7,18
7L0698151AG *5,BALATAS FRENOS DELANTEROS 190.0 X 106.3 MM PORSCHE AUDI VW SEAT (FERODO) SSF,1598,4,2,8,14
7L0698151AG *6,BALATAS FRENOS DELANTEROS 190.0 X 106.3 MM PORSCHE AUDI VW SEAT (BOSCH) SSF,1930,6,4,4,14
7L0698451K *3,BALATAS FRENOS TRASEROS 112.0 X 73.0 MM PORSCHE AUDI VW (TRW GDB1653),1945,6,4,6,16
7L0698451K *5,BALATAS FRENOS TRASEROS 112.0 X 73.0 MM PORSCHE AUDI VW (BOSCH) SSF,1619,7,1,9,17
7L0927807A,ABOR SENSOR ABS AUDI A3 TT  VIKA,1581,1,5,4,10
7L0927808A,SENSOR ABS DELANTERO R AUDI,1583,6,3,4,13
7L1Z5319AE *C,COMPRESOR AIRE SUSPENSION EXPEDITION NAVIGATOR 2007 A 2021 (EMBLER) TECH,1934,2,9,4,15
7L1Z5319AFULL-100,COMPRESOR DE AIRE SUSPENSION FORD EXPEDITION LINCOLN NAVIGATOR (EMBLER) CYS INACTIVO,1567,5,4,0,9
7L1Z5A891B *A,AMORTIGUADOR AIRE SIN ADS SUSPENSION TRASERA (L/R) NAVIGATOR EXPEDITION 2007 A 2016 (EMBLER) TECH,1933,9,9,0,18
7L1Z5A891B *B,BOLSA AIRE SUSPENSION TRASERA (L/R) NAVIGATOR EXPEDITION 2007 A 2012 (EMBLER) TECH,1290,2,8,8,18
7L1Z5A891B *V,BLOQUE VALVULAS FORD EXPEDITION (EMBLER) TECH,1672,2,0,5,7
7L6422154ES,BOMBA DE DIRECCION HIDRAULICA VW TOUAREG,1427,8,5,7,20
7L6615301N,DISCO DE FRENOS DELANTEROS ( L ) VW TOUAREG ( PAGID 355109711 ),1934,6,6,8,20
7L6615302N,DISCO DE FRENOS DELANTEROS ( R ) VW TOUAREG ( PAGID 355109741 ),1412,6,7,8,21
7L6616503B *B,BOLSA AIRE SUSPENSION TRASERA (L/R) Q7 CAYENNE TOUAREG (EMBLER) TECH,1550,7,5,3,15
7L6698151K *3,BALATAS FRENOS DELANTEROS VOLKSWAGEN TOUAREG (TRW GDB1670),1792,6,7,0,13
7L6698151K *5,BALATAS FRENOS DELANTEROS 131.8 X 77.3 MM AUDI VW SEAT (AKEBONO EURO) SSF,1461,2,6,0,8
7L6919087F,BOMBA DE GASOLINA L VW TOUAREG 4.2L VDO,1999,7,4,9,20
7L6919679D,FILTRO COMBUSTIBLE GASOLINA VW TOUAREG CONTINENTAL,1231,1,3,7,11
7L8199131A,SOPORTE DE MOTOR ( L / R ) AUDI Q7 ( BMTR ),1564,0,0,1,1
7L8199131A *2,SOPORTE MOTOR (L/R) AUDI Q7 (EMBLER) GOG,1405,9,4,6,19
7L8199131A-3,SOPORTE DE MOTOR ( L / R ) AUDI Q7 VW TOUAREG CORTECO,1877,5,8,3,16
7L8407183 *5,BUJE HORQUILLA INFERIOR SUSPENSION DELANTERA (L/R) AUDI Q7 (LEMFORDER) SSF,1481,3,6,6,15
7L8616030D *A,//,1341,1,5,4,10
7L8616039D *A,AMORTIGUADOR AIRE SUSPENSION DELANTERA (L) Q7 2007 A 2015 CAYENNE 2003 A 2010 TOUAREG 2004 A 2009 (EMBLER) TECH,1398,9,5,6,20
7L8616039D *B,BOLSA AIRE SUSPENSION DELANTERA (L) Q7 2007 A 2015 CAYENNE 2003 A 2010 TOUAREG 2004 A 2009 (EMBLER) TECH,1609,0,0,6,6
7L8616040D *A,AMORTIGUADOR AIRE SUSPENSION DELANTERA (R) Q7 2007 A 2015 CAYENNE 2003 A 2010 TOUAREG 2004 A 2009 (EMBLER) TECH,1253,5,6,9,20
7L8616040D *B,BOLSA AIRE SUSPENSION DELANTERA (R) Q7 2007 A 2015 CAYENNE 2003 A 2010 TOUAREG 2004 A 2009 (EMBLER) TECH,1464,2,8,2,12
7N0698451A *3,BALATAS FRENOS TRASEROS 104.3 X 52.0 MM AUDI VW SEAT (TEXTAR),1459,2,2,6,10
7N0698451A *5,BALATAS FRENOS TRASEROS 104.3 X 52.0 MM AUDI VW SEAT (JURID) SSF,1468,7,0,5,12
7P0698014 *V,BLOQUE VALVULAS AIRE SUSPENSION AUDI Q7 CAYENNE (EMBLER) TECH,1391,7,7,8,22
7P0907637C,SENSOR BALATAS FRENOS TRASERO (L/R) VW TOUAREG (BAMPIC),1391,9,2,7,18
7P5907381C *2,BALASTRA MODULO ELECTRONICO LUZ XENON D1S PANAMERA 2009 A 2014 CAYENNE 2011 A 2013 (EMBLER) MLL,1574,0,7,8,15
7P6616019K *A,AMORTIGUADOR AIRE SUSPENSION TRASERA (L) CAYENNE TOUAREG 2011 A 2016 (EMBLER) TECH,1312,0,5,9,14
7P6616019K *B,BOLSA AIRE SUSPENSION TRASERA (L) CAYENNE TOUAREG 2011 A 2016 (EMBLER) TECH,1904,5,0,8,13
7P6616020K *A,AMORTIGUADOR AIRE SUSPENSION TRASERA (R) CAYENNE TOUAREG 2011 A 2016 (EMBLER) TECH,1596,9,1,4,14
7P6616020K *B,BOLSA AIRE SUSPENSION TRASERA (R) CAYENNE TOUAREG 2011 A 2016 (EMBLER) TECH,1786,0,9,7,16
7P6616039N *A,AMORTIGUADOR AIRE SUSPENSION DELANTERA (L) CAYENNE 92A 2010 A 2019 TOUAREG 7P5 7P6 2011 A 2018 (EMBLER) TECH,1912,7,9,0,16
7P6616039N *B,BOLSA AIRE SUSPENSION DELANTERA (L) CAYENNE 92A 2010 A 2019 TOUAREG 7P5 7P6 2011 A 2018 (EMBLER) TECH,1892,1,6,3,10
7P6616040N *A ,AMORTIGUADOR AIRE SUSPENSION DELANTERA (R) CAYENNE 92A 2010 A 2019 TOUAREG 7P5 7P6 2011 A 2018 (EMBLER) TECH,1647,6,1,5,12
7P6616040N *B,BOLSA AIRE SUSPENSION DELANTERA (R) CAYENNE 92A 2010 A 2019 TOUAREG 7P5 7P6 2011 A 2018 (EMBLER) TECH,1752,2,2,6,10
7P6616040N *V,VALVULA ALIMENTACION BOLSA AIRE DELANTERA (L/R) Q7 CAYENNE (EMBLER),1278,0,8,1,9
7P6698151B,BALATAS FRENOS DELANTEROS VW TOUAREG PAGID T2056,1860,1,1,0,2
7P6698451,BALATAS FRENOS TRASEROS VW TOUAREG TEXTAR 2472101,1465,7,3,1,11
7PK1635 *1,BANDA ACCESORIOS MOTOR MEDIDA 7PK 1635 MM BMW MOTOR E38 E39 E53 M63 (FREY),1405,4,1,4,9
7PK1647 *1,BANDA DE BOMBA DE AGUA BMW MOTOR N63 FREY 7PK1647,1938,4,3,2,9
7PP903137,BANDA ACCESORIOS MOTOR MEDIDA 7DK 2880 MM PORSCHE CAYENNE 4.8 L V8 CONTITECH,1645,6,4,2,12
800302801 *1,KIT 61 PZ JUEGO JUNTAS MOTOR COMPLETO MEDIDA STD BMW N55 (FREY),1548,1,1,2,4
800303101A,KIT 37 PZ JUEGO JUNTAS MOTOR COMPLETO MEDIDA STD BMW MOTOR N20 N26 (FREY),1942,3,7,7,17
80141600,ACTIVIDADES DE VENTAS Y PROGRAMACION DE NEGOCIOS (COMISIONES),1549,7,3,0,10
80230136287,LLAVERO BMW EMBLEMA SERIE 5,1681,9,4,3,16
80A616025R *A,AMORTIGUADOR ELECTRONICO SUSPENSION TRASERA (L/R) AUDI Q5 SQ5 2014 A 2019 (EMBLER) TECH,1271,0,9,5,14
80A698151H *5,BALATAS FRENOS DELANTEROS 135.7 X 81.0 MM AUDI VW SEAT (FERODO) SSF,1733,5,1,2,8
80A698151H *6,BALATAS FRENOS DELANTEROS 135.7 X 81.0 MM AUDI VW SEAT (JURID) SSF,1603,4,5,1,10
80A919087 *3,BOMBA COMBUSTIBLE GASOLINA AUDI VW SAET 2.0 L TFSI (GENUINA),1999,9,8,1,18
8114107 *3,1.5 LITROS ANTICONGELANTE CONSENTRADO PENTOFROST ROSA AUDI VW SEAT (PENTOSIN ALEMAN),1399,3,5,9,17
8114117 *3,1.5 LITROS ANTICONGELANTE CONSENTRADO PENTOFROST AZUL BMW MERCEDES MINI (PENTOSIN ALEMAN ),1818,8,9,6,23
813718400 *5,RETEN DELANTERO DE ARBOL DE LEVAS ADM.Y ESC. VOLVO C30-S40-S60-S70 CORTECO,1597,1,6,0,7
8171701,EMBLEMA DE CAPUCHA FRONTAL NEGRO 57MM MERCEDES ORIGINAL,1219,6,7,7,20
82001192 *5,RETEN ARBOL LEVAS TRASERO 30X47 MM (L/R) VOLVO C70 S40 S60 S70 S80 V40 V50 V70 XC70 (EL RING) SSF,1453,0,8,9,17
8200177718,INTERRUPTOR DE LUZ DE REVERSA RENAULT GENUINO,1510,4,5,8,17
82027628 *5,RETEN DE ARBOL DE LEVAS DELANTERO L-R 1ra GEN FREELANDER (CORTECO) SSF,1659,9,7,0,16
82033885 *5,RETEN FECHA DELANTERA TRANSMISION AUTOMATICA (L) 63.3X38.4 MM VOLVO C30 C70 S40 S60 S70 S80 V50 V70 XC90 (CORTECO) SSF,1514,9,5,1,15
82034067 *5,RETEN DE FLECHA DERECHA TRANSMISION AUTOMATICA VOLVO S40 (CORTECO) SSF,1315,2,1,2,5
82140031133 *5,1 GALON CON 3.785 LITROS ANTICONGELANTE CONSETRADO COLOR AZUL (GENUINO MINI) SSF,1815,1,4,9,14
82141467704 *5,1 GALON CON 3.785  LITROS ANTICONGELANTE CONSENTRADO COLOR AZUL (GENUINO BMW) SSF,1270,1,0,3,4
82142209769 *5,1 LITRO ANTICONGELANTE CONSENTRADO AZUL BMW MINI (GENUINO BMW) SSF,1413,7,1,1,9
82510087 *5,RETEN TRASERO CIGï¿½Eï¿½AL VOLVO S40 MOTOR 2.5T  CORTECO,1743,5,2,7,14
83121703,SERVICIOS RELACIONADOS CON EL INTERNET,1959,5,3,0,8
83192211191 *1,1.5 LITROS ANTICONGELANTE AZUL -45ï¿½C BMW MINI (FREY),1929,0,5,3,8
83220397114 *5,5 LITROS LIQUIDO ATF6 TRANSMISION AUTOMATICA (FEBI) SSF,1431,8,1,6,15
83222163514 *5,1 LITRO LIQUIDO TRANSMISION AUTOMATICA DEXRON VI (FEBI) SSF,1364,3,8,8,19
83222163514 *6,1 LITRO LIQUIDO TRANSMISION AUTOMATICA TOP TEC ATF6 (LIQUI MOLY) SSF,1893,9,9,9,27
83222163514 *7,1 LITRO LIQUIDO TRANSMISION AUTOMATICA TRANSMAX DEXRON VI (CASTROL) SSF,1249,7,6,0,13
84070,RETEN DE TURBINA VOLVO S80 TRANSMISION 4T65E,1379,5,2,8,15
84076,RETEN DE FLECHA IZQUIERDO VOLVO S80 TRANSMISION 4T65E,1431,9,7,7,23
84077G,RETEN DE FLECHA DERECHO VOLVO S80 TRANSMISION 4T65E,1800,1,1,9,11
84111506,ANTICIPO,1500,2,0,6,8
84176631 *A,AMORTIGUADOR CON SENSOR SUSPENSION DELANTERA (L/R) YUKON SUBURBAN ESCALADE  2015 A 2019 (EMBLER) TECH,1863,8,6,8,22
84203420,BALATAS FRENOS TRASEROS MERCEDES R231 AMG TEXTAR,1821,4,3,6,13
84808104 *A,AMORTIGUADOR AIRE SUSPENSION TRASERO CADILLAC  ESCALADE TAHOE YUKON TECH,1339,0,1,7,8
859537 *5,1 GALON CON 3.785  LITROS ANTICONGELANTE LISTO PARA USAR COLOR AZUL (VALVOLINE) SSF,1968,7,3,5,15
859537 *6,1 GALON CON 3.785  LITROS ANTICONGELANTE LISTO PARA USAR COLOR AZUL (ZEREX) SSF,1834,1,2,9,12
86190001051,LUNA DE ESPEJO RETROVISOR ( R ) BMW F30,1383,9,4,6,19
8624509 *5,SOPORTE MOTOR (R) VOLVO S80 2.9 T6 (HUTCHINSON) SSF,1630,5,0,6,11
8627484 *5,BANDA DENTADA DISTRIBUCION MOTOR VOLVO C30 C70 S40 S60 S70 S80 V40 V50 V60 V70 XC70 XC90 (MITSUBOSHI) SSF,1419,9,9,0,18
86276790,SENSOR DE TEMPERATURA DE REFRIGERANTE VOLVO EMBLER,1839,7,7,4,18
8630590,POLEA DE BANDA DE SINCRONIZACION DE MOTOR VOLVO S40 OPTIMAL,1823,6,8,7,21
8630590F,POLEA DE BANDA DE SINCRONIZACION DE MOTOR VOLVO S40 (INA),1598,5,8,9,22
8636779,TERMOSTATO DE MOTOR VOLVO S80 1a GEN. ( GENUINO ),1594,1,9,9,19
8636779-1,TERMOSTATO DE MOTOR VOLVO S80 1a GEN. ( MAHLE ) TX10790D,1854,8,1,8,17
8638600 *3,FILTRO ENTRADA AIRE MOTOR VOLVO XC90  (MAHLE LX868),1594,3,1,7,11
8646713 *5,BASE INFERIOR AMORTIGUADOR SUSPENSION DELANTERA (L/R) VOLVO S60 S70 S80 V70 C70 XC70 (PRO PARTS) SSF,1211,4,6,9,19
8658495 *5,SENSOR ARBOL LEVAS ADMISION ESCAPE VOLVO C30 C70 S40 S60 V50 V60 XC60 XC70 (DENSO) SSF,1912,5,5,1,11
8658495 *6,SENSOR ARBOL LEVAS ADMISION ESCAPE VOLVO C30 C70 S40 S60 V50 V60 XC60 XC70 (BOUGICORD) SSF,1697,6,7,3,16
8675251 *3,JUNTA CABEZA MOTOR MEDIDA STANDAR 1.50X84.5 MM VOLVO S80 XC90 T6 2.9 L (VICTOR REINZ ) SSF,1489,6,1,7,14
8675251 *5,JUNTA CABEZA MOTOR MEDIDA STANDAR 1.50X84.5 MM VOLVO S80 2.9 L T6 (ELRING) SSF,1512,1,8,9,18
8692070 *5,BUJIA IGNICION DOBLE PLATINO VOLVO S40 1a GEN 1.9 L (BOSCH) SSF,1591,5,6,3,14
8692305 *3,FILTRO ACEITE MOTOR VOLVO (MAHLE OX370D),1630,2,2,8,12
8692888 *5,TAPON LLENADO ACEITE MOTOR VOLVO C70 S40 S60 S70 S80 S90 V40 V70 V90 XC70 XC90 (BLAU) SSF,1313,7,6,4,17
8694629 *5,BOMBA AGUA MECANICA ENFRIAMIENTO MOTOR VOLVO 2.9 L T6 (GRAF) SSF,1315,1,4,9,14
8699467,JUNTA DE ESCAPE VOLVO S40 2a GEN CORTECO,1836,4,5,5,14
8822041 *5,JUNTA TAPA PUNTERIAS MOTOR SAAB 9-3 9-5 2.3 L TURBO (VICTOR REINZ) SSF,1996,0,0,6,6
89092415,LIQUIDO LIMPIADOR DE INYECTORES PARA BOYA WURTH,1406,7,7,5,19
89092415-1,LIQUIDO LIMPIADOR DE INYECTORES PRESURIZADO WURTH,1863,6,5,8,19
8D0121101AF,MANGUERA DE AGUA RADIADOR A DEPOSITO AUDI A4 2.8L REIN,1914,1,4,4,9
8D0121101K *5,MANGUERA SUPERIOR RADIADOR AUDI A4 1997 A 2002 VW PASSAT 1999 A 2005 1.8 TURBO 20 V (FEBI) SSF,1854,3,7,2,12
8D0121101K-1,MANGUERA DE AGUA SUPERIOR DE RADIADOR AUDI A4 1.8L L4 MEISTERSATZ,1205,0,6,0,6
8D0121403L,DEPOSITO DE ANTICONGELANTE AUDI A4 1.8L GENERICO,1326,0,1,1,2
8D0121403L-1,DEPOSITO DE ANTICONGELANTE AUDI A4 1.8L BFGERMANY,1682,5,5,0,10
8D0199339P *5,SOPORTE DELANTERO MOTOR AUDI A4 A6 VW PASSAT (CORTECO) SSF,1867,4,2,9,15
8D0199379AQ *5,SOPORTE MOTOR DELANTERO (L) AUDI VW SEAT 1.8 TURBO 20 VALVULAS (REIN) SSF,1644,5,2,7,14
8D0199379AQ *6,SOPORTE MOTOR DELANTERO (L) AUDI VW SEAT 1.8 TURBO 20 VALVULAS (CORTECO) SSF,1219,4,3,0,7
8D0199382AN *5,SOPORTE MOTOR DELANTERO (R) AUDI VW SEAT 1.8 TURBO 20 VALVULAS (REIN) SSF,1513,7,0,5,12
8D0399151J,SOPORTE DE TRANSMISION AUDI 1.8 TURBO 20V 1999 A 2004 EMBLER,1810,3,9,1,13
8D0399151J-1,SOPORTE CAJA AUDI A4 A6 PASSAT CORTECO,1455,8,7,3,18
8D0615601B *2,DISCO FRENOS TRASEROS SOLIDO (L/R) 245X145X83.6 MM AUDI VW SEAT (EMBLER) EMB,1843,3,1,6,10
8D0959455R *5,MOTOVENTILADOR 300W ENFRIAMIENTO MOTOR AUDI A4 A6 1999 A 2002 A8 S8 1997 A 2003 PASSAT 2001 A 2005 1.8 TURBO (ACM) SSF,1812,6,0,0,6
8E0121101 *5,MANGUERA SUPERIOR RADIADOR ENFRIAMIENTO AUDI A4 1.8 TURBO 20 VALVULAS (HUTCHINSON) SSF,1304,1,4,1,6
8E0121101J *5,MANGUERA SUPERIOR RADIADOR ENFRIAMIENTO MOTOR AUDI A4 3.0 V6 2002 A 2005 (VAICO) SSF,1892,5,7,7,19
8E0121101R *2,MANGUERA SUPERIOR RADIADOR ENFRIAMIENTO MOTOR AUDI A4 2.0L TFSI (EMBLER) GOG,1565,6,6,2,14
8E0121101R *5,MANGUERA SUPERIOR RADIADOR ENFRIAMIENTO MOTOR AUDI A4 2.0 TFSI (REIN) SSF,1928,7,3,9,19
8E0121251AP,RADIADOR DE MOTOR AUDI A4 / 2.0 ( REARCH ),1755,2,6,3,11
8E0121403,DEPOSITO ANTICONGELANTE AUDI A4 1.8L 2.0L GENUINO,1549,7,2,6,15
8E0121403 *1,DEPOSITO ANTICONGELANTE AUDI A4 2002 A 2009 1.8 2.0 3.2 LITROS (EMBLER) GOG,1313,9,7,3,19
8E0121403A-100,DEPOSITO ANTICONGELANTE AUDI A4 EMBLER INACTIVO,1710,8,4,6,18
8E0121403F,DEPOSITO ANTICONGELANTE AUDI A4-B7 2004-2009 BEHR 37673713,1296,1,7,2,10
8E0199339,SOPORTE DE MOTOR DELANTERO AUDI A4 TFSI ORIGINAL ( BLANCO ),1896,8,9,7,24
8E0199339 *5,SOPORTE DE MOTOR DELANTERO AUDI A4 TFSI ORIGINAL (REIN) SSF,1682,6,4,6,16
8E0199339-1,SOPORTE DE MOTOR DELANTERO AUDI A4 TFSI ORIGINAL ( ROJO ),1622,5,4,8,17
8E0199379BK *5,SOPORTE MOTOR (L) AUDI A4 2002 A 2005 1.8 TURBO 20 VALVULAS (URO PARTS) SSF,1243,8,2,9,19
8E0199382AH *5,SOPORTE MOTOR (R) AUDI A4 2002 A 2005 1.8 TURBO 20 VALVULAS (FEBI) SSF,1812,7,2,0,9
8E0199382AJ,SOPORTE DE MOTOR TROMPO ( L / R ) AUDI A4 / 2.0 ( CORTECO ),1947,8,6,4,18
8E0201511L *3,FILTRO COMBUSTIBLE GASOLINA AUDI A4 1.8 L TURBO (MAHLE KL858),1358,6,6,7,19
8E0399105JD,SOPORTE DE TRANSMISION AUDI A4 1.8 TURBO ( FEBI ),1725,8,3,1,12
8E0399105JD-1,SOPORTE DE TRANSMISION AUDI A4 1.8 TURBO BFGERMANY,1557,1,4,5,10
8E0407151R *5,BRAZO INFERIOR DE SUSPENSION DELANTERA (L/R) AUDI A4 (DELPHI) SSF,1839,2,4,7,13
8E0407151R-1,BRAZO INFERIOR DE SUSPENSION DELANTERA L-R AUDI A4 BFGERMANY,1343,8,4,4,16
8E0407505A *5,BRAZO SUPERIOR RECTO SUSPENSION DELANTERA (L) AUDI VW (DELPHI) SSF,1629,6,1,1,8
8E0407505A-1,BRAZO SUPERIOR DE SUSPENSION DELANTERA L AUDI A4 1.8L BFGERMANY,1459,7,3,7,17
8E0407505P,BRAZO SUPERIOR RECTO DE SUSPENSION DELANTERA L AUDI A4 DELPHI,1653,4,7,0,11
8E0407505P-1,BRAZO SUPERIOR RECTO DE SUSPENSION DELANTERA L AUDI A4 FEBI,1484,1,2,6,9
8E0407505P-2,BRAZO SUPERIOR RECTO DE SUSPENSION DELANTERA L AUDI A4 BFGERMANY,1526,2,1,6,9
8E0407506A *5,BRAZO SUPERIOR RECTO SUSPENSION DELANTERA (R)  AUDI VW (DELPHI) SSF,1730,2,3,0,5
8E0407506P-1,BRAZO SUPERIOR RECTO DE SUSPENSION DELANTERA R AUDI A4 FEBI,1691,9,0,8,17
8E0407506P-2,BRAZO SUPERIOR RECTO DE SUSPENSION DELANTERA R AUDI A4 BFGERMANY,1587,8,5,8,21
8E0407509,BRAZO CURVO SUPERIOR DE SUSPENSION DELANTERA L AUDI A4 2.0L DELPHI,1568,1,1,6,8
8E0407509P-1,BRAZO CURVO SUPERIOR DE SUSPENSION DELANTERA L AUDI A4 2.0L BFGERMANY,1375,7,2,1,10
8E0407510P,BRAZO CURVO SUPERIOR DE SUSPENSION DELANTERA R AUDI A4 2.0L DELPHI,1458,4,0,5,9
8E0407510P-1,BRAZO CURVO SUPERIOR DE SUSPENSION DELANTERA R AUDI A4 2.0L BFGERMANY,1403,3,7,7,17
8E0407693AG *5,BRAZO CURVO INFERIOR SUSPENSION DELANTERA (L) AUDI A4 A6 A8 RS6 S4 S6 S8 PASSAT (DELPHI ) SSF,1565,1,9,7,17
8E0407693AL *5,BRAZO CURVO INFERIOR DE SUSPENSION DELANTERA L AUDI A4 2.0L (FEBI) SSF,1408,5,3,4,12
8E0407693AL-1,BRAZO CURVO INFERIOR DE SUSPENSION DELANTERA L AUDI A4 2.0L BFGERMANY,1233,7,8,8,23
8E0407694AL *5,BRAZO CURVO INFERIOR DE SUSPENSION DELANTERA R AUDI A4 2.0L (FEBI) SSF,1856,9,4,6,19
8E0407694AL-1,BRAZO CURVO INFERIOR DE SUSPENSION DELANTERA R AUDI A4 2.0L BFGERMANY,1456,9,8,1,18
8E0411317 *5,TORNILLO ESTABILIZADOR SUSPENSION DELANTERA (L) AUDI A4 2002 A 2009 (KARLYN) SSF,1711,3,0,5,8
8E0412377C *2,BASE AMORTIGUADOR SUSPENSION DELANTERA (L/R) AUDI A4 A7 SR4 S4 A4 A7 (EMBLER) SSF,1996,2,0,4,6
8E0413031CT *5,AMORTIGUADOR SUSPENSION DELANTERA (L/R) AUDI A4 2002 A 2008 (BLINSTEN) SSF,1769,1,6,0,7
8E0505465AF *5,TORNILLO ESTABILIZADOR SUSPENSION TRASERA (L/R) AUDI A4 2002 A 2009 (DELPHI) SSF,1892,6,5,5,16
8E0505465D,TORNILLO ESTABILIZADOR SUSPENSION TRASERA (L/R) AUDI A6 PASSAT 1999 A 2006 (LEMFORDER),1368,9,5,5,19
8E0615301AD *2,DISCO FRENOS DELANTEROS VENTILADO (L/R) 320X150X46.3 MM AUDI VW SEAT (EMBLER) EMB,1809,3,5,8,16
8E0615301Q *2,DISCO FRENOS DELANTEROS VENTILADO (L/R) 288X148X46.2 MM AUDI VW SEAT (EMBLER) EMB,1985,0,2,6,8
8E0615301R *2,DISCO FRENOS DELANTEROS VENTILADO (L/R) 312X149X46.2 MM AUDI VW SEAT (EMBLER) EMB,1930,4,8,4,16
8E0615601M *2,DISCO FRENOS TRASEROS SOLIDO (L/R) 288X174X35.8 MM AUDI VW SEAT (EMBLER) EMB,1406,4,6,6,16
8E0615601P *2,DISCO FRENOS TRASEROS SOLIDO (L/R) 245X146X39.7 MM AUDI A4 2002 A 2006 (EMBLER) EMB,1919,8,7,8,23
8E0615601Q *2,DISCO FRENOS TRASEROS SOLIDO (L/R) 255X146X39.9 MM AUDI VW SEAT (EMBLER) EMB,1448,5,1,7,13
8E0698151G *5,BALATAS FRENOS DELANTEROS 155.3 X 72.9 MM AUDI VW SEAT (FERODO) SSF,1855,6,1,6,13
8E0698451J *5,BALATAS FRENOS TRASEROS 105.5 X 55.9MM AUDI A4 2005 A 2009 (FERODO) SSF,1979,7,7,3,17
8E0698451J *6,BALATAS FRENOS TRASEROS 105.5 X 55.9 MM AUDI A4 2005 A 2009 (ATE) SSF,1333,5,4,8,17
8E0698451L *5,BALATAS FRENOS TRASEROS 87.0 X 53.0 MM AUDI A4 S4 TT (ATE) SSF,1543,4,9,4,17
8E0819439 *5,FILTRO AIRE CABINA AUDI A4 S4 (AIRMATIC) SSF,1489,5,0,3,8
8E0906087E *2,BOMBA DE GASOLINA ELECTRICA AUDI A6 (VDO) SSF,1530,2,3,7,12
8E0919051CG *5,BOMBA GASOLINA ELECTRICA AUDI A4 2003 A 2006 1.8 TURBO 20 VALVULAS 3.0 (BAPMIC) SSF,1505,8,4,0,12
8E0919051CN *5,BOMBA GASOLINA ELECTRICA AUDI A4 2005 A 2008 (HELLA) SSF,1849,6,4,5,15
8E0959455N *5,MOTOVENTILADOR ENFRIAMIENTO DE MOTOR AUDI A4 2.0L (FEBI) SSF,1331,5,8,2,15
8F0413031AA *5,AMORTIGUADOR SUSPENSION DELANTERA (L/R) AUDI A4 A5 Q5ï¿½(BILSTEIN)ï¿½SSF,1462,1,7,3,11
8K0121403,DEPOSITO DE ANTICONGELANTE AUDI A4-B7 2.0 TFSI GENUINO,1353,6,7,9,22
8K0121403-2,DEPOSITO DE ANTICONGELANTE AUDI A4-B8 URO,1481,4,3,8,15
8K0121403-5,DEPOSITO DE ANTICONGELANTE AUDI A4-B8 VIKA,1981,1,2,5,8
8K0121403AC *2,DEPOSITO ANTICONGELANTE MOTOR AUDI A4 A5 A7 Q5 TFSI 2.0 TFSI 3.0 FSI (EMBLER) GOG,1818,0,3,7,10
8K0121405A,DEPOSITO DE ANTICONGELANTE AUDI A5 8T 3.0TDI DORMAN ALEMAN,1969,1,3,2,6
8K0133843E,FILTRO ENTRADA AIRE MOTOR AUDI A5 3.2 LTS MANN C16114X,1596,8,5,4,17
8K0133843E-1,FILTRO ENTRADA AIRE MOTOR AUDI A4 2.0 L TFSI VIKA,1590,4,8,3,15
8K0133843E-3,FILTRO ENTRADA AIRE MOTOR AUDI A4 2.0 L TFSI MANN C32130,1700,2,3,2,7
8K0133843M *5,FILTRO ENTRADA AIRE MOTOR 128 X 322 MM AUDI S4 S5 SQ5 (HENGST) SSF,1551,1,4,6,11
8K0199381CQ -7,SOPORTE DE MOTOR ELECTRONICO CON SENSOR L-R AUDI A4 2.0-3.2 TFSI CORTECO,1869,9,9,1,19
8K0199381GQ,SOPORTE DE MOTOR L-R AUDI A4 2.0 Y 3.2 TFSI LEMFORDER,1691,9,1,9,19
8K0407151F *5,BRAZO CONTROL INFERIOR DELANTERO (L) AUDI A4 S4 A5 (LEMFOERDER) SSF,1487,9,0,0,9
8K0407151F *6,BRAZO CONTROL INFERIOR DELANTERO (L) AUDI A4 S4 A5 (FEBI) SSF,1603,5,2,0,7
8K0407152F *5,BRAZO CONTROL INFERIOR DELANTERO (R) AUDI A4 S4 A5 (LEMFOERDER) SSF,1795,8,8,4,20
8K0407152F *6,BRAZO CONTROL INFERIOR DELANTERO (R) AUDI A4 S4 A5 (FEBI) SSF,1771,7,3,6,16
8K0407182B *5,BUJE DE BRAZO INFERIOR DE SUSPENSION DELANTERA AUDI A4 (LEMFOERDER) SSF,1433,9,1,2,12
8K0407182B *6,BUJE DE BRAZO INFERIOR DE SUSPENSION DELANTERA AUDI A4 (CORTECO) SSF,1232,7,6,9,22
8K0407183F *3,BUJE DE BRAZO CURVO (L/R) AUDI A4 A5 Q5 S4 S5 2010 A 2023 (METRIX PREMIUM),1687,8,3,5,16
8K0407183F *5,BUJE DE BRAZO CURVO L-R AUDI A4 2.0L LEMFOERDER,1536,1,8,4,13
8K0407183F *6,BUJE DE BRAZO CURVO (L/R) AUDI A4 A5 Q5 S4 S5 2010 A 2023 (FEBI) SSF,1692,5,9,4,18
8K0407183F *7,BUJE DE BRAZO CURVO (L/R) AUDI A4 A5 Q5 S4 S5 2010 A 2023 (DELPHI) SSF,1828,8,8,6,22
8K0407183F-1,BUJE DE BRAZO CURVO L-R AUDI A4 2.0L OPTIMAL,1231,2,1,7,10
8K0407505N *5,BRAZO CONTROL RECTO DELANTERO (L) AUDI A4 (FEBI) SSF,1904,4,2,0,6
8K0407505N *6,BRAZO CONTROL RECTO DELANTERO (L) AUDI A4 (DELPHI) SSF,1609,0,9,3,12
8K0407506A *3,BRAZO RECTO SUPERIOR  DELANTERO (R) AUDI A4 A5 Q5 (VIKA),1387,0,8,3,11
8K0407509A *3,BRAZO RECTO SUSPENSION DELATERA (L) AUDI A4 A5 Q5 (VIKA),1317,6,4,2,12
8K0407510A *3,BRAZO CURVO SUPERIOR  DELANTERO (R) AUDI A4 A5 Q5 (VIKA),1438,4,6,0,10
8K0407515 *5,BUJE BRAZO SUPERIOR SUSPENSION DELANTERA (L/R) AUDI A4 A5 Q5 S4 S5 SQ5 (FEBI) SSF,1751,8,1,6,15
8K0407689,ROTULA SUSPENSIï¿½N INFERIOR DELANTERO ( L-R ) AUDI A5 TOPRAN,1557,9,2,3,14
8K0407693AD *3,BRAZO CURVO INFERIOR SUSPENSION DELANTERA (L) AUDI A4 A5 Q5 RS5 S4 S5 (VIKA),1606,6,9,8,23
8K0407693AD *5,BRAZO CURVO INFERIOR SUSPENSION DELANTERA (L) AUDI A4 A5 Q5 RS5 S4 S5 (KARLYN) SSF,1420,4,6,2,12
8K0407694AD *3,BRAZO CURVO INFERIOR SUSPENSION DELANTERA (R) AUDI A4 A5 Q5 RS5 S4 S5 (METRIX),1990,4,2,8,14
8K0407694AD *5,BRAZO CURVO INFERIOR SUSPENSION DELANTERA (R) AUDI A4 A5 Q5 RS5 S4 S5 (KARLYN) SSF,1649,1,2,9,12
8K0411317D *5,TORNILLO BARRA ESTABILIZADORA SUSPENSION DELANTERA (L/R) AUDI A4 A5 Q5 S4 S5 SQ5 (GENUINO) SSF,1524,4,1,7,12
8K0411317D *6,TORNILLO BARRA ESTABILIZADORA SUSPENSION DELANTERA (L/R) AUDI (LEMFOERDER) SSF,1457,9,1,5,15
8K0412377C *3,BASE AMORTIGUADOR SUSPENSION DELANTERA (L/R) AUDI A4 A5 S4 S5 RS5 Q5 SQ5 (MEISTERSATZ),1653,0,6,4,10
8K0412377C *5,BASE AMORTIGUADOR SUSPENSION DELANTERA (L/R) AUDI A4 A5 S4 S5 RS5 Q5 SQ5 (GENUINA) SSF,1240,5,9,8,22
8K0412377C *6,BASE AMORTIGUADOR SUSPENSION DELANTERA (L/R) AUDI (LEMFOERDER) SSF,1849,5,7,6,18
8K0413031BF,AMORTIGUADOR DE SUSPENSION DELANTERA ( L-R ) AUDI A4 TFSI SACHS 313363,1417,6,2,3,11
8K0505465G *5,TORNILLO BARRA ESTABILIZADORA TRASERA (L/R) AUDI A4 A5 A6 (LEMFOERDER) SSF,1763,1,4,6,11
8K0513035AJ,AMORTIGUADOR DE SUSPENSION TRASERA ( R ) AUDI A4 TFSI SACHS 313365,1810,2,6,5,13
8K0513353E,BASE DE AMORTIGUADOR SUPERIOR TRASERO L-R AUDI A4 FEBI,1462,7,5,7,19
8K0615301A *2,DISCO FRENOS DELANTEROS VENTILADO (L/R) 320X166X52.2 MM AUDI VW SEAT (EMBLER) EMB,1271,1,8,6,15
8K0615601M *2,DISCO FRENOS TRASEROS SOLIDO (L/R) 300X112X36.2 MM AUDI VW SEAT (EMBLER) EMB,1218,8,2,5,15
8K0615601M *5,DISCO FRENOS TRASERO 300X36 MM (L/R) AUDI A4 A5 Q5 (FREMAX) SSF,1716,9,8,7,24
8K0698151K *3,BALATAS FRENOS DELANTEROS 188.2 X 73.5  MM AUDI A4 A5 A6 A7 Q5 (TRW GDB1768),1611,9,1,1,11
8K0698151K *5,BALATAS FRENOS DELANTEROS 188.2 X 73.5 MM AUDI A4 A5 A6 A7 Q5 (FERODO) SSF,1324,5,0,1,6
8K0698151K *6,BALATAS FRENOS DELANTEROS 188.2 X 73.5 MM AUDI A4 A5 A6 A7 Q5 (ATE) SSF,1464,6,7,4,17
8K0698151K *7,BALATAS FRENOS DELANTEROS 188.2 X 73.5 MM AUDI A4 A5 A6 A7 Q5 (JURID) SSF,1803,0,6,2,8
8K0698451L *5,BALATAS FRENOS TRASEROS 116.6 X 58.5 MM AUDI VW SEAT (FERODO) SSF,1793,2,4,2,8
8K0698451L *6,BALATAS FRENOS TRASEROS 116.6 X 58.5 MM AUDI VW SEAT (ATE) SSF,1680,5,8,5,18
8K0819439 *5,FILTRO POLEN AIRE CABINA AUDI A4 A5 Q5 RS5 S4 S5 SQ5 (AIRMATIC ) SSF,1730,8,5,9,22
8K0819439 *6,FILTRO POLEN AIRE CABINA AUDI A4 A5 Q5 RS5 S4 S5 SQ5 (CORTECO) SSF,1916,8,8,2,18
8K0819439A,FILTRO POLEN AIRE CABINA AUDI A4 MANN CUK2450,1705,6,6,3,15
8K0906093H *3,MODULO DE BOMBA DE GASOLINA AUDI A4 A5 Q5 S4 S5 1.8 2.0 3.2 (VIKA),1781,3,9,4,16
8K0919051AS *2,BOMBA GASOLINA ALTA PRESION AUDI A5 A5 S4 S5 (VERMO),1734,8,0,8,16
8K0941597 *2,BALASTRA MODULO ELECTRONICO LUZ XENON D3S AUDI VW (EMBLER) MLL,1874,6,9,5,20
8K0959455K,MOTOVENTILADOR ( L ) 400W AUDI A4 / 2.0L ( ACM ),1297,5,1,5,11
8K0959455K *M,MOTOVENTILADOR (L) 400W AUDI A4 2.0L (EMBLER) GOG,1392,1,4,5,10
8K0959455K-1,MOTOVENTILADOR (L) 400W AUDI A4- 2.0L URO,1878,6,9,0,15
8K0959455M,MOTOVENTILADOR 200 W  ( R ) AUDI A4 ( ACM ),1799,5,4,6,15
8K0959455T *3,MOTOVENTILADOR 400W ENFRIAMIENTO AUDI A4 A5 A6 Q5 (BAPMIC),1916,3,9,8,20
8N0407181B *5,BUJE TRASERO HORQUILLA INFERIOR SUSPENSION DELANTERA (L/R) JETTA A4 AUDI TT (FEBI) SSF,1233,7,3,5,15
8N0615301A *2,DISCO FRENOS DELANTEROS VENTILADO (L/R) 312X146X34.0 MM AUDI VW SEAT (EMBLER) EMB,1829,1,4,8,13
8N1Z5A891Bï¿½-100,AMORTIGUADOR AIRE SUSPENS (EMBLER) CYS INACTIVO,1272,1,7,0,8
8PK1478 *5,BANDA ACCESORIOS MOTOR MEDIDA  8PK 1478 MM BMW E70 E71 F01 F07 N55 (CONTINENTAL) SSF,1510,0,1,7,8
8R0133843K *5,FILTRO ENTRADA AIRE MOTOR 128 X 322 MM AUDI VW SEAT (HENGST) SSF,1912,5,5,3,13
8R0133843K *6,FILTRO ENTRADA AIRE MOTOR AUDI A4-B9 2.0 TFSI (MANN) SSF,1498,2,8,9,19
8R0199381AK *2,SOPORTE MOTOR ELECTRONICO CON SENSOR (L/R) AUDI VW PORSCHE (EMBLER) GOG,1302,0,3,7,10
8R0199381AK *5,SOPORTE MOTOR ELECTRONICO CON SENSOR (L/R) AUDI VW PORSCHE (LEMFORDER) SSF,1793,5,3,8,16
8R0199381AL *2,SOPORTE MOTOR ELECTRONICO SIN SENSOR (L/R) AUDI A4  2.0 3.2 TFSI (EMBLER),1226,2,9,6,17
8R0199381AL *5,SOPORTE MOTOR ELECTRONICO SIN SENSOR (L/R) AUDI A4  2.0 3.2 TFSI (LEMFORDER) SSF,1928,5,7,0,12
8R0199381AL-2,SOPORTE DE MOTOR ELECTRONICO SIN SENSOR L-R AUDI A4  2.0-3.2 TFSI BFGERMANY,1543,4,7,0,11
8R0199381C *5,SOPORTE MOTOR ELECTRONICO CON SENSOR (L/R) AUDI PORSCHE (LEMFOERDER) SSF,1750,8,3,2,13
8R0199381C *6,SOPORTE MOTOR ELECTRONICO CON SENSOR (L/R) AUDI PORSCHE (CORTECO) SSF,1873,6,0,4,10
8R0615121A,SENSOR DE FRENO AUDI Q5 OSSCA,1675,7,7,7,21
8R0615301F *2,DISCO FRENOS DELANTEROS VENTILADO (L/R) 320X162X52.1 MM AUDI VW SEAT (EMBLER) EMB,1565,3,6,6,15
8R0698151AG-100,BALATAS FRENOS DELANTEROS AUDI Q5 PAGID T2212 inactivo,1995,8,5,8,21
8R0906262E *2,SENSOR DE OXIGENO DELANTERO AUDI A4 A5 A6 Q5 2.0 TFSI (EMBLER),1721,6,7,9,22
8R0941476A,MODULO LED DE LUZ DIURNA PARA OJO DE ANGEL ( R ) AUDI Q5 ( XENPLUS  ),1553,9,2,3,14
8R0941476B,MODULO LED DE LUZ DIURNA PARA OJO DE ANGEL ( L ) AUDI Q5 ( XENPLUS ),1479,0,5,4,9
8T0413031AF *3,AMORTIGUADOR AIRE SUSPENSION DELANTERA (L/R) AUDI A4 A5 (VIKA),1487,5,5,0,10
8T0513035M *A,AMORTIGUADOR AIRE SUSPENSION TRASERA (L/R) AUDI A4 A5 SEAT VW (EMBLER) TECH,1370,8,2,0,10
8V0615437,SENSOR BALATAS FRENOS DELANTERO (L/R) AUDI A3 TOPRAN,1749,5,3,2,10
8V0698151G *3,BALATAS FRENOS DELANTEROS 160.2 X 64.5 MM AUDI VW SEAT (TRW GDB1956),1648,2,1,6,9
8V0698151G *5,BALATAS FRENOS DELANTEROS 160.2 X 64.5 MM AUDI VW SEAT (JURID) SSF,1815,7,1,8,16
8W0121081AN *2,MANGUERA RADIADOR ENFRIAMIENTO MOTOR AUDI A4 A5 2.0 L 2017-2020 (EMBLER),1728,0,3,9,12
8W0121081DR *2,MANGUERA DEPOSITO ANTICONGELANTE A RADIADOR AUDI A4 A5 2.0L 2017 A 2024 (EMBLER),1222,2,8,9,19
8W0133843 *5,FILTRO ENTRADA AIRE MOTOR 152 MM AUDI A4 A5 S4 S5 SQ5 (MANN) SSF,1593,0,2,5,7
8W0133843B *3,FILTRO ENTRADA AIRE MOTOR AUDI A4 2017 A 2020 (MAHLE LX4411) DGO,1648,8,5,0,13
8W0133843C *3,FILTRO ENTRADA AIRE MOTOR 152 MM AUDI A4 A5 S4 S5 SQ5 (MALEH LX4406) DGO,1228,5,2,1,8
8W0133843C *6,FILTRO ENTRADA AIRE MOTOR 90 X 152 MM AUDI A4 A5 Q5 (HENGST) SSF,1436,1,4,0,5
8W0133843C-100,FILTRO ENTRADA AIRE MOTOR AUDI A4 VIKA INACTIVO,1755,1,0,5,6
8W0133843C-101,FILTRO ENTRADA AIRE MOTOR 90 X 152 MM AUDI A4 A5 Q5 (MANN) SSF INACTIVO,1458,9,5,6,20
8W0407151C *6,BRAZO RECTO INFERIOR SUSPENSION DELANTERA (L) AUDI A4 2017 A 2022 A5 2018 A 2022 (FEBI) SSF,1932,5,3,4,12
8W0407506C *3,BRAZO RECTO SUSPENSION DELANTERA (R) AUDI A4 A5 RS5 S4 S5 SEAT VW (VIKA),1763,4,7,2,13
8W0407510B *3,BRAZO CONTROL RECTO SUSPENSION DELANTERA (R) AUDI A4 A5 RS5 S4 S5 SEAT VW (VIKA),1477,0,6,0,6
8W0413031AA *3,AMORTIGUADOR AIRE SUSPENSION DELANTERA (L/R) AUDI A4 A5 (ALKO),2000,5,2,2,9
8W0615121H,SENSOR BALATAS FRENOS DELANTERO (L/R) AUDI A5 A4 Q5 (BOWA),1708,0,5,9,14
8W0615301AB *2,DISCO FRENOS DELANTEROS VENTILADO (L/R) 338X162X57.0 MM AUDI VW SEAT (EMBLER) EMB,1715,6,5,9,20
8W0615601H *2,DISCO FRENOS TRASEROS SOLIDO (L/R) 300X166X36.0 MM AUDI VW SEAT (EMBLER) EMB,1861,5,3,5,13
8W0615601K *2,DISCO FRENOS TRASEROS VENTILADO (L/R) 330X162X35.8 MM AUDI VW SEAT (EMBLER) EMB,1828,1,7,2,10
8W0698151AG *3,BALATAS FRENOS DELANTEROS 155X63.8 MM AUDI A4 2.0 (TRW),1290,5,6,0,11
8W0698151BC *5,BALATAS FRENOS DELANTEROS 210.2 X 99.0 MM AUDI VW SEAT (FERODO) SSF,1657,4,1,4,9
8W0698151BC *6,BALATAS FRENOS DELANTEROS 210.2 X 99.0 MM AUDI VW SEAT (ATE) SSF,1937,3,8,7,18
8W0698451AH *5,BALATAS FRENOS TRASEROS 129.1 X 58.6 MM AUDI VW SEAT (ATE) SSF,1529,0,6,0,6
8W0698451N *3,BALATAS FRENOS TRASEROS 129.1 X 58.6 MM AUDI VW SEAT (TRW GDB2132),1839,4,9,7,20
8W0698451N *5,BALATAS FRENOS TRASEROS 129.3 X 59.0 MM AUDI VW SEAT (FERODO) SSF,1348,4,5,3,12
8X3827552 *3,AMORTIGUADOR CAJUELA 600 NEWTONS 513 MM (L/R) AUDI A1 (VERMO),1843,3,2,0,5
8d0199379,SOPORTE DE MOTOR AUDI A3 A4 A6 CORTECO,2000,0,6,5,11
8k0121403-1,DEPOSITO DE ANTICONGELANTE AUDI A4-B8 MEISTERSATZ,1408,9,1,3,13
8k0121403-3,DEPOSITO DE ANTICONGELANTE AUDI A4-B8 TOPRAN,1776,8,6,8,22
90,"JUEGO DE 4 EMBLEMAS DE RIN """"M"""" BMW E92",1506,4,5,8,17
90-3,EMBLEMA M3 BMW E92,1899,7,4,4,15
9013200089 *1,Estabilizador Para Mercedes-Benz (FREY),1756,9,7,0,16
9013200289 *1,Estabilizador Para Mercedes-Benz VW (FREY),1811,7,8,7,22
9013200389 *1,Estabilizador Para Mercedes-Benz VW ( FREY ),1621,9,7,3,19
9013200631 *1,AMORTIGUADOR SUSPENSION TRASERA (L/R) SPRNTER W901 A W905 (FREY),1676,2,8,3,13
9013201606 *1,MUELLE SUSPENSION TRASERA (L/R) SPRINTER W901 A W905 (FREY),1834,2,6,4,12
9013201606B,MUELLE SUSPENSION TRASERA (L/R) SPRINTER W901 A W905 (FREY) B,1275,2,8,2,12
9013202130 *1,AMORTIGUADOR SUSPENSION DELANTERA (L/R) SPRINTER W901 A W905 (FREY),1810,7,5,8,20
9013230198 *1,"TAPA PROTECTORA CONTINUACIï¿½N, AMORTIGUADOR MERCEDES (FREY)",1651,2,2,1,5
9013231185 *1,BASE AMORTIGUADOR SUSPENSION DELANTERA (L/R) SPRINTER W901 A W905 (FREY),1706,0,6,9,15
9013250844 *1,BUJE SUPERIOR TRASERO MERCEDES / SPRINTER 901 FREY,1541,3,8,9,20
9013301707 *1,Brazo de control de seguimiento para Mercedes Benz VW ( FREY ),1544,3,8,7,18
9013331127 *1,ROTULA HORQUILLA SUPERIOR SUSPENSION DELANTERA (L/R) SPRINTER W901 A W905 (FREY),1914,1,8,5,14
9014110097 *1,FUELLE DE ARBOL DE TRANSMISION SPRINTER (FREY),1804,7,5,3,15
9014110312 *1,Almacenamiento de las articulaciones ola para mercedes benz (FREY),1255,8,1,1,10
9014200120 *1,PASTILLA DE FRENO SPRINTER (FREY),1242,4,9,7,20
9014201885 *1,CHICOTE FRENO ESTACIONAMIENTO TRASERO 1513 MM (L/R) SPRINTER W901 A W905 (FREY),1511,8,9,4,21
9014230612 *1,DISCO FRENOS TRASERO 285 MM (L/R) SPRINTER W901 A W905 (FREY),1642,4,1,3,8
9014600148 *1,TERMINAL DIRECCION SIN BIELETA SUSPENSION DELANTERA (L/R) SPRINTER W901 A W905 (FREY),1897,1,7,3,11
9014600155 *1,BIELETA DIRECCION SIN TERMINAL SUSPENSION DELANTERA (L/R) SPRINTER W901 A W905 (FREY),1652,3,8,1,12
9014600205 *1,BIELETA DIRECCION CON TERMINAL SUSPENSION DELANTERA (L/R) SPRINTER W901 A W905 (FREY),1625,9,4,0,13
9014605500B,CUBRE POLVO DIRECCION HIDRAULICA SPRINTER W901 A W905 (FREY),1973,3,7,9,19
9014620179 *1,CILINDRO CERRADURA CHAPA PUERTA DELANTERA (L) SPRINTER W901 A W905 (FREY),1767,6,2,4,12
9015284382 *1 ,MANGUERA ENTRADA AIRE INTERCOOLER (R) SPRINTER W901 A W905 (FREY),1470,1,9,3,13
9015400117 *1,SENSOR BALATAS FRENOS DELANTERO TRASERO (L/R) SPRINTER 901 A 905 (FREY),1380,7,5,7,19
9015400217 *1,SENSOR BALATAS FRENOS DELANTERO TRASERO (L/R) SPRINTER W901 A W905 (FREY),1785,5,6,7,18
9015421717 *1,SENSOR FRENOS ABS RUEDA DELANTERA (L/R) SPRINTER W901 A W905 (FREY),1419,9,6,7,22
9017600459 *1,MANIJA EXTERNA PUERTA TRASERA SIN LLAVE (L/R) SPRINTER W901 A W905 (FREY ),1366,6,5,9,20
9017600704 *1,CHICOTE MANIJA PUERTA DELANTERA (L/R) SPRINTER W901 A W905 (FREY),1739,8,6,8,22
9018800385 *1,PARRILLA FRENTE COFRE SPRINTER W901 A 905 (FREY ),1247,6,0,8,14
9023340301 *1,Muï¿½ones enroscarse delantero izquierdo ( FREY ),1554,7,4,6,17
9024201201 *1,El freno de disco para mercedes benz VW FREY,1576,5,8,9,22
9024230312 *1,Discos de Freno Pastillas Delantero Trasero Para Mercedes ( FREY),1463,7,9,6,22
90325572,RETEN DE CIGUEï¿½AL TRASERO SAAB 9-3 ( CORTECO 90 X 104 X 11 MM ),1976,6,8,5,19
9034100010 *1,BALERO SOPORTE CENTRAL CARDAN 193X140X45 MM SPRINTER W901 A W905 (FREY),1375,2,3,5,10
9043111 *5,GRASA MOLIBDENO ESPECIAL JUNTAS HOMOSINETICA 80 GRAMOS (GKN LOEBRO) SSF,1591,7,5,5,17
9043200231 *1,AMORTIGUADOR SUSPENSION TRASERA (L/R) SPRINTER W901 A W905 (FREY),1988,0,7,9,16
9043201930-100,AMORTIGUADOR SUSPENSION DELANTERA (L/R) W901 A W905 INACTIVO,1446,6,6,4,16
9043260981 *1,BUJES GOMA BARRA ESTABILIZADORA TRASERA (L/R) SPRINTER W901 A W905 (FREY ),1815,1,0,8,9
9043261081 *1,BUJE GOMA BARRA ESTABILIZADORA SUSPENSION TRASERA 33 MM (L/R) SPRINTER W901 A W905 (FREY ),1481,2,4,5,11
9043500039 *1,DIFERENCIAL 215 MM CORONA 35 DIENTES PIï¿½ON 8 DIENTES SPRINTER W901 A W905 (FREY),1221,7,7,8,22
9044200101 *1,Pinza de freno delantero izquierdo se ajusta Volkswagen (FREY),1522,4,1,6,11
9044200285 *1,CHICOTE FRENO ESTACIONAMIENTO TRASERO (R) 1520 MM SPRINTER W901 A W906 (FREY ),1540,7,8,0,15
9044200320 *1,KIT 4 PZ. BALATAS FRENO ESTACIONAMIENTO SPRINTER W901 A W905 (FREY),1556,0,7,3,10
9044200385 *1,CHICOTE FRENO ESTACIONAMIENTO DELANTERO 1970 MM SPRINTER W901 A W905 (FREY),1885,7,8,5,20
9044200485 *1,"Cable, Freno De Estacionamiento Para Mercedes-Benz FREY",1912,4,9,2,15
9050342,SENSOR DE ESTACIONAMIENTO MERCEDES W204 ( BMTR ),1941,1,4,2,7
90537687 *5,JUNTA TAPA PUNTERIAS MOTOR SAAB 9-3 TURBO 2.0 L (ELRING) SSF,1595,0,7,3,10
9062411513 *1,SOPORTE MOTOR (L/R) SPRINTER W906 CRAFTER 2006 A 2016 (FREY),1306,8,8,7,23
9062411613 *1,MONTAJE DE MOTOR MERCEDES BENZ (FREY),1719,3,1,1,5
9062420013 *1,SOPORTE TRANSMISION MANUAL O AUTOMATICA (L/R) SPRINTER W906 CRAFTER 2006 A 2016 (FREY),1464,1,1,7,9
9062601551 *1,CHICOTES PALANCA VELOCIDADES ESTANDAR MERCEDES W906 CRAFTER 2006 A 2016 (FREY),1745,2,6,4,12
9062603309 *1,PALANCA VELOCIDADES TRANSMISION STANDAR SPRINTER W906 (FREY),1422,9,9,2,20
9062680166 *1,ARTICULACION ENLACE CHICOTE SELECTOR VELOCIDADES TRANSMISION STANDAR SPRINTER 906 (FREY ),1913,2,9,6,17
9062900212 *1,BOMBA CLUTCH CILINDRO MAESTRO SPRINTER W906 (FREY),1985,7,0,7,14
9062900501 *1,MECANISMO PEDAL CLUTCH SPRINTER W906 CRAFTER 2006 A 2016 (FREY),1842,6,0,4,10
9062900501B,MECANISMO PEDAL CILINDRO BOMBA CLUTCH SPRINTER W906 CRAFTER 2006 A 2016 (FREY),1488,0,1,6,7
9063200931 *1,AMORTIGUADOR SUSPENSION TRASERA (L/R) SPRINTER W906 CRAFTER 2006 A 2016 (FREY,1582,6,3,9,18
9063201389 *1,TORNILLO ESTABILIZADOR SUSPENSION TRASERA (L/R) SPRINTER W906 VW CRAFTER 2006 A 2016 (FREY),1933,4,4,1,9
9063201489 *1,Nuevo Estabilizador Puntal Barra Para Mercedes Benz VW (FREY),1646,0,0,0,0
9063201789 *1,TORNILLO ESTABILIZADOR SUSPENSION DELANTERA (L) SPRINTER W906 CRAFTER 2006 A 2016 (FREY),1687,8,4,4,16
9063201806 *1,MUELLE SUSPENSION TRASERA 70X750 MM (L/R) SPRINTER W906 CRAFTER 2006 A 2016 (FREY),1599,9,5,1,15
9063201889 *1,TORNILLO ESTABILIZADOR SUSPENSION DELANTERA (R) SPRINTER W906 (FREY),1424,6,4,7,17
9063203206 *1,HOJA MUELLE DETRAS DE RESORTE P.F MERCEDES (FREY),1638,5,5,2,12
9063206206 *1,MUELLE MAESTRA SUSPENSION TRASERA (L/R) SPRINTER W906 VW CRAFTER 2006 A 2016 (FREY),1283,3,6,4,13
9063206230 *1 ,AMORTIGUADOR SUSPENSION DELANTERA (L/R) SPRINTER W906 CRAFTER 2006 A 2016 (FREY),1745,7,8,3,18
9063211003 *1,MUELLE SUSPENSION DELANTERA 670 MM (L/R) SPRINTER W906 VW CRAFTER 2006 A 2016 (FREY),1568,3,1,9,13
9063220319 *1,BUJE DELANTERO SUPERIOR SPRINTER W906 (FREY),1611,0,9,4,13
9063220619 *1,TOPE GOMA MUELLE SUSPENSION TRASERA (L/R) SPRINTER W906 (FREY),1425,9,3,1,13
9063230292 *1,CUBRE POLVO AMORTIGUADOR (L/R) SUSPENSION DELANTERA SPRINTER W906 VW CRAFTER 2006 A 2016 (FREY),1229,8,8,1,17
9063230520 *1,BASE AMORTIGUADOR SUSPENSION DELANTERA (L/R) SPRINTER W906 VW CRAFTER 2006 A 2016 (FREY),1528,4,2,2,8
9063231685 *1,GOMA BARRA ESTABILIZADORA DELANTERA 23 MM (L/R) SPRINTER W906 CRAFTER 2006 A 2016 (FREY),1286,9,5,2,16
9063231685 *3,GOMA BARRA ESTABILIZADORA DELANTERA 23 MM (L/R) SPRINTER W906 CRAFTER 2006 A 2016 (CORTECO),1848,8,8,0,16
9063240050 *1,BUJE MUELLE SUSPENSION TRASERA (L/R) SPRINTER W906 CRAFTER 2006 A 2016 (FREY),1611,5,6,9,20
9063251444 *1,automotive atentado bï¿½fer amortiguadores (FREY),1513,2,2,3,7
9063260000 *1,AMORTIGUADOR SUPENSION TRASERA (L/R) SPRINTER W906 CRAFTER 2006 A 2016 (FREY),1336,7,9,1,17
9063260781 *1,BUJE BARRA ESTABILIZADORA SUSPENSION TRASERA 15.5 MM (L/R) SPRINTER W906 VW CRAFTER 2006 A 2016 (FREY),1941,4,9,0,13
9063304007 *1,HORQUILLA INFERIOR SUSPENSION DELANTERA (L) SPRINTER W906 CRAFTER 2006 A 2016 (FREY),1424,7,2,6,15
9063304107 *1,HORQUILLA INFERIOR SUSPENSION DELANTERA (R ) SPRINTER W906 CRAFTER 2006 A 2016 (FREY),1693,4,5,7,16
9063305020 *1,Eje Nudillo delantero derecho FREY,1679,2,0,8,10
9063330014 *1,BRAZO ARRANQUE BUSH MERCEDES FREY,1514,8,1,6,15
9063380227 *1,ROTULA HORQUILLA INFERIOR DELANTERA (L/R) SPRINTER W906 CRAFTER 2006 A 2016 (FREY),1324,5,1,2,8
9063500135 *1,CUBO DE RUEDA TRASERA (FREY),1267,1,5,7,13
9063500249 *1,Trasero Cubo De Rueda Kit de rodamientos FREY,1247,8,4,3,15
9063503901 *1,FECHA DIFERENCIAL TRASERO SPRINTER W906 (FREY),1516,7,0,9,16
9064100001 *1,1 PZ FLECHA CARDAN DELANTERO 921 MM SPRINTER W906 VW CRAFTER 2006 A 2016 (FREY),1806,7,2,7,16
9064100131 *1,CRUCETA FECHA CARDAN 88X27 MM SPRINTER W906 CRAFTER 2006 A 2016 (FREY),1588,3,5,6,14
9064100281 *1,BALERO SOPORTE CENTRAL CARDAN 222X140X44 MM SPRINTER W906 CRAFTER 2006 A 2016 (FREY),1949,3,3,5,11
9064100381-100,BALERO SOPORTE CENTRAL CARDAN TRASERO SPRINTER W906 CRAFTER INACTIVO,1292,2,1,0,3
9064101281 *1,KIT 3 PZ BALERO SOPORTE CENTRAL CARDAN TRASERO SPRINTER W906 CRAFTER 2006 A 2016 (FREY),1313,7,9,7,23
9064101306 *1,2 PZ FLECHAS CARDAN 2582 MM SPRINTER W906 VW CRAFTER 2006 A 2016 (FREY),1538,9,2,3,14
9064101816 *1,2 PZ FLECHAS CARDAN 2754 + 820 MM SPRINTER W906 CRAFTER 2006 A 2016 A (FREY),1570,9,1,6,16
9064110015 *1,JUNTA GOMA CARDAN 160X120X70 MM SPRINTER W906 MERCEDES W204 W221 W212 (FREY),1865,3,1,9,13
9064200320 *1,KIT 4  PZ. BALATAS FRENOS ESTACIONAMIENTO (L/R) SPRINTER W906 CRAFTER 2006 A 2016 (FREY),1222,2,7,4,13
9064200420 *1,KIT 4 PZ. BALATAS FRENOS DE ESTACIONAMIENTO (FREY),1238,1,3,8,12
9064202385 *1,CHICOTE FRENO ESTACIONAMIENTO DELANTERO 2522 MM SPRINTER W906 CRAFTER 2006 A 2016 (FREY),1510,9,8,3,20
9064202785 *1,CHICOTE FRENO ESTACIONAMIENTO DELANTERO 2425 MM SPRINTER W906 CRAFTER 2006 A 2016 (FREY),1302,4,6,9,19
9064203085 *1,CHICOTE FRENO ESTACIONAMIENTO TRASERO 1400 MM (L/R) SPRINTER W906 CRFATER (FREY),1296,0,5,7,12
9064207085-100,CHICOTE FRENO ESTACIONAMIENTO TRASERO 1400 MM (L/R) SPRINTER W906 CRAFTER INACTIVO,1379,4,8,2,14
9064210012 *1,DISCO FRENOS DELANTEROS (L/R) 300 MM SPRINTER W906 CRAFTER 2006 A 2016 (FREY),1416,0,8,4,12
9064210400 *1,BALATAS FRENOS DELANTEROS 163 X 67 MM SPRINTER W906 VITO VIANO CRAFTER 2006 A 2016 (FREY),1957,4,4,2,10
9064230112 *1,DISCO FRENOS TRASEROS 303X28 MM (L/R) SPRINTER W906 CRAFTER 2006 A 2016 (FREY),1849,9,9,6,24
9064600048 *1,TERMINAL DIRECCION SIN BIELETA SUSPENSION DELANTERA (L/R) SPRINTER W906 (FREY),1226,5,6,8,19
9064600055 *1,BIELETA DIRECCION SIN TEMINAL SUSPENSION DELANTERA (L/R) SPRINTER W906 CRAFTER 2006 A 2016 (FREY),1459,4,3,2,9
9064600096 *1,"Juego de fuelles, volante para Mercedes-Benz FREY",1423,7,2,5,14
9064600148,TERMINAL DIRECCION SIN BIELETA SUSPENSION DELANTERA (L/R) MERCEDEZ BENZ W906 (DELPHI),1545,1,3,1,5
9064600444 *1,KIT JUNTAS DIRECCION MERCEDES SPRINTER W906 (FREY),1507,0,8,3,11
9064600800 *1,CAJA DIRECCION HIDRAULICA CREMALLERA SPRINTER W906 CRAFTER 2006 A 2016 (FREY),1528,0,7,7,14
9064620001 *1,EJE DIRECCION INFERIOR MERCEDES SPRINTER W906 (FREY),1480,5,3,1,9
9064660201 *1,BOMBA DIRECCION HIDRAULICA SPRINTER W906 CRAFTER 2006 A 2016 (FREY),1745,0,5,6,11
9065000102 *1,RADIADOR ENFRIAMIENTO MOTOR TRANSMISION STANDAR SPRINTER W906 CRAFTER 2006 A 2016 (FREY),1451,7,1,0,8
9065000302 *1,RADIADOR ENFRIAMIENTO MOTOR TRANSMISION AUTOMATICA Y STANDAR SPRINTER W906 OM646 OM651 (FREY),1200,0,8,9,17
9065000393 *1,MOTOVENTILADOR ENFRIAMIENTO SITEMA A/C 310 WATTS (L) SPRINTER W906 CRAFTER 2006 A 2016 (FREY),1563,4,0,0,4
9065000493 *1,NUEVO VENTILADOR DE CONDENSADOR A/C SE AJUSTA A MERCEDES BENZ (FREY),1729,5,3,8,16
9065010015 *1,TAPON DEPOSITO ANTICONGELANTE SPRINTER W906 VIANO W639 VITO (FREY),1707,9,1,4,14
9065010182 *1,MANGUERA SUPERIOR RADIADOR ENFRIAMIENTO MOTOR SPRINTER W906 OM651 (FREY),1550,4,8,2,14
9065010201 *1,INTERCOOLER ENFRIADOR TURBO CARGADOR SPRINTER W906 OM651 OM646 CRAFTER 2006 A 2016 (FREY),1739,1,1,5,7
9065010503 *1,DEPOSITO ANTICONGELANTE ENFRIAMIENTO MOTOR SPRINTER W906 OM651 (FREY),1263,5,4,8,17
9065010682 *1,MANGUERA SUPERIOR RADIADOR A DEPOSITO ANTICONGELANTE SPRINTER W906 (FREY),1690,7,7,5,19
9065010782 *1,MANGUERA DEPOSITO ANTICONGELANTE A RADIADOR SPRINTER W906 (FREY),1553,1,6,4,11
9065011482 *1,MANGUERA INFERIOR RADIADOR ENFRIAMIENTO MOTOR SPRINTER W906 OM651 (FREY),1875,9,2,2,13
9065012482 *1,MANGUERA INFERIOR RADIADOR ENFRIAMIENTO MOTOR SPRINTER W906 OM646 (FREY),1400,0,7,2,9
9065012982 *1,Manguera De Radiador Superior FREY,1497,6,3,7,16
9065030001 *1,REJILLA CUBIERTA ASPAS MOTOVENTILADOR CLIMA A/C (L/R) SPRINTER W906 (FREY),1568,4,0,9,13
9065050555 *1,MARCO MOTOVENTILADORES SPRINTER W906 OM651 OM646 (FREY),1567,1,8,6,15
9065280024 *1,MANGUERA DUCTO DE CARROCERIA A FILTRO ENTRADA AIRE MOTOR (FREY),1588,8,3,6,17
9065280382 *1,MANGUERA AIRE TURBO INTERCOOLER (R) 385 MM SPRINTER W906 OM642 OM646 (FREY),1735,8,8,5,21
9065282282 *1,MANGUERA INTERCOOLER (L) MERCEDES SPRINTER W906 (FREY),1457,0,1,6,7
9065282682 *1,MANGUERA AIRE TURBO INTERCOOLER (R) 250 MM SPRINTER W906 OM642 OM646 (FREY),1331,0,2,3,5
9065283282 *1,MANGUERA AIRE TURBO INTERCOOLER (R) SPRINTER W906 (FREY),1316,9,4,7,20
9065283782 *1,MANGUERA AIRE TURBO INTERCOOLER (L) 320 MM SPRINTER W906 OM642 646 651 654 (FREY),1447,7,0,4,11
9065283782B,KIT 4 PZ 2 SELLOS 2 SEGUROS MANGUERA TURBO INTERCOOLER (L) SPRINTER W906 OM646 OM651 OM654 (FREY),1510,2,3,6,11
9065285082 *1,MANGUERA AIRE TURBO INTERCOOLER (R) 420 MM SPRINTER OM651 (FREY),1843,5,3,4,12
9065285082B,KIT 4 PZ 2 SELLOS 2 SEGUROS MANGUERA TURBO INTERCOOLER (R ) SPRINTER OM654 (FREY),1564,6,1,9,16
9065400217 *1,SENSOR FRENOS ABS RUEDA TRASERA (R) SPRINTER W906 CRAFTER 2006 A 2016 (FREY),1488,9,0,8,17
9065400317 *1,Sensor de Velocidad ABS genuino para Mercedes-Benz FREY,1383,0,2,8,10
9065401217-100,SENSOR FRENOS ABS TRASERO (R) SPRINTER W906 CRAFTER INACTIVO,1803,0,6,9,15
9065401317 *1,SENSOR BALATAS FRENOS TRASERO (L/R) SPRINTER W906 (FREY),1651,9,6,8,23
9065401417 *1,SENSOR FRENOS ABS DELANTERO MERCEDES SPRINTER (FREY),1409,9,7,9,25
9065450010 *1,Conmutador de columna de direcciï¿½n para Mercedes-Benz FREY,1656,1,4,0,5
9065450310 *1,interruptor intermitente FREY,1668,0,7,7,14
9065451013 *1,CONTROL ELECTRICO PRINCIPAL CRISTALES (L) SPRINTER W906 CRAFTER (FREY),1887,4,2,6,12
9065451213 *1,CONTROL ELECTRICO PRINCIPAL CRISTALES ESPEJOS (L) SPRINTER W906 CRAFTER (FREY),1977,5,6,7,18
9065451913 *1,CONTROL ELECTRICO VENTANILLA DELANTERA (R) SPRINTER W906 CRAFTER 2006 A 2016 (FREY),1906,2,0,2,4
9067200046 *1,ELEVADOR CRISTAL VENTANILLA DELANTERA (L) SPRINTER W906 CRAFTER 2006 A 2016 (FREY),1555,4,0,5,9
9067200146 *1,ELEVADOR CRISTAL VENTANILLA PUERTA DELANTERA (R) SPRINTER W906 CRAFTER 2006 A 2016 (FREY),1984,6,9,1,16
9067201735 *1,CERRADURA CHAPA ACTUADOR ELECTRICO DELANTERO ( R) SPRINTER W906 (FREY),1919,0,8,5,13
9067202135 *1,ACTUADOR PUERTA DELANTERA (L) SPRINTER W906 (FREY),1867,2,6,3,11
9067400032 *1,CERRADURA PUERTA TRASERA SPRINTER W906 (FREY),1520,3,4,2,9
9067400035 *1 ,CHAPA CERRADURA CAJUELA TRASERA (L/R) SPRINTER W906 CRAFTER 2006 A 2016 (FREY),1907,2,2,4,8
9067500002 *1,COFRE MOTOR SRINTER W906 (FREY),1950,9,1,6,16
9067500021 *1,BISAGRA COFRE (L) SPRINTER W906 VW CRAFTER 2006 A 2016 (FREY),1348,5,1,6,12
9067500121 *1,BISAGRA COFRE MOTOR (R) SPRNTER W906 (FREY),1213,1,8,9,18
9067500450 *1,CERRADURA CHAPA COFRE SPRINTER W906 CRAFTER 2006 A 2016 (FREY),1418,0,2,2,4
9067600020 *1,MANIJA EXTERNA CUBIERTA CHAPA PUERTA DELANTERA (L) SPRINTER W906 CRAFTER 2006 A 2016 (FREY),1799,1,2,2,5
9067600061 *1,MANIJA INTERNA PUERTA TRASERA (L/R) SPRINTER W906 CRAFTER 2006 A 2016 (FREY),1913,0,1,4,5
9067600070 *1,MANIJA INTERNA SIN CHAPA PUERTA DELANTERA (L/R) SPRINTER W906 CRAFTER 2006 A 2016 (FREY),1682,7,8,5,20
9067600147 *1 ,CARRETILLA RODILLO PUERTA CORREDIZA TRASERA SUPERIOR (R ) SPRINTER W906 CRAFTER 2006 A 2016 (FREY),1793,3,4,9,16
9067600161 *1,MANIJA INTERNA PUERTA DELANTERA (L) SPRINTER W906 CRAFTER 2006 A 2016 (FREY),1602,8,7,2,17
9067600170 *1,MANIJA EXTERNA PUERTA TRASERA (L/R) SPRINTER W906 CRAFTER 2006 A 2016 (FREY),1845,8,7,7,22
9067600261 *1,Maneta interior delantera derecha MERCEDES FREY,1706,8,6,5,19
9067600347 *1,CARRETILLA RODILLO PUERTA CORREDIZA CENTRAL (R) SPRINTER W906 CRAFTER 2006 A 2016 (FREY),1361,8,8,8,24
9068104846 *1,ESPEJO RETROVISOR LATERAL (L) MERCEDES SPRINTER W906 (FREY),1675,7,0,7,14
9068104946 *1,ESPEJO RETROVISOR LATERAL (R) MERCEDES SPRINTER W906 (FREY),1590,8,0,4,12
9068106016 *1,ESPEJO RETROVISOR ELECTRICO LATERAL (L) BRAZO CORTO SPRINTER W906 CRAFTER 2006 A 2016 (FREY),1636,3,6,2,11
9068106116 *1,ESPEJO RETROVISOR ELECTRICO LATERAL (R) BRAZO CORTO SPRINTER W906 CRAFTER 2006 A 2016 (FREY),1929,9,8,1,18
9068172314 *1,EMBLEMA INSIGNIA TRASERA SPRINTER W906 (FREY),1319,7,1,9,17
9068200161 *1,FARO LUZ DELANTERO (L) SPRINTER W906 (FREY),1212,0,0,3,3
9068200164 *1,CALAVERA LUZ TRASERA (L) SPRINTER W906 (FREY),1417,4,0,4,8
9068200261 *1,FARO LUZ DELANTERO (R) SPRINTER W906 (FREY),1857,3,9,6,18
9068200264 *1,CALAVERA LUZ TRASERA (R) SPRINTER W906 (FREY),1378,4,3,3,10
9068200269-100,MECANISMO PUERTA CORREDIZA 40 ESLABONES (R) SPRINTER W906 CRAFTER 2007 A 2017 INACTIVO,1528,9,9,4,22
9068200475 *1,ANTENA SEï¿½AL RADIO SPRINTER W906 VW CRAFTER 2006 A 2016 (FREY),1863,2,0,6,8
9068200644 *1,LIMPIAPARABRISAS MERCEDES BENZ FREY,1309,6,3,8,17
9068200801 *1,LAMPARA INTERIOR LUZ CORTESIA SPRINTER W906 (FREY),1438,3,4,2,9
9068202361 *1,FARO LUZ DELANTERO (L) SPRINTER W906 CRAFTER 2006 A 2016 (FREY),1763,0,7,6,13
9068202461 *1,FARO LUZ DELANTERO (R) SPRINTER W906 CRAFTER 2006 A 2016 (FREY),1650,4,8,5,17
9068203769-100,Cable de puerta corredera Mercedes Sprinter Inferior Parte de abajo INACTIVO,1763,0,6,0,6
9068204169 *1,MECANISMO PUERTA CORREDISA 79.5 MM LARGO (R) SPRINTER W906 CRAFTER 2006 A 2016 (FREY),1530,1,9,9,19
9068260040 *1,REFLEJANTE ROJO FACIA TRASERA (L)  SPRINTER W906 (FREY),1516,9,4,0,13
9068260140 *1,REFLEJANTE ROJO FACIA TRASERA (R )  SPRINTER W906 (FREY),1856,9,0,3,12
9068300318 *1,FILTRO POLEN AIRE CABINA CON CARBON ACTIVO SPRINTER W906 CRAFTER 2006 A 2016 (FREY),1843,1,8,7,16
9068300318 *3,FILTRO POLEN AIRE CABINA MERCEDES BENZ SPRINTER (MAHLE LAK307),1960,0,0,2,2
9068360618 *1,VENTILA PARRILLA SUPERIOR COFRE DELANTERO MOTOR (L) SPRINTER W906 (FREY),1226,4,1,4,9
9068360718 *1,VENTILA PARRILLA SUPERIOR COFRE DELANTERO MOTOR (R) SPRINTER W906 (FREY),1713,7,5,6,18
9068690072 *1,TAPA DEPOSITO LIQUIDO LIMPIA PARABRISAS SPRINTER W906 CRFATER (FREY),1579,2,0,1,3
9068690220 *1,DEPOSITO DE LIMPIAPARABRISAS MERCEDES SPRINTER (FREY),1881,8,8,9,25
9068800059 *1,CHICOTE LIBERARDOR DE COFRE SPRINTER W906 CRAFTER 2006 A 2016 (FREY),1444,5,9,4,18
9068800203 *1,MARCO PARRILLA RADIADOR DELANTERO SPRINTER W906 (FREY),1704,6,1,1,8
9068800385 *1,PARRILLA COFRE DELANTERO COLOR NEGRO CON CROMO SPRINTER W906 (FREY),1280,3,8,9,20
9068800403 *1,SOPORTE RADIADOR MERCEDES SPRINTER W906 (FREY),1952,5,2,3,10
9068800785 *1,PARRILLA COFRE DELANTERO COLOR NEGRO SIN MOLDURA CROMADA SPRINTER W906 (FREY),1926,7,8,1,16
9068801171 *1,ESQUINA FASIA DEFENSA TRASERA (R) SPRINTER W906 (FREY),1951,8,6,3,17
9068810101 *1,SALPICADERA CARROCERIA DELANTERA (L) SPRINTER W906 (FREY),1889,9,6,5,20
9068810201 *1,SALPICADERA CARROCERIA DELANTERA (R) SPRINTER W906 (FREY),1281,0,1,3,4
9069001200 *1,MODULO CONTROL ESTACIONAMIENTO SPRINTER W906 CRAFTER 2006 A 2016 (FREY),1795,6,6,3,15
9069050701 *1,SENSOR FRENOS ABS RUEDA DELANTERA (L/R) SPRINTER W906 CRAFTER 2006 A 2016 (FREY),1680,7,2,7,16
9069051001 *1,SENSOR FRENOS ABS RUEDA TRASERA (L) MERCEDES W906 SPRINTER (FREY),1410,2,8,1,11
9073205701 *1,AMORTIGUADOR SUSPENSION DELANTERA (L/R) SPRINTER W907 (FREY),1984,3,5,4,12
9074212100 *1,CALIPER MORDAZA PASTILLAS FRENOS DELANTEROS (L/R) SPRINTER W907 W910 (FREY),1231,3,3,6,12
9077604000 *1,GUIA RODILLO PUERTA CORREDIZA INFERIOR (L) SPRINTER W910 (FREY),1555,2,1,8,11
9079050504 *1,BOTON DE CRISTALES SPRINTER W907 W910 (FREY),1721,1,5,5,11
90906288,JUNTA DE TAPA DE PUNTERIAS ( L-R ) BMW F10-N63 ELRING,1333,1,9,6,16
9103203000 *1,TORNILLO BARRA ESTABILIZADORA SUSPENSION DELANTERA (L) MERCEDES W907 (FREY),1896,9,1,5,15
9103203100 *1,TORNILLO BARRA ESTABILIZADORA SUSPENSION DELANTERA (R) MERCEDES W907 (FREY),1224,3,7,6,16
9103261200 *1,BIELETA DIRECCION SIN TERMINAL SUSPENSION TRASERA (L/R) SPRINTER W910 (FREY),1341,2,1,6,9
9105010400 *1,DEPOSITO ANTICONGELANTE ENFRIAMIENTO MOTOR SPRINTER W910 (FREY),1710,5,0,2,7
9107603600 *1,MANIJA EXTERIOR DE PUERTA TRASERA (L/R) SPRINTER W910 (FREY),1701,0,2,0,2
9107603700 *1,MANIJA EXTERIOR DE PUERTA DELANTERA (L/R) SPRINTER W910 (FREY),1526,2,9,3,14
9107603900 *1,MANIJA EXTERIOR PUERTA TRASERA (L/R) SPRINTER W910 (FREY),1357,3,3,4,10
9107604000 *1,MANIJA EXTERIOR PUERTA DELANTERA (L/R) SPRINTER W910 (FREY),1425,2,0,2,4
9107605600 *1,GUIA RODILLO PUERTA CORREDIZA SUPERIOR (L) SPRINTER W910 (FREY),1844,2,4,2,8
9107630000 *1,GUIA RODILLO CENTRAL PUERTA CORREDIZA (L) SPRINTER W910 (FREY),1357,3,1,0,4
9108100300 *1,ESPEJO RETROVISOR ELECTRICO LATERAL (L) BRAZO CORTO SPRINTER W910 (FREY),1737,1,6,2,9
9108100400 *1,ESPEJO RETROVISOR ELECTRICO LATERAL (R) BRAZO CORTO SPRINTER W910 (FREY),1646,2,7,9,18
9108112400 *1,LUNA ESPEJO RETROVISOR (R) SPRINTER W910 (FREY),1622,5,2,8,15
9108112500 *1,LUNA ESPEJO RETROVISOR (L) SPRINTER W910 (FREY),1701,8,1,5,14
9108112600 *1,LUNA ESPEJO RETROVISOR BRAZO CORTO (R) SPRINTER W910 (FREY),1409,7,6,4,17
9108112700 *1,LUNA ESPEJO RETROVISOR BRAZO CORTO (L) SPRINTER W910 (FREY),1535,7,2,1,10
9108113800 *1,MARCO CARCASA EXTERIOR ESPEJO RETROVISOR ELECTRICO LATERAL (R) SPRINTER W910 (FREY),1798,7,1,0,8
9108113900 *1,MARCO CARCASA EXTERIOR ESPEJO RETROVISOR ELECTRICO LATERAL (L) SPRINTER W910 (FREY),1805,0,5,4,9
9108114000 *1,CUBIERTA EXTERIOR ESPEJO RETROVISOR ELECTRICO LATERAL (R) SPRINTER W910 (FREY),1963,3,7,1,11
9108114100 *1,CUBIERTA EXTERIOR ESPEJO RETROVISOR ELECTRICO LATERAL (L) SPRINTER W910 (FREY),1611,5,2,0,7
9108200200 *1,CALAVERA LUZ TRASERA (L) SPRINTER W907 (FREY),1325,1,1,9,11
9108200300 *1,CALAVERA LUZ TRASERA (R) SPRINTER W907 (FREY),1410,7,4,5,16
9108205200 *1,CALAVERA LUZ TRASERA (L) SPRINTER W910 (FREY),1412,1,0,4,5
9108205300 *1,CALAVERA LUZ TRASERA (R) SPRINTER W910 (FREY),1715,8,2,1,11
9108206800 *1,PLACA CIRCUITO LUCES (L) CALAVERA TRACERA SPRINTER W907 (FREY),1493,0,0,5,5
9108206900 *1,PLACA CIRCUITO LUCES (R) CALAVERA TRACERA SPRINTER W907 (FREY),1518,3,3,3,9
9108810000 *1,PANEL GUARDABARROS DELANTERO (L ) SPRINTER W907 (FREY),1844,1,1,3,5
9108810100 *1,PANEL GUARDABARROS DELANTERO (R ) SPRINTER W907 (FREY),1592,9,5,9,23
9108852700B,PARRILLA DELANTERA COFRE SPRINTER W910 (FREY),1998,5,6,2,13
9108880000 *1,MOLDURA INFERIOR DEFENSA DELANTERA SPRINTER W910 (FREY),1431,7,8,9,24
9110702400 *3,FILTRO ACEITE MOTOR PORSCHE MAHLE OX366D,1686,3,6,7,16
91111018502 *3,FILTRO ENTRADA AIRE MOTOR PORSHE 911 3.6 L (MAHLE LX582/1),1468,2,2,8,12
91135299800 *5,KIT REPARACION PINZA FRENO TRASERO PORSCHE 911 (FTE),1803,0,0,5,5
9186262 *3,FILTRO ENTRADA AIRE MOTOR VOLVO C701 (MAHLE LX726),1818,1,4,7,12
9186361 *3,FILTRO ENTRADA AIRE MOTOR VOLVO S80 1a GEN T6 (MAHLE LX637),1863,1,6,3,10
927601,FILTRO COMBUSTIBLE GASOLINA MERCEDES W123-M116 BOSCH F5007,1528,7,0,8,15
93186324,ENFRIADOR DE ACEITE DE MOTOR CHEVROLET MOTOR ECOTEC,1610,3,1,7,11
9404725 *5,JUNTA CABEZA MOTOR MEDIDA STANDAR 1.5 MM VOLVO S40 V40 1.9 L 4 CIL (VICTOR REINZ) SSF,1227,5,7,4,16
9440651 *5,RETEN ARBOL LEVAS DELANTERO 45X65 MM (L/R) VOLVO C70 S40 S60 S70 S80 V40 V50 V70 XC70 (CORTECO) SSF,1701,9,0,7,16
9443787 *5,1 PZ. SELLO VALVULA ADMISION 6 MM VOLVO 2.5 2.9 C30 C70 S40 S60 S80 V40 V50 V70 XC60 XC70 XC90 (ELRING) SSF,1215,3,7,7,17
9443787 *6,1 PZ SELLO VALVULA ADMISION 6 MM VOLVO 2.5 2.9 C30 C70 S40 S60 S80 V40 V50 V70 XC60 XC70 XC90 (CORTECO) SSF,1982,6,8,3,17
9443787 *7,1 PZ SELLO VALVULA ADMISION 6 MM VOLVO 2.5 2.9 C30 C70 S40 S60 S80 V40 V50 V70 XC60 XC70 XC90 (OEM) SSF,1511,1,7,8,16
94451135101,AMORTIGUADOR COFRE FUERZA 270 NEWTONS 405 MM PORSCHE 924-TM STABILUS,1872,8,5,1,14
9445462,TAPON DE DEPOSITO DE ANTICONGELANTE VOLVO S40 1a GEN VERNET RC0033,1549,8,2,3,13
9445462 *5,TAPON DEPOSITO ANTICONGELANTE ENFRIAMIENTO MOTOR 154 KPA VOLVO (FEBI) SSF,1768,7,1,1,9
9445462-2,TAPON DE DEPOSITO DE ANTICONGELANTE VOLVO S40 1a GEN URO,1261,6,6,3,15
94457769-1,FILTRO ENTRADA AIRE MOTOR VOLVO C701 MANN C35148,1752,6,3,1,10
9454607 *5,VALVULA ADMISION CABEZA MOTOR 6 MM VOLVO C30 C70 S4O S60 S70 S80 V40 V50 V60 V70 XC60 XC70 XC90 (EA) SSF,1391,1,9,9,19
9454607 *6,VALVULA ADMISION CABEZA MOTOR 6 MM VOLVO C30 C70 S4O S60 S70 S80 V40 V50 V60 V70 XC60 XC70 XC90 (CRP) SSF,1802,5,6,3,14
9454610 *5,VALVULA ESCAPE CABEZA MOTOR 6 MM VOLVO C30 C70 S4O S60 S70 S80 V40 V50 V60 V70 XC60 XC70 XC90 (PRO PARTS) SSF,1684,3,4,1,8
9454647,FILTRO ENTRADA AIRE MOTOR VOLVO S60 2.0 2.4  LTS MANN C30189,1515,1,4,1,6
9454647 *3,FILTRO ENTRADA AIRE MOTOR VOLVO S60 2.0 2.4  LTS (MAHLE LX700),1725,4,6,1,11
9458178,RETEN TRASERO DE CIGUEï¿½AL VOLVO C30/ CX90/ S40 /S60 /S70 / V40 ( ELRING ),1623,0,5,5,10
9458309,RETEN DELANTERO DE ARBOL DE LEVAS ADM.Y ESC. VOLVO C30/ S40 / S60 / S70 ( VICTOR REINZ ),1278,0,6,1,7
94810240323,POLEA TENSORA PORSCHE CAYENNE ( FEBEST ),1831,8,2,2,12
94810417106,JUNTA CABEZA MOTOR (R) MEDIDA STANDAR 0.60 MM PORSCHE CAYENNE 4.5L V8 ELRING,1865,9,8,4,21
94810417205,JUNTA CABEZA MOTOR (L) MEDIDA STANDAR 0.60 MM PORSCHE CAYENNE 4.5L V8 (ELRING),1501,7,9,6,22
94810593103,JUNTA DE TAPA DE PUNTERIAS R PORSCHE CAYENNE 4.5 LITROS  ELRING,1738,4,0,9,13
94810593205,JUNTA DE TAPA DE PUNTERIAS L PORSCHE CAYENNE ELRING,1584,5,5,4,14
94810593300,JUNTA DE BUJIA PORSCHE CAYENNE MAHLE,1928,4,1,1,6
94810593400,JUNTA DE GOMA CENTRAL PARA TAPA DE PUNTERIAS PORSCHE CAYENNE URO,1397,5,3,3,11
94810601104,BOMBA AGUA MECANICA ENFRIAMIENTO MOTOR PORSCHE CAYENNE (GRAF),1892,9,7,3,19
94810603301 *2,BOMBA AGUA ENFRIAMIENTO MOTOR PORSCHE CAYENNE PANAMERA 2008 A 2018 (EMBLER),1710,8,6,6,20
94810605001ï¿½,MANGUERA DE AGUA PORSCHE CAYENNE ORIGINAL,1603,7,4,6,17
94810605906,TUBO CALENTADOR URO PARTS,1705,3,6,8,17
94810722200-2,FILTRO ACEITE MOTOR PORSCHE CAYENNE 4.8 LTS MANN HU926X,1303,4,1,2,7
94810727103,ENFRIADOR DE ACEITE DE MOTOR PORSCHE CAYENNE 4.8L TAIFA,1948,6,4,4,14
94810727603,ENFRIADOR DE ACEITE DE MOTOR PORSCHE CAYENNE 4.5L TAIFA,1975,3,9,4,16
94811031502,BOMBA DE GASOLINA DE ALTA PRESION PORSCHE CAYENNE E2 PANAMERA G1,1643,4,7,4,15
94860210410 *5,BOBINA ENCENDIDO IGNICION MOTOR PORSCHE CAYENNE PANAMERA (BOSCH) SSF,1520,1,4,0,5
94860210414-1,BOBINA DE IGNICION PORSCHE CAYENNE GENUINA,1494,0,4,9,13
9487146,SENSOR DE OXIGEN TRASERO VOLVO S40 ( BOSCH ),1952,0,8,2,10
95510229900,TENSOR DE BANDA DE ACCESORIOS CON POLEA PORSCHE CAYENNE ( INA ),1626,1,2,6,9
95510293300,BANDA ACCESORIOS MOTOR MEDIDA 7DK 2074 MM PORSCHE CAYENNE (MITSUBOSHI) SSF,1230,0,7,7,14
95510614723,DEPOSITO DE ANTICONGELANTE PORSCHE CAYENNE BEHR,1846,7,8,6,21
95510614723-1,DEPOSITO DE ANTICONGELANTE PORSCHE CAYENNE REIN,1368,4,8,4,16
95510614723-2,DEPOSITO DE ANTICONGELANTE PORSCHE CAYENNE TOPRAN,1375,7,9,4,20
95511031600 *5,BOMBA DE GASOLINA DE ALTA PRESION VW TOUAREG 3.6L (HITACHI) SSF,1666,2,7,3,12
95532124302,RETEN DE TURBINA DE TRANSMISION AUTOMATICA PORSCHE CAYENNE ( VICTOR REINZ ),1455,1,7,3,11
95534124262,BUJE DE HORQUILLA INFERIOR DELANTERA TRASERO PORSCHE CAYENNE LEMFOERDER,1235,4,6,1,11
95534158810,BUJE DE HORQUILLA INFERIOR DELANTERA DELANTERO PORSCHE CAYENNE LEMFOERDER,1456,3,3,6,12
95534324301-1,BUJE DE HORQUILLA INFERIOR DELANTERA EXTERIOR PORSCHE CAYENNE EMBLER,1403,2,2,6,10
95534703122,BIELETA DIRECCION CON TERMINAL SUSPENSION DELANTERA (L) PORSCHE CAYENNE (FEBI),1577,1,1,6,8
95534703122-1,BIELETA DIRECCION CON TERMINAL SUSPENSION DELANTERA (L) PORSCHE CAYENNE (LEMFORDER),1704,1,2,2,5
95534703222,BIELETA DIRECCION CON TERMINAL SUSPENSION DELANTERA (R) PORSCHE CAYENNE (FEBI),1309,9,8,8,25
95535193900 *3,BALATAS FRENOS TRW GDB1946 TRW (GDB1547),1734,2,7,0,9
95535193952 *3,BALATAS FRENOS DELANTEROS PORSCHE CAYENNE (TRW GDB1764),1541,7,2,7,16
95535293904,BALATAS FRENOS TRASEROS 73X117 MM CAYENNE Q7 TOUAREG 1a GEN TEXTAR,1903,6,2,8,16
95535890104 *C,COMPRESOR AIRE SUSPENSION VW TOUAREG PORSCHE CAYENNE (EMBLER) TECH,1237,9,5,8,22
95551255006-1,MUELLE DE RETORNO PORSCHE CAYENNE,1461,7,2,4,13
95552860701 *2,TAPA DEPOSITO AGUA LIMPIAPARABRISAS CAYENNE (EMBLER) GOG,1638,7,6,5,18
95557221910 *3,FILTRO ENTRADA AIRE MOTOR PORSCHE CAYENNE CARBON ACTIVADO (MAHLE LAK182),1894,0,3,7,10
95560410700,MARCHA PARA TOUAREG,1844,8,1,5,14
95581963100 *3,FILTRO POLEN AIRE CABINA VW TOUAREG (MAHLE LA182),1600,0,9,7,16
95810603304,BOMBA AGUA MECANICA ENFRIAMIENTO MOTOR CON POLEA CAYENNE (URO),1851,1,2,6,9
95810722210 *3,FILTRO ACEITE MOTOR PORSCHE CAYENNE (MAHLE OX983D),1296,9,1,2,12
95811013000 *3,FILTRO ENTRADA AIRE MOTOR PORSCHE CAYENNE (MAHLE LX2024),1559,8,5,5,18
95811013010 *3,FILTRO ENTRADA AIRE MOTOR CAYENNE 3.6L 4.8L 2 2011 A 2018 PORSCHE  VW (MAHLE LX2024/1)  DGO,1230,3,5,2,10
95835193930 *3,BALATAS FRENOS DELANTEROS 209X94 MM PORSCHE CAYENNE (BREMBO P65026N),1726,3,8,3,14
95835293900-9,BALATAS FRENOS TRASEROS PORSCHE CAYENNE TEXTAR,1814,6,2,0,8
95835890102 *C,COMPRESOR AIRE SUSPENSION Q7 TOUAREG CAYENNE MACAN (EMBLER) TECH,1844,7,6,6,19
95835890102-100,COMPRESOR DE AIRE SUSPENSION  TOUARE CAYENNE INACTIVO,1723,7,8,6,21
95857221900 *3,FILTRO ENTRADA AIRE MOTOR PORSCHE (MAHLE LAK855),1707,7,9,4,20
95861236500,SENSOR BALATAS FRENOS DELANTERO (L/R) VW TOUAREG VAICO,1270,7,3,4,14
95B616001A *B,BOLSA AIRE SUSPENSION TRASERA (L) PORSCHE MACAN 2014 A 2019 (EMBLER) TECH,1905,2,1,2,5
95B616002A *B,BOLSA AIRE SUSPENSION TRASERA (R) PORSCHE MACAN 2014 A 2019 (EMBLER) TECH,1224,1,5,2,8
95B907253A *5,SENSOR BALATAS FRENOS DELANTEROS (L/R) 295 MM PORSCHE MACAN (FEBI) SSF,1213,9,7,5,21
9644860880ï¿½,ELECTROBOMBA DE DIRECCION HIDRAULICA PEUGEOT 307 ( BMTR ),1658,4,0,8,12
9653204180-100,BANDA ACCESORIOS MOTOR 6PK998 BMW N20 N26 (FREY) INACTIVO,1513,8,5,9,22
97,"CUBIERTA PARA PARRILLA """"M"""" BMW F30",1331,9,6,3,18
97011022001 *3,FILTRO ENTRADA AIRE MOTOR POSCHE PANAMERA (MAHLE LX3772),1911,0,0,6,6
97034305115 *A,AMORTIGUADOR AIRE CON SENSOR SUSPENSION DELANTERA (L) PORSCHE PANAMERA 2009 A 2012 (EMBLER) TECH,1326,5,0,8,13
97034305115 *B,BOLSA AIRE CON SENSOR SUSPENSION DELANTERA (L) PORSCHE PANAMERA 2010 A 2016 (EMBLER) TECH,1468,5,3,2,10
97034305134 *A,AMORTIGUADOR AIRE SIN SENSOR SUSPENSION DELANTERA (L) PORSCHE PANAMERA 2013 A 2017 (EMBLER) TECH,1639,2,5,7,14
97034305134 *B,BOLSA AIRE SIN SENSOR SUSPENSION DELANTERA (L) PORSCHE PANAMERA (EMBLER) TECH,1736,9,1,9,19
97034305214 *A,AMORTIGUADOR AIRE CON SENSOR SUSPENSION DELANTERA (R) PORSCHE PANAMERA (EMBLER) TECH,1209,4,5,6,15
97034305214 *B,BOLSA AIRE CON SENSOR SUSPENSION DELANTERA (R) PORSCHE PANAMERA 2010 A 2016 (EMBLER) TECH,1722,2,8,0,10
97034305234 *A,AMORTIGUADOR AIRE SIN SENSOR SUSPENSION DELANTERA (R) PORSCHE PANAMERA 2010 A 2016 (EMBLER) TECH,1770,0,6,0,6
97034305234 *B,BOLSA AIRE SIN SENSOR SUSPENSION DELANTERA (R) PORSCHE PANAMERA 2010 A 2016 (EMBLER) TECH,1390,4,0,4,8
971616037G *A,AMORTIGUADOR AIRE SUSPENSION DELANTERA (L)  PANAMERA 2017-2022 (EMBLER) TECH,1760,8,5,4,17
971616038G *A,AMORTIGUADOR AIRE SUSPENSION DELANTERA (R)  PANAMERA 2017-2022 (EMBLER) TECH,1783,7,3,3,13
98635193915 *5,BALATAS FRENOS DELANTEROS 114.2 X 78.0 MM PORSCHE BOXSTER 1997 A 2004 (FERODO) SSF,1869,5,5,5,15
98635193915 *6,BALATAS FRENOS DELANTEROS 114.2 X 78.0 MM PORSCHE BOXSTER 1997 A 2004 (ATE) SSF,1726,6,4,3,13
98635293910 *6,BALATAS FRENOS TRASEROS 112.0 X 73.0 MM PORSCHE BOXSTER CARRERA TARGA CAYMAN 911 (ATE) SSF,1216,9,5,0,14
98661236500,SENSOR BALATAS FRENOS TRASERO (L/R) PORSCHE BOXSTER (SEBRO),1796,9,3,2,14
98661236501 *5,SENSOR BALATAS FRENOS TRASERO (L/R) PORSCHE BOXER 1997 A 2012 CAYMAN 2007 A 2012 (SEBRON) SSF,1289,2,3,6,11
98711013301 *3,FILTRO ENTRADA AIRE MOTOR PORSCHE BOXSTER (MAHLE LX1009/6),1226,0,6,4,10
98735293901,PASTILLAS DE FRENO FERODO,1726,0,7,5,12
98735293903 *3,BALATAS TRASERAS PORSCHE BOXTER CAYMAN (TRW GDB1961),1287,4,9,5,18
99310720305 *3,FILTRO ACEITE MOTOR PORSCHE 911 (MAHLE OC229),1426,9,1,9,19
99311032700,FILTRO ENTRADA AIRE MOTOR PORSCHE 911 TURBO 93-97 MANN C33106,1474,6,8,4,18
99311032701 *3,FILTRO ENTRADA AIRE MOTOR PORSCHE 911 TURBO 93-97 (MAHLE LX459),1629,9,5,2,16
99320720103 *3,FILTRO ACEITE MOTOR PORSCHE 911 (MAHLE OC213),1939,6,6,3,15
99610511552,SELLO DE VALVULAS PORSCHE CAYENNE ( CORTECO ),1942,9,3,3,15
99610601153,BOMBA AGUA MECANICA ENFRIAMIENTO MOTOR PORSCHE BOXSTER (GENERICA),1853,1,5,4,10
99610702507,ENFRIADOR DE ACEITE DE MOTOR PORSCHE BOXSTER TAIFA,1870,1,7,3,11
99610722553 *5,FILTRO ACEITE MOTOR PORSCHE (MAHLE OX128/1D) SSF,1934,9,0,0,9
99611013103,FILTRO ENTRADA AIRE MOTOR PORSHE BOXTER-S 1999 MANN C2558/5,1733,6,8,0,14
99611013104 *3,FILTRO ENTRADA AIRE MOTOR PORSHE BOXTER-S 1999 (MAHLE LX566/1),1696,7,6,6,19
99611013151 *5,FILTRO ENTRADA AIRE MOTOR PORSHE 911 3.6 L (MANN) SSF,1974,5,5,1,11
99611013151 *6,FILTRO ENTRADA AIRE MOTOR PORSHE 911 3.6 L (HENGST) SSF,1454,2,0,1,3
99611013171 *3,FILTRO ENTRADA AIRE MOTOR PORSCHE CAYENNE (MAHLE LX696/1),1788,5,5,9,19
99611025301 *3,FILTRO COMBUSTIBLE GASOLINA PORSCHE (MAHLE KL80),1408,7,6,6,19
99651155101 *5,AMORTIGUADOR COFRE FUERZA 560 NEWTONS 225 MM PORSCHE 911 (STABILUS) SSF,1362,1,4,0,5
99651155101 *6,AMORTIGUADOR COFRE FUERZA 560 NEWTONS 225 MM PORSCHE 911 (URO) SSF,1952,4,5,0,9
99651155101-100,AMORTIGUADOR DE COFRE 560N PORSCHE 911 INACTIVO,1865,1,7,3,11
99661236500,SENSOR BALATAS FRENOS DELANTERO TRASERO (L/R) PORSCHE 911 / BOXSTER ( SEBRO ),1933,6,8,0,14
99710121201,RETEN DE CIGUEï¿½ALTRASERO 85 X 105 X 11  POSRCHE CAYENNE ( VICTOR REINZ ),1575,4,6,5,15
99711013032 *3,FILTRO ENTRADA AIRE MOTOR PORSCHE PANAMERA 911 (MAHLE LX2974),1893,4,6,1,11
99757121901 *3,FILTRO ENTRADA AIRE MOTOR PORSCHE (MAHLE LAK32/1),1773,8,6,8,22
99760210401,BOBINA DE IGNICION PORSCHE 911-BOXTER-CAYMAN 2001 A 2011 BREMI,1258,1,1,2,4
9985690,TAPON DE ACEITE PARA CABEZA DE MOTOR MERCEDES W203-M272 BAPMIC,1228,7,4,3,14
99970738940,JUNTA DE ENFRIADOR DE ACEITE PORSCHE 911 BOXSTER VICTOR REINZ,1389,7,6,9,22
99970740940,JUNTA DE ENFRIADOR DE ACEITE PORSCHE 911 BOXSTER VICTOR (REINZ),1917,9,4,0,13
9P1819631 *5,FILTRO POLEN AIRE CABINA PORSCHE 2012 A 2023 (HENGST) SSF,1274,2,3,6,11
9Y0616039B *A,AMORTIGUADOR DE AIRE DELANTERO (L) PORSCHE CAYENNE 2019,1769,8,7,6,21
9Y0616040B *A,AMORTIGUADOR DE AIRE DELANTERO (R) PORSCHE CAYENNE 2019 (EMBLER) TECH,1967,2,9,4,15
A00000002016,KIT DE SUSPENSION DELANTERA BMW E46,1315,3,2,7,12
A00000089,REPUESTO DE CHAPA BMW E53,1548,2,0,0,2
A0000089,REPUESTO DE CHAPA BMW E46 AFTERMARKET,1386,5,3,3,11
A00005356-100,4 SELLOS DE VALVULA ADMISION-ESCAPE MERCEDES INACTIVO,1879,8,6,0,14
A0000940548,SENSOR DE MASA DE AIRE MAF MERCEDES W124-M104 BMTR,1418,4,1,2,7
A0001501380-1,BOBINA DE ENCENDIDO ( UNIDAD ) MERCEDES W168-M166 TOPRAN,1370,1,2,6,9
A0003123V007,FILTRO ENTRADA AIRE MOTOR SMART FORTWO MANN C10361,1475,8,3,3,14
A0004600183,DEPOSITO DE ACEITE DE DIRECCION MERCEDES W163-M112 FEBI,1687,9,0,9,18
A0004600183-1,DEPOSITO DE ACEITE DE DIRECCION MERCEDES W163 / M112 ( REIN ),1397,5,7,5,17
A0004602683,DEPOSITO DE ACEITE DE DIRECCION MERCEDES X164-M273 LEMFOERDER,1229,9,0,7,16
A0004661880,SELLO DE DEPOSITO DE ACEITE DE DIRECCION MERCEDES W164 / M272 ( MEISTERSATZ ),1526,3,4,2,9
A0004661880-2,SELLO DE DEPOSITO DE ACEITE DE DIRECCION MERCEDES W164-M272 GENUINO,1726,5,4,1,10
A0004706394,BOMBA DE GASOLINA MERCEDES W202 C220-C230A-C230K-C280 BAMPIC,1480,3,6,2,11
A0004707894-1,BOMBA DE GASOLINA MERCEDES W220-M113 BOSCH,1504,1,5,5,11
A0004707894-100,BOMBA DE GASOLINA MERCEDES W220-M113 BMTR INACTIVO,1201,0,6,8,14
A000828038810,BATERIA PARA LLAVE MERCEDES VARTA 3.0 V CR2025,1672,0,5,7,12
A0009050242,SENSOR DE ESTACIONAMIENTO MERCEDES W204 ( BMTR,1351,0,7,5,12
A0009051202,SENSOR DE ESTACIONAMIENTO MERCEDES W212 ( BMTR ),1646,3,7,0,10
A0009057200,SENSOR DE PRESION DE LLANTAS MERCEDES W203 / TM ( BMTR ),1748,9,4,3,16
A0010940301-2,FILTRO ENTRADA AIRE MOTOR SMART FORTWO MANN C2716,1628,0,5,3,8
A0013307735,TERMINAL DIRECCION SIN BIELETA SUSPNSION DELANTERA (L/R) MERCEDES W202 ( KARLYN ),1842,2,8,0,10
A0015405117,SENSOR DE OXIGENO DELANTERO  MERCEDES W210 ( BMTR ),1433,3,9,6,18
A0015406017-1,SENSOR  DE OXIGENO MERCEDES W210 ( BOSCH ),1894,5,6,9,20
A0015427418,SENSOR DE ESTACIONAMIENTO MERCEDES W164 BMTR,1728,2,4,8,14
A0019938396,BANDA DE MOTOR MB W204 DAYCO 6PK2360,1854,6,5,4,15
A0025400617,SENSOR DE OXIGENO TRASERO MERCEDES W203 BMTR,1393,9,5,0,14
A0025401497,VALVULA SOLENOIDE AIRE MERCEDES BENZ E36 PIERBURG,1349,3,5,7,15
A0029935496,BANDA DE ALTERNADOR MERCEDES W204 C350 OPTIBELT 6PK2215,1234,3,5,9,17
A0030915301,BOMBA DE GASOLINA MERCEDES W124-L6 BOSCH,1603,8,7,5,20
A0030947104,FILTRO ENTRADA AIRE MOTOR MERCEDES BENZ W124 MANN C31144,1455,6,5,2,13
A0030948204 - AGN1ML,FILTRO ENTRADA AIRE MOTOR MERCEDES BENZ MANN  C32338,1907,1,1,5,7
A0031532828-1,SENSOR DE CIGUEï¿½AL MERCEDES W203-M111 BOSCH,1481,5,8,2,15
A0031532828-3,SENSOR DE CIGUEï¿½AL MERCEDES W203-M111 BREMI,1357,9,3,7,19
A0039970689-1,TOMA DE TUBO DE VENTILACION MERCEDES W203-M271 URO,1683,2,1,6,9
A0040941604,FILTRO ENTRADA AIRE MOTOR MERCEDES BENZ C208 CLK430 MANN C3479,1243,7,7,1,15
A0041536928-2,SENSOR DE ARBOL DE LEVAS MERCEDES W203 / M111 ( BREMI ),1930,0,6,2,8
A0041592603,BUJIA DE IGNICION BERU ULTRA MERCEDES W245 BERU,1988,8,8,3,19
A0041592603-1,BUJIA DE IGNICION MERCEDES W245 BOSCH,1213,9,3,8,20
A0045420818,SENSOR DE OXIGENO DELANTERO R-L MERCEDES W204-M272 BMTR,1623,1,0,8,9
A0051513901,MARCHA DE MOTOR DE ARRANQUE W203 ( BMTR ),1906,6,1,7,14
A0055411701,BATERIA PARA LLAVE DE IGNICION MERCEDES VARTA 1.55V V357,1988,6,0,3,9
A0055422617,SENSOR DE TEMPERATURA DE ANTICONGELADA MERCEDES W202 URO,1901,1,9,7,17
A0055422617-2,SENSOR DE TEMPERATURA DE ANTICONGELADA MERCEDES W202 OSSCA,1234,3,4,3,10
A0084201320-3,BALATA DE FRENOS TRASEROS MERCEDES W205-M274 BREMBO,1248,6,0,5,11
A008909100,LIMPIADOR DE CUERPO DE ACELERACION Y CARBURADORES WURTH,1939,8,2,1,11
A0119970292,BANDA DE ALTERNADOR MERCEDES MOTOR M111 CONTITECH 6KX1875,1411,7,7,1,15
A0119974792,BANDA ACCESOROS MOTOR MEDIDA 6PK 2415 MM MERCEDES W210 W124 CONTITECH,1427,1,0,9,10
A0119975892,BANDA DE SUPERCARGADOR MERCEDES MOTOR M111 CONTITECH 6KX1330,1867,3,5,5,13
A0179977447,RETEN DE CIGUEï¿½AL TRASERO MERCEDES W202-M111 ELRING,1978,3,8,9,20
A0258030023,SENSOR DE OXIGENO LAND ROVER RANGE ROVER SPORT GENUINO,1350,5,4,6,15
A0280750009,CUERPO DE ACELERACION AUDI A4 1.8L BOSCH GENUINO,1488,4,2,8,14
A053103663,EMBUDO BAYONETA AUDI A4 1.8L DORMAN ALEMAN,1292,2,9,9,20
A07119963418,ANILLO DEL TENSOR DE LA CADENA DE DISTRIBUCION BMW MOTOR M43-M44-M50-M52 GENUINO,1508,0,0,6,6
A09126007057,FILTRO ACEITE MOTOR LAND ROVER LR2 MHALE OC1063,1763,9,5,4,18
A0999053800,SENSOR DE TEMPERATURA MERCEDES W203 / M112 ( FEBI ),1568,4,0,0,4
A0999053800-4,SENSOR DE TEMPERATURA MERCEDES W203 / M112 ( TOPRAN ),1765,6,0,9,15
A1330940104,FILTRO ENTRADA AIRE MOTOR MERCEDES AMG  MULLER,1258,5,5,7,17
A2054600805,BIELETA DIRECCION SIN TERMINAL SUSPENSION DELTANTERA (L/R) MB W205 (SIDEM),1365,4,2,1,7
A2054600805-1,BIELETA DIRECCION SIN TERMINAL SUSPENSION DELTANTERA (L/R) MB W205 (TOPRAN),1448,6,2,2,10
A2660940004,FILTRO ENTRADA AIRE MOTOR MERCEDES W245 2.0 L KS 50013697,1970,6,2,2,10
A2711880001,ENFRIADOR DE ACEITE DE MOTOR MERCEDES W203 OSSCA,1856,7,9,7,23
A2C59515108 *5,SERVOMOTOR SISTEMA VALVETRONIC COOPER N12 N16 (CONTINENTAL) SSF,1585,1,4,0,5
A4526544,ENFRIADOR DE ACEITE DE MOTOR LAND ROVER RANGE ROVER LR3-LR4 BMTRS,1886,4,7,6,17
AAA7ML-100,PAR TORNILLOS ESTABILIZADOR DE SUSPENSION INACTIVO,1798,6,6,7,19
AAD5ML-100,PAR TERMINAL DE DIRECCION R Y L INACTIVO,1719,9,3,8,20
AAW2ML-100,PAR HORQUILLAS DE SUSPENSION DELANTERA INFERIOR INACTIVO,1406,7,8,5,20
AAX1ML *100,PAR AMORTIGUADORES TRASEROS ( L Y R )  MERCEDES BAJA,1856,4,4,1,9
AAX7ML-100,PAR AMORTIGUADORES  SUSPENSION DELANTERA INACTIVO,1481,3,9,2,14
AAZ5ML-100,PAR MORTIGUADORES DELANTEROS MERCEDES BENZ  INACTIVO,1627,9,5,6,20
ABT7ML,PAR DIAFRAGMAS DE VALVULA PCV BMW MOTOR N62 N62N ( KZR GERMANY ),1957,8,1,5,14
ACA6ML,KIT GUIAS DE DISTRIBUCION RECTA Y CURVA BMW E46 M54 INACTIVO,1979,9,8,3,20
ACA8ML,"KIT GUIAS DE DISTRIBUCION RECTA , CURVA Y FORMA ( T ) BMW E46 M54 INACTIVO",1377,0,6,8,14
ACEATF11 *3,1 LITRO LIQUIDO TRANSMISION AUTOMATICA ATF6 BMW MINI MERCEDES AUDI (PENTOSIN ALEMAN),1774,7,0,7,14
ACEATF11 *5,1 LITRO LIQUIDO ATF6 TRANSMISION AUTOMATICA (MOTUL),1874,1,8,0,9
ACEATF15 *3,5 LITROS LIQUIDO TRANSMISION AUTOMATICA ATF6 BMW MERCEDES AUDI MINI (PENTOSIN ALEMAN),1710,2,4,2,8
ACEFFL2 *3,1 LITRO LIQUIDO TRANSMISION DSG DOBLE CLUTCH AUDI VW SEAT (PENTOSIN ALEMAN),1326,7,5,4,16
ACSIN5W301 *3,1 LITRO ACEITE MOTOR 100% SINTETICO 5W-30 BMW MERCEDES AUDI MINI (PENTOSIN ALEMAN),1279,1,8,4,13
ACSIN5W301 *4,1 LITRO ACEITE MOTOR 100% SINTETICO 5W-30 BMW MERCEDES AUDI MINI (HELLA),1723,7,1,7,15
ACSIN5W301 *5,1 LITRO ACEITE MOTOR 100% SINTETICO 5W-30 BMW MERCEDES AUDI MINI (MOTUL),1313,5,9,7,21
ACSIN5W305 *3,5 LITROS ACEITE MOTOR 100% SINTETICO 5W-30 BMW MERCEDES AUDI MINI (PENTOSIN ALEMAN),1357,0,8,4,12
ACSIN5W305 *4,5 LITROS ACEITE MOTOR 100% SINTETICO 5W30 BMW MERCEDES AUDI MINI (HELLA),1284,3,9,7,19
ACSIN5W401 *3,1 LITRO ACEITE MOTOR 100% SINTETICO HP II 5W-40 BMW MERCEDES AUDI MINI (PENTOSIN ALEMAN),1861,7,9,9,25
ACSIN5W401 *4,1 LITRO ACEITE MOTOR 100% SINTETICO 5W40 BMW MERCEDES AUDI MINI (HELLA),1931,5,0,8,13
ACSIN5W404 *3,1 LITRO ACEITE MOTOR 100% SINTETICO 5W-40 BMW MERCEDES AUDIï¿½MINIï¿½(MOTUL),1997,1,4,2,7
ACSIN5W405 *3,5 LITROS ACEITE MOTOR 100% SINTETICO 5W-40 BMW MERCEDES AUDI MINI (PENTOSIN ALEMAN),1530,9,1,3,13
ACSIN5W405 *4,5 LITROS ACEITE MOTOR 100% SINTETICO 5W-40 BMW MERCEDES AUDI MINI (HELLA),1574,9,3,3,15
ACSIN5W405 *5,5 LITROS ACEITE MOTOR 100% SINTETICO 5W-40 BMW MERCEDES AUDIï¿½MINIï¿½(MOTUL),1676,4,5,4,13
ACSIN5W5-100,ACEITE SINTETICO DE MOTOR 5W50 1 LITRO INACTIVO,1219,9,9,9,27
ACSIN5W501 *3,1 LITRO ACEITE MOTOR 100% SINTETICO 5W-50  BMW MERCEDES AUDI MINI (PENTOSIN ALEMAN),1990,8,0,0,8
ACSIN5W501 *4,1 LITRO ACEITE MOTOR 100% SINTETICO 5W-50 BMW MERCEDES AUDI MINI (HELLA),1984,8,5,4,17
ACSIN5W505 *3,5 LITROS ACEITE MOTOR 100% SINTETICO 5W-50 BMW MERCEDES AUDI MINI (PENTOSIN ALEMAN),1776,4,3,3,10
ACSIN5W505 *4,5 LITROS ACEITE MOTOR 100% SINTETICO 5W-50 BMW MERCEDES AUDI MINI (HELLA),1517,2,9,2,13
ACSIN5W505-1,ACEITE SINTETICO DE MOTOR 5W50 5 LITROS CASTROL,1538,5,6,4,15
ACSIN75W901,ACEITE DE TRANSMISION MANUAL STD 75W90 (1LT) 100% SINTETICO,1503,4,6,5,15
ACSIN75W901-3,ACEITE DE TRANSMISION MANUAL STD 75W90 GEAR 300 LS (1LT) 100% SINTETICO MOTUL,1350,4,9,0,13
ACT000000,MOTOR DE ACTUADOR BMW E70 ( GENUINO ),1408,6,5,2,13
AD30XLB01 *K,KIT GUIAS TENSOR CADENAS DISTRIBUCION AUDI VW 3.0 L V6 (EMBLER) HPS,1569,2,6,3,11
AD32XLB01 *K,KIT 15 PZ GUIAS TENSORES CADENAS DISTRIBUCION MOTOR AUDI FSI 3.2 L V6 (EMBLER) HPS,1592,3,4,6,13
AD32XLB02,KIT DE CADENAS DE DISTRIBUCION CON JUNTAS AUDI A4 3.2L DORMAN PRECISION incompleto,1916,6,7,7,20
ADO5ML-100,FILTRO GASOLINA MINI COOPER R53 INACTIVO,1355,7,1,1,9
ADS4ML-100,KIT FILTRO JUNTA ACEITE TRANSMISIO INACTIVO,1895,6,5,7,18
AE1MlL-100,KIT JUNTAS ENFRIADOR ACEITE DE MOTOR MERCEDES W204 INACTIVO,1296,2,4,4,10
AH0616013A *V,BLOQUE VALVULAS AIRE SUSPENSION AUDI A6 2013 2017 (EMBLER) TECH,1798,7,1,6,14
AJ811793,TERMOSTATO DE MOTOR JAGUAR S-TYPE / 4.2L ( GENUINO ),1958,2,8,3,13
AJ86484,TERMOSTATO DE MOTOR JAGUAR S-TYPE 4.0L EUROSPARE,1695,2,9,0,11
ANR3731 *C,COMPRESOR AIRE SUSPENSION LAND ROVER RANGE ROVER GENERATION ll (EMBLER) TECH,1787,3,3,8,14
ANTHELLACON *4,1 GALON CON 3.78 LITROS ANTICONGELANTE CONCENTRADO ROSA AUDI VW SEAT (HELLA),1909,7,3,5,15
ANTHELLALPU *4,1 GALON CON 3.78 LITROS ANTICONGELANTE LISTO PARA USAR ROSA AUDI VW SEAT (HELLA),1271,2,7,8,17
AOI6ML-100,BOMBA AGUA LIMPIA PARABRISAS CHISGUETROS BMW MERCEDES SPRINTER INACTIVO,1648,4,5,6,15
APF2ML-100,KIT SOPORTE CON JUNTA GOMA CARDAN 96X12 MM BMW INACTIVO,1345,7,2,5,14
AW5MLFULL -,BOMBA DE AGUA SIN TERMOSTATO ELECTRONICO AUDI A4-B9 2.0 TFSI (EMBLER),1937,0,0,6,6
AXPLFRE400MATX,LIMPIADOR DE FRENOS AXPRO 400ML,1276,0,0,7,7
AXPLMOT500MATX,LIMPIADOR DE MOTOR AXPRO 500ML,1212,8,2,4,14
B0580453021-100,BOMBA DE GASOLINA BMW E34 BMTR REPUESTO INACTIVO,1226,6,3,9,18
B27107566250-100,ENGRANE MAESTRO DE SERVOMOTOR BLANCO BMW E53  BMTR INACTIVO,1248,2,5,1,8
B27107566250-101,ENGRANE MAESTRO DE SERVOMOTOR BLANCO BMW E53 BMTR INACTIVO,1540,0,2,4,6
BC18XLBM,BC18XLBM271X,1807,3,6,6,15
BC18XLBM271X02 *B,KIT DE 11 PZ SIN ENGRANES GUIAS TENSOR CADENAS DISTRIBUCIï¿½N MERCEDES M271 2a GENENERACION TURBO (EMBLER) HP,1265,5,3,5,13
BC18XLBM271X02 *K,KIT 16 PZ CON ENGRANES GUIAS TENSOR CADENAS DISTRIBUCIï¿½N MERCEDES M271 2a GEN TURBO (EMBLER) HPS,1260,8,2,3,13
BC270XLB001 *K,KIT 7 PZS ENGRANE GUIAS TENSOR CADENAS DISTRIBUCION MERCEDES W176 W205 W212 W213 W246 X204 (EMBLER) HPS,1799,6,9,4,19
BC30M276XLB002 *2,KIT DE CADENAS DE DISTRIBUCION MERCEDES M276 (EMBLER) HPS,1643,8,2,3,13
BC35M272XLB02 *K,KIT 13 PZ ENGRANES GUIAS TENSOR CADENAS DISTRIBUCION MERCEDES M272 (EMBLER) HPS,1994,8,6,3,17
BM16XLB001 *4,KIT 5 PZ GUIAS TENSOR CADENA DISTRIBUCION 1 ENGRANE CIGUEï¿½AL MINI N12 N14 N16 N18 (EMBLER) HPS,1662,1,6,6,13
BM16XLB005ï¿½*K,KIT 6 PZ ENGRANES GUIAS TENSOR CADENA DISTRIBUCION MINI R50 R52 R53 (EMBLER) HPS,1637,0,3,3,6
BM18XLB001C *K,KIT 4 PZ GUIAS CADENAS TENSOR DISTRIBUCION MOTOR BMW N46 N46N (EMBLER) HPS,1205,6,5,5,16
BMW44XLB01 *2,KIT 9 PZ SIN ENGRANES GUIAS TENSORES CADENAS DISTRIBUCION BMW M62 V8 4.4L (EMBLER) HPS,1238,0,0,4,4
BMW44XLB02,KIT DE DISTRIBUCION 6 PIEZAS E53-M62 4.4L DORMAN PRECISION,1230,2,8,5,15
BN9ML *100,KIT BUJE DE SUSPENSION DELANTERA ( L-R ) BMW E46 BAJA,1402,2,1,0,3
BON,Devoluciï¿½n sobre pieza defectuosa,1325,9,8,6,23
BP4L-32600,ELECTROBOMBA DE DIRECCION HIDRAULICA MAZDA 3,1345,5,4,0,9
BULEDBMWE87,BULBO LUZ LED BMW E87 AFTERMARKET,1366,6,7,9,22
BV8ML-100,KIT 2 BIELETAS CON TERMINAL DE DIRECCION INACTIVO,1416,3,7,2,12
C2C20176,TERMINAL DIRECCION SIN BIELETA SUSPENSION DELANTERA (R) JAGUAR S-TYPE (EUROSPARE),1338,0,4,3,7
C2C35783,TERMINAL DIRECCION SIN BIELETA SUSPENSION DELANTERA (L) JAGUAR S-TYPE (EUROSPARE),1589,0,1,0,1
C2C39683B,BUJE INFERIOR DE SUSPENSION DELANTERA L-R JAGUAR S-TYPE URO,1611,9,8,3,20
C2C41899,DEPOSITO DE ANTICONGELANTE JAGUAR S-TYPE EUROSPARE,1701,4,2,8,14
C2D24220,TORNILLO DE BARRA ESTABILIZADORA DE SUSPENSION DELANTERA JAGUAR S-TYPE ( SIDEM ),1694,8,2,2,12
C2D3792 *3,BALATAS FRENOS TRASEROS 122 X 64 MM JAGUAR X-TYPE (TRW GDB1877),1622,9,5,9,23
C2P17700,TAPON DE DEPOSITO DE ANTICONGELANTE JAGUAR S-TYPE ( EUROSPARE ),1993,4,9,7,20
C2S47861,DEPOSITO DE REFRIGERANTE JAGUAR X-TYPE  (EMBLER),1775,1,9,5,15
C2Z32125 *3,FILTRO ACEITE MOTOR DISCOVERY SPORT - LR2 - EVOQUE MAHLE OC1063,1794,2,8,0,10
C9658,FILTRO ENTRADA AIRE MOTOR MERCEDES W245 KOLBENSCHMIT,1808,7,9,5,21
CARS3BOT,CARCASA PARA LLAVE DE ENCENDIDO MERCEDES BENZ 3 BOTONES,1647,8,3,9,20
CE5ML-100,PAR DE AMORTIGUADORES DE SUSPENSION DELANTERA INACTIVO,1570,0,4,8,12
CHF11S *3 ,1 LITRO LIQUIDO DIRECCION HIDRAULICA 100% SINTETICO 11S CHF BMW MERCEDES AUDI MINI (PENTOSIN ALEMAN),1464,3,6,1,10
CHF11S *5 ,1 LITRO LIQUIDO DIRECCION HIDRAULICA 100% SINTETICO 11S CHF BMW MERCEDES AUDI MINI (FEBI) SSF,1394,1,3,1,5
CHR0385R,MANGUERA SUPERIOR DE RADIADOR VOLVO XC90 2007 3.2L DORMAN ALEMAN,1783,6,3,6,15
CLIPBMW,GRAPA CLIP PARA PANEL DE PORTEZUELA BMW BMTR,1547,2,4,6,12
CORTECO 21653085,BASE DE AMORTIGUADOR TRASERO L-R BMW E46 CORTECO 21653085,1923,2,2,8,12
CORTECO 80001833,POLEA CIGUEï¿½AL DAMPER MINI MOTOR SUPERCARGADO W11 (CORTECO 80001833),1678,2,0,9,11
DC1026LH,LUNA DE ESPEJO RETROVISOR ( L ) AUDI A3-A4 A6 01-08,1933,2,6,6,14
DC1026RH,LUNA DE ESPEJO RETROVISOR ( R )  AUDI A3-A4 A6 01-08,1590,1,3,0,4
DC1027LH,LUNA DE ESPEJO RETROVISOR (L) AUDI A3-A4-A5 09-16,1287,2,3,9,14
DC1027LHQ,LUNA DE ESPEJO RETROVISOR ( L ) AUDI Q5 Q7 08-16,1534,9,0,9,18
DC1027RH,LUNA DE ESPEJO RETROVISOR ( R )  AUDI A3-A4-A5 09-16,1607,4,8,4,16
DC1027RHQ,LUNA DE ESPEJO RETROVISOR ( R )  AUDI Q5 Q7 08-16,1834,6,2,0,8
DC1028LH,LUNA ESPEJO IZQUIERDO AUDIQ5 Q7 2008 AL 2016,1370,7,9,4,20
DC1028RH,LUNA ESPEJO DERECHO AUDI Q5 Q7 2008 AL 2016,1583,1,3,8,12
DC1031LH,LUNA DE ESPEJO RETROVISOR ( L ) AUDI Q7 06-09,1531,5,8,0,13
DC1031LHA,LUNA DE ESPEJO RETROVISOR ( L ) AUDI A3 AL A6 97-05,1235,4,1,9,14
DC1031RH,LUNA DE ESPEJO RETROVISOR ( R )  AUDI Q7 06-09,1366,9,6,3,18
DC1031RHA,LUNA DE ESPEJO RETROVISOR ( R )  AUDI A3 AL A6 97-05,1660,6,5,7,18
DC1033LH,LUNA ESPEJO IZQUIERDO AUDI A3 A 6 1997 A 2005,1579,4,2,0,6
DC1033RH,LUNA ESPEJO DERECHO AUDI A3 A 6 1997 A 2005,1993,5,7,6,18
DC1051ALH,LUNA DE ESPEJO RETROVISOR ( L ) BMW SERIE 2,1259,9,4,6,19
DC1051ARH,LUNA DE ESPEJO RETROVISOR ( R ) BMW SERIE 2,1775,4,6,4,14
DC1051BLH,LUNA ESPEJO IZQUIERDO BMW F30,1722,4,9,2,15
DC1053LH,LUNA DE ESPEJO RETROVISOR ( L ) BMW E60,1595,4,5,7,16
DC1053RH,LUNA DE ESPEJO RETROVISOR ( R )  BMW E60,1796,4,9,4,17
DC1054LH,LUNA DE ESPEJO RETROVISOR ( L ) BMW E90-E87,1674,4,4,5,13
DC1054RH,LUNA DE ESPEJO RETROVISOR ( R ) BMW E90-E87,1477,4,4,7,15
DC1055LH,LUNA DE ESPEJO RETROVISOR ( L ) BMW E90-E87 ),1496,7,5,2,14
DC1055RH,LUNA DE ESPEJO RETROVISOR ( R )  BMW E90-E87,1730,7,5,3,15
DC1057LH,LUNA DE ESPEJO RETROVISOR ( L ) BMW E70-E71,1731,2,6,2,10
DC1057RH,LUNA DE ESPEJO RETROVISOR ( R ) BMW E70-E71,1533,6,9,6,21
DC1058LRH,LUNA DE ESPEJO RETROVISOR ( L-R ) BMW E46-E39,1755,1,8,7,16
DC1059LH,LUNA DE ESPEJO RETROVISOR ( L ) BMW F25-E84,1350,8,4,2,14
DC1059RH,LUNA DE ESPEJO RETROVISOR ( R ) BMW F25-E84,1971,9,6,1,16
DC1060LH,LUNA DE ESPEJO RETROVISOR ( L ) BMW E53,1845,1,5,6,12
DC1060RH,LUNA DE ESPEJO RETROVISOR ( R ) BMW E53,1703,0,3,0,3
DC1061LH,LUNA DE ESPEJO RETROVISOR ( L ) BMW SERIE 5 2016,1626,8,9,3,20
DC1061LR,LUNA DE ESPEJO RETROVISOR ( R )  BMW SERIE 5 2016,1462,7,9,2,18
DC1061RH,LUNA ESPEJO DERECHO BMW SERIE 5 2016,1781,5,5,0,10
DC1062LH,LUNA DE ESPEJO RETROVISOR ( L ) BMW E83,1937,4,1,9,14
DC1062RH,LUNA DE ESPEJO RETROVISOR ( R ) BMW E83,1808,3,9,0,12
DC1063LH,LUNA DE ESPEJO RETROVISOR ( L ) BMW F15-F16,1646,5,9,9,23
DC1063RH,LUNA DE ESPEJO RETROVISOR ( R ) BMW F15-F16,1995,2,9,8,19
DC1064LH,LUNA DE ESPEJO RETROVISOR ( L ) BMW E46,1266,4,2,4,10
DC1064RH,LUNA DE ESPEJO RETROVISOR ( R ) BMW E46,1785,2,3,1,6
DC1402LH,LUNA DE ESPEJO RETROVISOR ( L ) MERCEDES BENZ  CLASE SLK- CLK,1532,4,8,3,15
DC1402RH,LUNA DE ESPEJO RETROVISOR ( R )  MERCEDES BENZ CLASE SLK - CLK,1877,0,1,0,1
DC1404LH,LUNA DE ESPEJO RETROVISOR ( L ) MERCEDES BENZ W203,1811,7,3,8,18
DC1404RH,LUNA DE ESPEJO RETROVISOR ( R )  MERCEDES BENZ W203,1607,8,5,9,22
DC1405LH,LUNA DE ESPEJO RETROVISOR ( L ) MERCEDES BENZ CLASE A-B-C-CLA-E,1728,4,1,9,14
DC1405RH,LUNA DE ESPEJO RETROVISOR ( R )  MERCEDES BENZ CLASE A-B-C-CLA-E,1753,0,0,2,2
DC1406LH,LUNA DE ESPEJO RETROVISOR ( L ) MERCEDES BENZ CLASE A-B 09-12,1361,8,5,5,18
DC1406RH,LUNA DE ESPEJO RETROVISOR ( R )  MERCEDES BENZ CLASE A-B 09-12,1804,4,9,1,14
DC1407LH,LUNA DE ESPEJO RETROVISOR ( L ) MERCEDES BENZ CLASE G GL M R 10-12,1298,6,6,9,21
DC1407LHS,LUNA DE ESPEJO RETROVISOR ( L ) MERCEDES BENZ SPLINTER 2012,1275,9,0,3,12
DC1407RH,LUNA DE ESPEJO RETROVISOR ( R )  MERCEDES BENZ CLASE G GL M R 10-12,1913,8,6,5,19
DC1407RHS,LUNA DE ESPEJO RETROVISOR ( R  )  MERCEDES BENZ SPLINTER 2012,1575,1,4,4,9
DC1410LH,LUNA DE ESPEJO RETROVISOR ( L ) MERCEDES BENZ W204,1816,0,7,5,12
DC1410RH,LUNA DE ESPEJO RETROVISOR ( R )  MERCEDES BENZ W204,1863,0,7,7,14
DC1413LH,LUNA DE ESPEJO RETROVISOR ( L ) MERCEDES BENZ SPLINTER 06-11,1275,7,7,7,21
DC1413LR,LUNA DE ESPEJO RETROVISOR ( R )  MERCEDES BENZ SPLINTER 06-11,1676,6,5,3,14
DC1415LH,LUNA DE ESPEJO RETROVISOR ( L ) MERCEDES BENZ X204,1821,7,6,6,19
DC1415RH,LUNA DE ESPEJO RETROVISOR (R)  MERCEDES BENZ X204,1872,5,9,7,21
DC1416LH,LUNA DE ESPEJO RETROVISOR ( L ) MERCEDES BENZ W163,1982,7,7,8,22
DC1416RH,LUNA DE ESPEJO RETROVISOR ( R )  MERCEDES BENZ W163,1442,2,8,1,11
DC1419LH,LUNA DE ESPEJO RETROVISOR ( L ) MERCEDES  W163,1365,1,2,2,5
DC1419RH,LUNA DE ESPEJO RETROVISOR ( R )  MERCEDES BENZ W164,1257,9,1,7,17
DC1420LH,LUNA DE ESPEJO RETROVISOR ( L ) MERCEDES BENZ VIANO 03-11,1848,5,6,9,20
DC1420RH,LUNA DE ESPEJO RETROVISOR ( R )  MERCEDES BENZ VIANO 03-11,1913,2,9,7,18
DC1421LH,LUNA DE ESPEJO RETROVISOR ( R )  MERCEDES BENZ CLASE E 06-09,1448,2,2,3,7
DC1421RH,LUNA DE ESPEJO RETROVISOR ( R )  MERCEDES  CLASE E 06-09,1603,9,0,5,14
DC1431LH,LUNA DE ESPEJO RETROVISOR ( L ) MINI COOPER R50,1725,0,4,3,7
DC1431LRH,LUNA ESPEJO IZQUIERDO O DERECHO MINI COOPER R50,1420,9,1,8,18
DC1431RH,LUNA DE ESPEJO RETROVISOR ( R )  MINI COOPER R50,1224,4,8,2,14
DC1432LH,LUNA DE ESPEJO RETROVISOR ( L ) MINI COOPER R56,1402,0,3,7,10
DC1432RH,LUNA DE ESPEJO RETROVISOR ( R )  MINI COOPER R56,1380,2,6,5,13
DK5ML-100,KIT TERMINAL DIRECCION SINN BIELETA (L/R) MERCEDES INACTIVO,1530,2,5,2,9
DK7ML,PAR BOLSAS AIRE SUSPENSION TRASERA (L/R) BMW X5 E53 (EMBLER),1971,8,3,3,14
DK9ML,PAR DE BOLSAS DE AIRE SUSPENSION TRASERA ( L-R ) LINCOLN CONTINENTAL SUNCORE,1904,7,9,4,20
DL-100,DE COFRE ( L Y R ) BMW INACTIVO,1902,6,8,1,15
DL2ML,PAR BOLSAS AIRE SUSPENSION DELANTERA (L/R) LAND ROVER RANGE ROVER (EMBLER),1792,5,9,4,18
DN2ML-100,PAR AMORTIGUADORES DE SUSPENSION DELANTERA INACTIVO,1608,6,6,2,14
DO6ML,PAR AMORTIGUADORES SUSPENSION DELANTERA BENTLEY (EMBLER),1570,1,2,1,4
DO9ML,PAR AMORTIGUADORES AIRE SUSPENSION TRASERA (L/R) BMW F02 F04 (EMBLER),1533,1,6,2,9
DU7ML-100,KIT 6 CABLES BUJIA MERCEDES M112 6 CIL INACTIVO,1458,5,2,7,14
DV2ML,KIT EMBLEMA Y OJALES 82 MM BMW,1761,8,6,4,18
DZ1ML-100,KIT 6 JUNTAS MULTIPLE ESCAPE MEDIDA 52 INACTIVO,1696,2,5,1,8
DZEA888XLB01 *K,KIT GUIAS CADENAS TENSOR HIDRAULICO AUDI VW SEAT 1.8 2.0 TFSI 2a GEN (EMBLER),1626,8,6,7,21
E17ML-100,BOMBA AGUA ELECTRICA ENFRIAMIENTO MOTOR BMW N52 N52N (PIERBUG) INACTIVO,1866,4,1,7,12
E3H4,FOCO DE LUZ HALOGENO H4 ( XENPLUS ),1674,3,8,7,18
E79ML-100 ,BOMBA DE AGUA MECANICA BMW E53 N62 INACTIVO,1442,0,7,1,8
ECO-105,LIMPIADOR DE CARBURADORES Y PARTES METALICAS ECOM,1543,8,1,5,14
ENVIO,ENVIO,1825,1,3,6,10
ESCRITORIO,ESCRITORIO,1716,3,2,1,6
F00M346097,REGULADOR DE VOLTAJE DE ALTERNADOR VOLVO S40 ( BOSCH 14 V ),1209,6,4,9,19
F010203MBAZ,LLAVERO MERCEDES BENZ EMBLEMA AZUL CERRADO,1248,6,4,1,11
F010402AMG,LLAVERO EMBLEMA MERCEDES BENZ AMG,1908,5,6,0,11
F010402AUD,LLAVERO EMBLEMA AUDI S LINE PIEL/METAL,1535,4,4,0,8
F010402AUD-1,LLAVERO EMBLEMA AUDI S LINE METAL,1763,8,0,8,16
F010402AUDI,LLAVERO EMBLEMA AUDI,1275,8,8,0,16
F010402BM,LLAVERO EMBLEMA BMW M CINTA NEGRA,1555,7,0,8,15
F010402BM-1,LLAVERO EMBLEMA BMW M CINTA COLORES,1324,4,3,7,14
F010402BMW,LLAVERO EMBLEMA BMW,1334,5,9,7,21
F010402BMW3,LLAVERO COLOR PLATA SERIE 3 BMW,1355,5,2,5,12
F010402BMWP,LLAVERO COLOR PLATA CON EMBLEMA BMW,1483,9,7,6,22
F010402BMWX5,LLAVERO BMW X5 LARGO,1560,6,3,7,16
F010402CAD,LLAVERO EMBLEMA CADILLAC,1921,9,3,6,18
F010402CHEV,LLAVERO EMBLEMA CHEVROLET,1804,4,6,2,12
F010402FIAT,LLAVERO EMBLEMA FIAT,1581,0,4,5,9
F010402FORD,LLAVERO EMBLEMA FORD,1374,9,8,9,26
F010402FUN,FUNDA PARA LLAVE DE MERCEDES BENZ COLOR NEGRO,1286,6,6,6,18
F010402HYUN,LLAVERO EMBLEMA HYUNDAI,1496,0,6,8,14
F010402JEEP,LLAVERO EMBLEMA JEEP,1764,5,2,7,14
F010402JG,LLAVERO EMBLEMA JAGUAR,1369,3,8,6,17
F010402KIA,LLAVERO EMBLEMA KIA,1399,1,2,7,10
F010402LAND,LLAVERO EMBLEMA LAND ROVER GRUESO,1915,8,7,8,23
F010402LANDR,LLAVERO EMBLEMA LAND ROVER,1939,8,3,0,11
F010402LEX,LLAVERO EMBLEMA LEXUS,1228,6,6,2,14
F010402MAZ,LLAVERO EMBLEMA MAZDA,1286,0,4,2,6
F010402MB,LLAVERO EMBLEMA MERCEDES BENZ PLATEADO ABIERTO,1678,3,1,4,8
F010402MBAZ,LLAVERO MERCEDES BENZ EMBLEMA NEGRO ABIERTO,1690,1,0,0,1
F010402MBAZ-1,LLAVERO MERCEDES BENZ EMBLEMA AZUL ABIERTO,1494,6,2,3,11
F010402MG,LLAVERO EMBLEMA MG,1896,9,2,5,16
F010402MINI,LLAVERO EMBLEMA MINI COOPER,1787,4,9,0,13
F010402MITSU,LLAVERO EMBLEMA MITSUBISHI,1541,4,2,9,15
F010402NISS,LLAVERO EMBLEMA NISSAN,1423,3,4,1,8
F010402PEUG,LLAVERO EMBLEMA PEUGEOT,1300,4,5,0,9
F010402PORS,LLAVERO EMBLEMA PORSCHE,1333,1,4,1,6
F010402REN,LLAVERO EMBLEMA RENAULT,1928,9,7,0,16
F010402SEAT,LLAVERO EMBLEMA SEAT,1201,4,4,9,17
F010402STKBMW,JUEGO DE TIRAS DE COLOR M BMW CALCOMANIA,1611,9,6,5,20
F010402SUB,LLAVERO EMBLEMA SUBARU,1356,5,4,1,10
F010402SUZU,LLAVERO EMBLEMA SUZUKI,1611,9,6,5,20
F010402TOYO,LLAVERO EMBLEMA TOYOTA,1712,8,8,3,19
F010402VOL,LLAVERO EMBLEMA VOLVO,1791,5,8,5,18
F010402VW,LLAVERO EMBLEMA R LINE VOLSWAGEN,1557,1,7,4,12
F010402VW-1,LLAVERO EMBLEMA VOLSWAGEN,1505,2,3,7,12
F5OY5319A *C ,COMPRESOR AIRE SUSPENSION LINCOLN CONTINENTAL (EMBLER) TECH,1605,7,1,7,15
F75Z5A891CA *B,BOLSA AIRE SUSPENSION TRASERA (L/R) FORD F150 F250 F350 (EMBLER) TECH,1801,0,4,3,7
F8VZ5319AA *C,COMPRESOR AIRE SUSPENSION TOWN CAR CROWN VICTORIA GRAND MARQUIS 1990 2011 (EMBLER) TECH,1500,0,4,1,5
FEM4008,SOPORTE PENDULAR (REIN),1776,4,4,7,15
FRENDO 1002411,AMORTIGUADOR DE SUSPENSIï¿½N DELANTERA ( L ) MINI F56 B38 (FRENDO 1002411),1519,0,2,7,9
FRENDO 1002412-100,AMORTIGUADOR SUSPENSION DELANTERA (R) MINI F56 INACTIVO,1684,7,6,7,20
FSKC-19-9F0,ENFRIADOR DE ACEITE DE TRANSMISION AUTOMATICA MAZDA 3-5 BMTRS,1781,4,1,0,5
FTE BL1822A2 *2,BALATAS FRENOS DELANTEROS AUDI Q7 2007 A 2015 VW TOUAREG 2004 A 2010 (FTE),1905,8,6,9,23
FTE BL2026A2,BALATAS FRENOS DELANTEROS MERCEDES W216-W221 (FTE),1420,3,9,1,13
FTE BL2552A1,BALATAS FRENOS DEALTERAS PEUGEOT/CITROï¿½N FTE BL2252A1,1928,0,4,3,7
FW7ML,KIT ENGRANE MAESTRO SERVOMOTOR BLANCO Y NEGRO 55 DIENTES BMW E53 (EMBLER),1585,3,8,8,19
G013A8JM1 *5 ,1.5 LITROS ANTICONGELANTE CONSENTRADO ROSA AUDI VW SEAT (FEBI) SSF,1559,1,3,9,13
G052180A2 *5,1 LITRO LIQUIDO TRANSMION AUTOMATICA CVT  TOP TEC ATF 1400 AUDI (LIQUI MOLY) SSF,1898,5,4,7,16
G0521821LDSP *5 ,1 LITRO LIQUIDO TRANSMISION DSG DOBLE CLUTCH AUDI VW SEAT (LIQUI MOLY) SSF,1788,2,7,0,9
GB-BRI3H-81-30,COMPUTADORA GB-BRI3H-81-30 Y COMPLEMENTOS,1319,7,2,7,16
GC5ML-100,KIT 6 BUJIAS IGNICION DOBLE PLATINO MERCEDES MOTOR INACTIVO,1805,8,7,3,18
GDB 856DTM ,BALATAS FRENOS (TRW GDB 856DTM),1293,6,9,6,21
GEDHL7,GUIA ELECTRONICA DHL 3KG,1363,8,9,0,17
GP2ML,PAR BOLSAS AIRE SUSPENSION DELANTERA (L/R) JEEP GRAND CHEROKEE (EMBLER),1600,7,8,2,17
GUIELFDX,GUIA ELECTRONICA FEDEX,1547,4,9,4,17
GUIFSFDX,GUIA FISICA FEDEX,1706,6,3,0,9
HT05457-100,HERRAMIENTA PARA ALTERNADOR BMW MERCEDES AUDI INACTIVO,1960,4,6,6,16
HTA1001 *2,HERRAMIENTA SINCRONIZACION CADENAS MOTOR MINI N12 N14 N16 (EMBLER) T&F,1608,6,5,4,15
HTA1002 *2,HERRAMIENTA SINCRONIZACION CADENAS MOTOR BMW MINI N13 N18 (EMBLER) T&F,1982,1,0,4,5
HTA1005B *2,HERRAMIENTA SINCRONIZACION CADENAS TIEMPO MOTOR BMW N20 N26 (EMBLER) T&F,1378,1,1,1,3
HTA1014,HERRAMIENTA DE SINCRONIZACION BMW MOTOR M62 HT,1357,5,5,4,14
HTA1021 *2 ,HERRAMIENTA SINCRONIZACION CADENAS TIEMPO MOTOR BMW N52 N52N N54 N55 (EMBLER) T&F,1534,1,8,1,10
HTA1031 *2,HERRAMIENTA SINCRONIZACION CADENAS MOTOR BMW N62 N62N (EMBLER) T&F,1782,7,9,6,22
HTA1032 *2,HERRAMIENTA SINCRONIZACION CADENAS MOTOR BMW N63 N63N (EMBLER) T&F,1589,1,6,0,7
HTA1038 *2 ,HERRAMIENTA SINCRONIZACION CADENAS MOTOR BMW M52 M54 (EMBLER) T&F,1794,2,2,9,13
HTA1041 *2,HERRAMIENTA SINCRONIZACION CADENAS MOTOR MINI B38 B48 B58 (EMBLER) T&F,1394,4,0,5,9
HTA1109 *2,HERRAMIENTA SINCRONIZACION CADENAS MOTOR BMW MOTOR N46 N46N (EMBLER) T&F,1416,2,1,2,5
HTB1001 *2,HERRAMIENTA DE SINCRONIZACION DE MOTOR MERCEDES MOTOR M271 HT,1506,8,0,8,16
HTB1009 *2,HERRAMIENTA DE SINCRONIZACION DE CADENAS MERCEDES AMG M156,1975,5,5,8,18
HTB1015 *2,HERRAMIENTA DE SINCRONIZACION MERCEDES M112-M113-M272-M273 CHRYSLER JEEP HT,1448,8,1,1,10
HTD1005 *2 ,HERRAMIENTA SINCRONIZACION ARBOLES LEVAS AUDI VW SEAT 1.2 1.4 1.6 TSI FSI (EMBLER) T&F,1278,4,7,5,16
HTD1007 *2,HERRAMIENTA DE SINCRONIZACION CON CARATULA MOTOR AUDI 1.4 TSI -1.6 FSI HT,1897,9,1,3,13
HTD1014,HERRAMIENTA DE SICRONIZACION DE CADENAS DE TIEMPO MERCEDES AMG 63 TH,1817,0,2,7,9
HTD1014B-100,HERRAMIENTA DE SINCRONIZACION VW AUDI 3.2L tool INACTIVO,1921,2,5,1,8
HTD1015 *2,HERRAMIENTA SINCRONIZACION ARBOLES LEVAS AUDI VW SEAT 1.2 1.4 TFSI (EMBLER) T&F,1993,2,8,1,11
HTD1020 *2,HERRAMIENTA SINCRONIZACION CADENAS MOTOR AUDI VW SEAT 1.8 2.0 TFSI (EMBLER) T&F,1990,3,8,3,14
HTD1027B-1,HERRAMIENTA DE SINCRONIZACION DE MOTOR AUDI B6 3.2 TFSI HT,1533,6,9,7,22
HTD1028 *2 ,HERRAMIENTA DE SINCRONIZACION DE MOTOR AUDI A4-3.2 TFSI HT,1815,2,0,7,9
HTD1030 *2,HERRAMIENTA SINCRONIZACION CADENAS MOTOR AUDI VW 2.8 3.0 (EMBLER) TOOL,1301,8,3,4,15
HTD1031 *2,KIT 6 PZ. HERRAMIENTA BLOQUEO ARBOLES LEVAS SINCRONIZACION CADENAS AUDI WV 3.0 L (EMBLER) TOOL,1932,7,3,2,12
HTL1005 *2,KIT 9 PZ. HERRAMIENTA SINCRONIZACION CADENAS MOTOR JAGUAR LAND ROVER 3.2 L 3.5 L 3.7 L 4.0 L 4.2 L 4.4 L (EMBLER) TOOL,1885,1,3,3,7
HTL1006 *2,HERRAMIENTA DE SINCRONIZACION DE MOTOR FREELANDER 2.5 V6 HT,1986,0,0,2,2
HTL1008 *2,HERRAMIENTA SINCRONIZACION JAGUAR - LAND ROVER 8 CIL 5.0L HT,1252,9,8,9,26
HTL10122-1 *2,HERRAMIENTA DE SINCRONIZACION DE MOTOR JAGUAR LAND ROVER 2.0T HT,1589,0,6,3,9
HTP1009,DADO MAGNETICO PARA BUJIAS 16 MM BMW E90-N54 HT,1323,9,8,0,17
HTP1010,DADO MAGNETICO PARA BUJIAS 14 MM BMW E90-N54 HT,1416,5,5,3,13
HTU1016B-100,HERRAMIENTA PARA ALTERNADOR VW BMW HT INACTIVO,1232,4,2,7,13
HTV10-100,HERRAMIENTA DE SINCRONIZACION INACTIVO,1731,6,5,6,17
HTV1004 *2,HERRAMIENTA SINCRONIZACION BANDA TIEMPO MOTOR VOLVO S40 S60 (EMBLER) T&F,1357,9,8,7,24
HTV1006B *2,HERRAMIENTA DE SINCRONIZACION DE MOTOR VOLVO T4 T5 2.0T HT,1343,7,8,9,24
HV-086,CADENA PARA TRANSFER NV125 BMW E83 BORGWARNER,1753,9,5,3,17
HV-087,CADENA PARA TRANSFER NV125  BMW E53 BORGWARNER,1891,2,1,1,4
HV8ML-100,KIT ACEITE BOMBA DIRECCION HIDRAULICA TAPA REDONDA INACTIVO,1877,1,4,4,9
HW1ML-100,KIT ACEITE  BOMBA DE DIRECCION HIDRAULICA INACTIVO,1379,1,6,7,14
HW3ML,KIT ACEITE Y BOMBA DE DIRECCION HIDRAULICA MERCEDES CLASE ML,1304,1,8,4,13
IAF500070,SOPORTE DE TRANSMISION RANGE ROVER SPORT,1803,1,5,4,10
IS9ML,PAR AMORTIGUADORES DE AIRE SUSPENSION DELANTERO CON SENSOR ( L-R )  ESCALADE-SUBURBAN SUNCORE,1274,1,3,2,6
JD6ML,KIT 6 BUJIAS DE IGNICION DOBLE PLATINO MERCEDES W140 GENUINA,1262,5,6,8,19
JD8ML,KIT 4 BUJIAS DE IGNICION DOBLE PLATINO MERCEDES W140 GENUINA,1945,9,3,9,21
JE1ML,KIT 8 BUJIAS DE IGNICION DOBLE PLATINO MERCEDES W140 GENUINA,1866,9,5,5,19
KKB103360 *5,SOPORTE MOTOR (R) FREELANDER 2002 A 2005 V6 2.5 L (FEBI) SSF,1396,5,5,4,14
KKB500630,SOPORTE DE MOTOR ( L / R ) RANGE ROVER SPORT,1896,2,3,8,13
KKH102680 *5,SOPORTE INFERIOR MOTOR FREELANDER 2002 A 2005 V6 2.5 L (BRITPART) SSF,1582,6,0,0,6
KS2ML,PAR AMORTIGUADORES DE SUSPENSION DELANTERO (L/R) MINI R50 SACHS,1309,0,0,0,0
KV1ML,PAR BOLSA DE AIRE SUSPENSION TRASERA ( L-R )  MERCEDES BENZ W251,1405,9,2,5,16
KV3ML-100,PAR BOLSA AIRE SUSPENSION TRASERA (L/R) LINCOLN NAVIGATOR FORD EXPEDITION (EMBLER) inactivo,1265,7,2,6,15
KV6ML,PAR BOLSA AIRE SUSPENSON TRASERA (L/R) LINCOLN TOWN CAR LIMOUSINE (EMBLER),1529,6,1,2,9
KV8ML,PAR BOLSA AIRE SUSPENSION TRASERA (L/R)  LINCOLN TOWN CAR GRAND MARQUIS CROWN VICTORIA (EMBLER),1877,0,1,7,8
KW1ML,PAR BOLSA AIRE 4X2 SUSPENSION TRASERA (L/R) LINCOLN NAVIGATOR FORD EXPEDITION 4X2 (EMBLER),1400,2,2,6,10
KW5ML,PAR BOLSA AIRE SUSPENSION TRASERA (L/R) HUMMER H2 (EMBLER),1898,7,8,8,23
KY7ML-100,PAR BRAZO DE CONTROL DELANTERO ( L/R ) BMW E60 INACTIVO,1875,6,6,5,17
L2012859 *A,AMORTIGUADOR AIRE CON SENSOR SUSPENSION DELANTERA (R) RANGE ROVER III (EMBLER) TECH,1946,3,0,2,5
L33L13700B-100,TURBO CARGADOR CARTUCHO K04 MAZDA CX-7 2.3 L DORMAN ALEMAN INACTIVO,1477,6,4,5,15
L33L13700B-101,TURBO CARGADOR COMPLETO K04 MAZDA CX-7 2.3 L KZR GERMANY INACTIVO,1445,3,9,6,18
LC8ML-100,PAR BRAZO CURVO DE SUSPENSION DELANTERA INACTIVO,1358,2,0,2,4
LD3ML-100,PAR BRAZO DE HIERRO INFERIOR DE SUSPENSION DELANTERA INACTIVO,1881,9,3,5,17
LDN10027L *5,1 PZ TORNILLO CABEZA MOTOR FREELANDER 2002 A 2005 2.5 L V6 (EUROSPARE) SSF,1358,4,3,5,12
LF6W14700,"ENFRIADOR DE ACEITE DE MOTOR MAZDA 3,5,6 Speed 5 Cx-7 2.3 y 2.5 L BMTRS",1608,4,5,5,14
LFP101370L,SET DE 1 ANILLO DE MOTOR FREELANDER / 2.5 L 1a GEN.( GOETZE ),1269,0,7,7,14
LFP101370L-1,ANILLOS DE MOTOR STD X 6 PISTONES FREELANDER MOTOR 2.5 L 1a GEN. GOETZE,1856,5,0,7,12
LGH101360,VALVULA DE ESCAPE LAND ROVER FREELANDER AE,1264,5,8,9,22
LHB101630L,TENSOR MECANICO DE BANDA DE DISTRIBUCION CON POLEA FREELANDER 1a GEN./ V6 2.5 ( INA ),1429,0,7,0,7
LHN100-100,BANDA DENTADA DISTRIBUCION MOTOR 176 DIENTES FREELANDER INACTIVO,1673,2,1,2,5
LHN100410L*5,BANDA DISTRIBUCION MOTOR 176 DIENTES FREELANDER 2002 A 2005 2.5 L V6 (DAYCO) SSF,1628,4,9,9,22
LHN100420L *5,BANDA TRASERA DENTADA DISTRIBUCION TIEMPO IGNICION MOTOR 58 DIENTES FREELANDER 2002 A 2005 V6 (DAYCO) SSF,1922,3,9,2,14
LHP100610L-1,TENSOR HIDRAULICO DE BANDA DE DISTRIBUCION FREELANDER 1a GEN./ V6 2.5 ( JSD ),1648,4,8,6,18
LHP100610LG *5,TENSOR HIDRAULICO DE BANDA DE DISTRIBUCION FREELANDER 1a GEN./ V6 2.5 ( EUROSPARE ),1520,1,4,2,7
LIFREATE,LIQUIDO DE FRENOS ATE,1739,9,2,4,15
LIFREDOT4 *3,1 LITRO LIQUIDO DE FRENOS SUPER DOT4 (PENTOSIN ALEMAN),1892,4,7,2,13
LIQWURT,LIQUIDO LIMPIAPARABISAS ALEMAN WURTH 32 ML,1978,0,4,4,8
LKG100290L,JUNTA DE MULTIPLE DE ESCAPE L-R FREELANDER 1a GEN EUROSPARE,1503,8,4,1,13
LKJ100992L *5,JUNTA MULTIPLE ADMISION AIRE MOTOR (L/R) FREELANDER 1a GEN (EUROSPARE) SSF,1629,8,5,5,18
LKJ100992L-3,JUNTA DE MULTIPLE DE ADMISION L-R FREELANDER 1a GEN BGA,1794,6,8,6,20
LO5ML-100,PAR BRAZO SUPERIOR DE SUSPENSION DELANTERA INACTIVO,1904,9,1,1,11
LPW000010,FILTRO ACEITE MOTOR FILTRON,1352,2,0,4,6
LPW100230 *3,FILTRO ACEITE MOTOR FREELANDER 6 CIL. 2.5 L V6 (MAHLE OC2371),1965,0,4,8,12
LPW100230-1,FILTRO ACEITE MOTOR FREELANDER 1a GEN 2000 - 2006 MANN W713/28,1949,0,1,9,10
LPW500030,FILTRO ACEITE MOTOR LAND ROVER RANGE ROVER FILTRON,1530,6,9,3,18
LR000931,MANGUERA SUPERIOR DE RADIADOR LR2 ( GENUINA ),1321,1,8,3,12
LR001454 *5,1 PZ JUNTA MULTIPLE ADMISION LAND ROVER LR2 3.2 L 6 CIL 2008 A 2012 (VICTOR REINZ) SSF,1497,5,9,2,16
LR002609 *5,TERMINAL DIRECCION SIN BIELETA SUSPENSION DELANTERA (R) LAND ROVER LR2 2008 a 2015 (LEMFOERDER) SSF,1633,3,8,4,15
LR002626 *5,TORNILLO BARRA ESTABILIZADORA SUSPENSION DELANTERA (L/R) LAND ROVER LR2 2008 A 2015 (DELPHI) SSF,1236,4,2,5,11
LR003157,BALERO MASA DELANTERO LAND ROVER LR2 OPTIMAL,1542,2,4,9,15
LR004936,BALATAS FRENOS DELANTEROS LAND ROVER LR2 PAGID T1653,1715,7,7,5,19
LR004936-1,BALATAS FRENOS DELANTEROS LAND ROVER LR2 TEXTAR 2412301,1272,6,2,3,11
LR005563,MANGUERA DE RADIADOR/ENFRIADOR DE ACEITE LR2 EUROSPARE,1314,7,1,2,10
LR005564,MANGUERA INFERIOR DE BOMBA DE AGUA LAND ROVER LR2 GENUINA,1395,9,3,9,21
LR005566,MANGUERA DE RADIADOR/TERMOSTATO LR2 GENUINA,1913,2,8,9,19
LR005631 *5,TERMOSTATO SENSOR TOMA AGUA ENFRIAMIENTO MOTOR RANGE ROVER LAND ROVER LR3 2005 A 2009 4.4 L V8 (UROPARTS) SSF,1438,8,1,9,18
LR005649R *5,BUJE GOMA BARRA ESTABILIZADORA SUSPENSION DELANTERA LAND ROVER LR2 2008 A 2012 (EUROSPARE) SSF,1589,1,9,2,12
LR005816 *3,FILTRO ENTRADA AIRE MOTOR LAND ROVER  LR2 (MAHLE LX1957),1641,5,5,2,12
LR006071 *5,TERMOSTATO ENFRIAMIENTO MOTOR LAND ROVER LR2 2008 A 2012 (MAHLE) SSF,1667,1,9,0,10
LR006071 *6,TERMOSTATO ENFRIAMIENTO MOTOR LAND ROVER LR2 2008 A 2012 (FEBI) SSF,1471,3,4,3,10
LR006071-100,TERMOSTATO DE MOTOR LAND ROVER LR2 INACTIVO,1336,0,1,7,8
LR006165,MANGUERA DE RADIADOR A DEPOSITO DE ANTICONGELANTE LR2 GENUINA,1679,4,8,3,15
LR006861,BOMBA AGUA MECANICA ENFRIAMIENTO MOTOR LAND ROVER LR2 (URO),1762,6,9,8,23
LR007413,MANGUERA SUPERIOR DE RADIADOR LR2 EUROSPARE,1823,5,3,2,10
LR007474,FILTRO ACEITE TRANSMISION CON CARTER RANGE ROVER,1200,1,3,9,13
LR010801,BOMBA DE AGUA PARA JAGUAR F-TYPE - LAND ROVER LR4 3.0 LITROS ( EMBLER ),1656,6,7,2,15
LR011279,FILTRO ACEITE MOTOR RANGE ROVER RANGE ROVER SPORT BLUE PRINT,1903,4,9,0,13
LR011279 *3,FILTRO ACEITE MOTOR RANGE ROVER RANGE ROVER SPORT MAHLE OX774D,1549,6,5,0,11
LR011593 *5,FILTRO ENTRADA AIRE MOTOR V8 (L/R) DISCOVERY LR4 2010 A 2013 RANGE ROVER SPORT 2010 A 2017 (MAHLE LX4397) SSF,1251,7,1,2,10
LR011593 *6,FILTRO ENTRADA AIRE MOTOR V8 (L/R) DISCOVERY LR4 2010 A 2013 RANGE ROVER SPORT 2010 A 2017 (HENGST) SSF,1279,0,9,8,17
LR015339,BUJE DE BARRA ESTABILIZADORA R-L LR3 EUROSPARE,1330,3,6,7,16
LR016176,DISCO DE FRENOS DELANTEROS RANGE ROVER ( EUROSPARE ),1529,2,1,0,3
LR016192,DISCO DE FRENOS TRASEROS RANGE ROVER SPORT 1a GEN ( EUROSPARE ),1462,5,4,8,17
LR016419 *A,AMORTIGUADOR AIRE SUSPENSION TRASERA (L/R) LAND ROVER RANGE ROVER SPORT DISCOVERY LR3 LR4 (EMBLER) TECH,1502,7,2,9,18
LR016869,BIELETA DIRECCION SIN TERMINAL SUSPENSION DELANTERA (L/R) LR2 (EUROSPARE),1230,7,4,8,19
LR017011,BUJE DE HORQUILLA DELANTERA INFERIOR RANGE ROVER SPORT 1a GEN DELPHI,1981,2,8,8,18
LR018275ES *5,TOMA AGUA MONOBLOCK ENFRIAMIENTO MOTOR RANGE ROVER LAND ROVER LR4 2010 A 2013 5.0 L V8 (EUROSPARE) SSF,1572,2,8,4,14
LR018347,BUJE DE BARRA ESTABILIZADORA  DE SUSPENSION DELANTERA RANGE ROVER SPORT EUROSPARE,1409,3,3,1,7
LR018347-1,BUJE DE BARRA ESTABILIZADORA  DE SUSPENSION DELANTERA RANGE ROVER SPORT SIDEM,1213,0,0,3,3
LR019618,BALATAS FRENOS DELANTEROS LAND ROVER  RANGE ROVER SPORT PAGID T1513,1777,1,0,2,3
LR019618-1,BALATAS FRENOS DELANTEROS LR3 RANGE ROVER RANGE ROVER SPORT BREMBO P44014N,1692,6,9,4,19
LR019618-2,BALATAS FRENOS DELANTEROS LAND ROVER  RANGE ROVER SPORT FTE BL2008B4,1606,6,1,4,11
LR019625,BALATAS FRENOS DELANTEROS LAND ROVER LR3 BREMBO P44014N,1380,7,4,9,20
LR019993 *A,AMORTIGUADOR AIRE CON SENSOR SUSPENSION DELANTERA (L/R) RANGE ROVER SPORT (EMBLER) TECH,1441,2,0,6,8
LR020367 *5,DEPOSITO ANTICONGELANTE LAND ROVER SPORT LR3 LR4 (EUROSPARE) SSF,1777,5,3,6,14
LR021899,BALATAS FRENOS DELANTEROS FREELANDER 1a GEN 2000-2006 PAGID T1283,1405,3,3,9,15
LR023888,BALATAS FRENOS TRASEROS LAND ROVER LR2 PAGID T1696,1788,3,8,1,12
LR023888-1,BALATAS FRENOS TRASEROS LAND ROVER LR2 TEXTAR 2453703,1262,2,8,4,14
LR023964 *C,COMPRESOR AIRE SUSPENSION LAND ROVER LR3 LR4 (EMBLER) TECH,1692,6,3,4,13
LR023964-100,COMPRESOR DE AIRE SUSPENSION LAND ROVER LR3 LR4 SPORT SUPERCARGADO INACTIVO,1962,5,2,8,15
LR023977 *3,FILTRO POLEN AIRE CABINA LAND ROVER (MAHLE LAK280),1562,4,1,2,7
LR025159,BUJE LAND ROVER LR3,1905,8,1,5,14
LR025739,BALATAS FRENOS TRASEROS LAND ROVER SPORT JURID,1910,5,6,1,12
LR025955,FAN CLUTCH RANGE ROVER SPORT TURBO CARGADA 4.2L V8 BEHR,1627,8,3,0,11
LR026221,BALATAS FRENOS DELANTEROS RANGE ROVER TEXTAR 2502101,1597,5,8,4,17
LR027408 *5,FILTRO ENTRADA AIRE MOTOR MOTOR FREELANDER 2002 A 2005 2.5 L V6 (MAHLE LX 886) SSF,1660,4,9,8,21
LR029078 *3,FILTRO ENTRADA AIRE MOTOR DISCOVERY SPORT EVOQUE LR2 (MAHLE LX3246),1496,6,7,4,17
LR030047,TORNILLO ESTABILIZADOR SUSPENSION DELANTERA (L/R) RANGE ROVER / TM (SIDEM),1262,9,0,0,9
LR030047 -2,TORNILLO ESTABILIZADOR SUSPENSION DELANTERA (L/R) RANGE ROVER (KARLYN),1317,0,1,0,1
LR030200,SENSOR DE CIGUEï¿½AL LAND ROVER LR2 ( EUROSPARE ),1656,4,4,3,11
LR030200-1,SENSOR DE CIGUEï¿½AL LAND ROVER LR2 ( GENUINO ),1718,3,0,5,8
LR031439 *1,FILTRO ACEITE MOTOR LAND ROVER LR3 4.4L (FREY),1908,8,3,5,16
LR031439 *5,FILTRO ACEITE MOTOR LAND ROVER LR3 4.4L (MANN) SSF,1384,7,2,1,10
LR031665 *A,AMORTIGUADOR AIRE SUSPENSION DELANTERA (L) LAND ROVER LR2 (EMBLER) TECH,1517,1,4,6,11
LR031666 *A,AMORTIGUADOR SUSPENSION TRASERA (L) LAND ROVER LR2 (EMBLER) TECH,1269,9,4,6,19
LR031667 *A,AMORTIGUADOR SUSPENSION DELANTERA (R) LAND ROVER LR2 (EMBLER) TECH,1561,4,4,5,13
LR031668 *A ,AMORTIGUADOR SUSPENSION TRASERA (R) LAND ROVER LR2 (EMBLER) TECH,1743,6,5,4,15
LR031844,DISCO DE FRENOS TARSEROS 354 MM RANGE ROVER 3a GEN FREMAX,1897,8,9,6,23
LR032080 *5,BUJIA IGNICION JAGUAR LAND ROVER (BOSCH) SSF,1938,7,3,4,14
LR032080-100,BUJIA IGNICION JAGUAR LAND ROVER (GENUINA) INACTIVO,1371,5,9,1,15
LR032560 *A,AMORTIGUADOR AIRE CON SENSOR SUSPENSION DELANTERA (R) RANGE ROVER 3a GEN (EMBLER) TECH,1619,1,7,1,9
LR032567 *A,AMORTIGUADOR AIRE CON SENSOR SUSPENSION DELANTERA (L) RANGE ROVER III (EMBLER) TECH,1434,6,2,6,14
LR032651 *A,AMORTIGUADOR AIRE CON SENSOR SUSPENSION TRASERA (L) RANGE ROVER PORT LR3 LR4 (EMBLER) TECH,1986,7,1,7,15
LR032652 *A,AMORTIGUADOR DE SUSPENSION TRASERA  ( R ) RANGE ROVER SPORT CON ADS LR3 LR4 (EMBLER) TECH,1745,6,3,3,12
LR033311 *C,COMPRESOR AIRE SUSPENSION RANGE ROVER 3a GEN. (EMBLER) TECH,1467,7,8,7,22
LR034266-3,AMORTIGUADOR DE SUSPENSION TRASERO L LAND ROVER RANGE ROVER SPORT,1646,3,4,7,14
LR034270 *A,AMORTIGUADOR SUSPENSION TRASERO (R) RANGE ROVER SPORT (EMBLER) TECH,1867,8,5,7,20
LR038599,BOMBA DE GASOLINA LAND ROVER LR2 MOTOR 3.2 L,1262,3,5,1,9
LR041425,BALERO DE RUEDA DELANTERO TRASERO LAND ROVER FREELANDER NSK,1752,3,9,4,16
LR041777 *C,COMPRESOR AIRE SUSPENSION RANGE ROVER SPORT LR3 LR4 (EMBLER) TECH,1607,5,8,4,17
LR044016 *C,COMPRESOR AIRE SUSPENSION LAND ROVER DISCOVERY (EMBLER) TECH,1239,4,3,5,12
LR044853 *B,BOLSA AIRE SUSPENSION TRASERA (L/R) RANGE ROVER SPORT 2a GEN 2013 A 2021 (EMBLER) TECH,1820,8,8,2,18
LR045251 *C,COMPRESOR AIRE SUSPENSION RANGE ROVER SPORT 2006-2013 (EMBLER) TECH,1399,0,2,9,11
LR049207 *3,AMORTIGUADOR COFRE FUERZA 380 NEWTONS 325 MM (L/R) LAND ROVER 2012 A 2018 (STABILUS),1532,3,6,4,13
LR051611,BUJE DE SUSPENSION TRASERA INFERIOR L-R LR3 LEMFOERDER,1341,4,4,1,9
LR051616,BUJE DE SUSPENSION TRASERA SUPERIOR ANTERIOR L-R LAND ROVER LR3 LEMFORDER,1504,0,5,0,5
LR051621,BUJE DE SUSPENSION TRASERA SUPERIOR POSTERIOR L-R LAND ROVER LR3 LEMFORDER,1662,6,7,4,17
LR051625G,BUJE DE BRAZO SUPERIOR DE SUSPENSION LAND ROVER RANGE ROVER SPORT LEMFORDER,1526,9,1,4,14
LR052171 *B,BOLSA AIRE SUSPENSION TRASERA (L) RANGE ROVER SPORT (EMBLER) TECH,1613,1,7,0,8
LR052774 *A,AMORTIGUADOR AIRE CON SENSOR SUSPENSION DELANTERA (R) RANGE ROVER 2012 A 2019 (EMBLER) TECH,1387,4,7,8,19
LR052775 *2,AMORTIGUADOR AIRE SUSPENSION DELANTERA (L) LAND ROVER 2014 (EMBLER) TECH,1339,9,6,6,21
LR052775 *A,AMORTIGUADOR AIRE CON SENSOR SUSPENSION DELANTERA (L) RANGE ROVER 2012 A 2019 (EMBLER) TECH,1574,6,4,7,17
LR055291,BUJE DE HORQUILLA DELANTERA INFERIOR RANGE ROVER SPORT 1a GEN FEBI,1853,1,9,8,18
LR055291-1,BUJE DE HORQUILLA DELANTERA INFERIOR RANGE ROVER SPORT 1a GEN LEMFOERDER,1209,3,7,1,11
LR055454-1,BALATAS FRENOS TRASEROS LAND ROVER  LR3 AKEBONO,1751,7,5,1,13
LR055454-3,BALATAS FRENOS TRASEROS LAND ROVER  LR3 PAGID T1514,1526,6,9,7,22
LR056138 *3,FILTRO ENTRADA AIRE MOTOR LAND ROVER CARBON ACTIVO (MAHLE LAK387),1600,1,3,4,8
LR056924 *A,AMORTIGUADOR SUSPENSION DELANTERA (R) LAND ROVER 2014 (EMBLER) TECH,1248,9,0,2,11
LR056964 *5,BUJE HORQUILLA SUPERIOR DELANTERA (L/R) LAND ROVER LR3 (EUROSPARE) SSF,1636,2,6,6,14
LR061365ES *5,SENSOR BALATAS FRENOS DELANTERO (L/R) LAND ROVER DISCOVERY SPORT 2015 A 2019 (EUROSPARE) SSF,1417,6,7,4,17
LR064185,BANDA ACCESORIOS MOTOR MEDIDA 6PK 2460 MM LR4 RANGE ROVER RANGE ROVER SPORT DAYCO,1287,5,1,8,14
LR072537 *C,COMPRESOR AIRE SUSPENSION RANGE ROVER SPORT 1A GEN. (EMBLER) TECH,1271,4,5,0,9
LR073366 *5,BUJE SUSPENSION DELANTERA LAND ROVER LR3 LR4 (MEYLE) SSF,1407,4,1,5,10
LR078656 *5,BRAZO DE CONTROL DELANTERO LAND ROVER RANGE ROVER (KARLYN) SSF,1520,6,3,7,16
LR081578 *2,BOMBA AGUA MECANICA ENFRIAMIENTO MOTOR RANGE ROVER EVOQUE (EMBLER) HT,1421,1,4,4,9
LR081578 *5,BOMBA AGUA MECANICA ENFRIAMIENTO MOTOR RANGE ROVER EVOQUE (GRAF) SSF,1747,3,5,5,13
LR114004,BALATAS FRENO DELANTERAS RANGE ROVER SPORT D5 E2 TEXTAR 2465901,1230,6,6,7,19
LR134692 *3,BALATAS FRENOS DELANTEROS LAND ROVER LR2 (TRW GDB1683),1937,4,4,3,11
LR139969,BALATAS FRENOS TRASEROS 116 X 46 RANGE ROVER TRW,1329,7,8,5,20
LR139969 *3,BALATAS FRENOS TRASEROS 117X46 MM RANGE ROVER 2010 A 2012 (TRW GDB1632),1706,7,1,2,10
LR160436 *3,BALATAS FRENOS TRASEROS VOLVO S60 XC90 (TRW GDB2110),1779,4,1,1,6
LR160444 *3,BALATAS LAND ROVER RANGE ROVER VELAR 2018 2.0T (TRW GDB2145),1473,2,3,3,8
LR160540 *3,BALATAS FRENOS DELANTEROS LAND ROVER DISCOVERY SPORT (TRW GDB2100),1357,1,3,9,13
LT8ML-100,PAR BRAZO INFERIOR DE SUSPENSION DELANTERA MERCEDES INACTIVO,1900,7,7,9,23
LU9ML-100,PAR HORQUILLAS SUPERIORES SUSPENSION DELANTERA INACTIVO,1357,0,8,2,10
LUB100350LES,SELLOS VALVULA FREE LANDER URO C/U,1293,4,5,0,9
LUC100150L,TAPON DE ARBOL DE LEVAS DELANTERO L-R FREELANDER 1ra GEN ELRING,1473,8,3,1,12
LUC100150L *5,TAPON DE ARBOL DE LEVAS DELANTERO L-R FREELANDER 1ra (VICTOR REINZ),1321,8,8,8,24
LUC100220L,RETEN DE ARBOL DE LEVAS TRASERO L-R FREELANDER 1ra GEN CORTECO,1676,2,5,7,14
LUC100290L,RETEN DE ARBOL DE LEVAS DELANTERO L-R 1ra GEN FREELANDER MAHLE,1983,0,4,1,5
LV2ML-100,PAR HORQUILLA SUPERIOR DE SUSPENSION DELANTERA INACTIVO,1330,0,5,0,5
LVB101630L *2 ,JUNTA CABEZA MOTOR MEDIDA STANDAR 1.5 MM FREELANDER 1a GEN (EMBLER) GOG,1591,2,6,8,16
LVF100400,JUNTA DE ACEITE EUROSPARE,1950,1,3,1,5
LVP100470L,JUNTA DE TAPA DE PUNTERIAS LAND ROVER FREELANDER VICTOR REINZ,1464,2,0,9,11
LW1ML-101,KIT DE 6 BOBINAS DE IGNICION MERCEDES W204-M272 BMTR INACTIVO,1666,6,1,7,14
LWF100090L,JUNTA LIGA DE MULTIPLE DE ADMISION FREELANDER 1a GEN EUROSPARE,1387,1,4,9,14
LZN100220L,VALVULA CHECK PARA BOOSTER DE FRENOS LAND ROVER FREELANDER,1720,9,0,7,16
M271L-K02A05/CE-4,KIT CADENAS DISTRIBUCION BASICO MERCEDES W203 M271 1a GEN KOMPRESSOR (EMBLER),1542,8,1,6,15
M271L-K02A05/CE/CJ,KIT DE CADENAS DISTRIBUCION SIN JUNTAS MOTOR MERCEDES W203-M271K-1a GEN. EMBLER,1279,4,2,4,10
M271X-T10A15/CE-100,KIT CADENAS DISTRIBUCION MERCEDES M271T INACTIVO,1842,9,2,0,11
M271X-T10A15/SE/SJ,KIT DE CADENAS DE DISTRIBUCION MERCEDES W204 M271T (EMBLER),1292,9,8,1,18
M271XL-K02A05/CE/CJ,KIT DE CADENAS DISTRIBUCION CON ENGRANES Y CON JUNTAS DE MOTOR MERCEDES W203-M271K -1a GEN. EMBLER,1518,2,1,1,4
M276XL,KIT DE CADENAS DE DISTRIBUCION MERCEDES M276 DORMAN PRECISION,1940,3,9,3,15
MACSIN5W305 *3,5 LITROS ACEITE MOTOR 100% SINTETICO 5W-30 BMW MERCEDES AUDIï¿½MINIï¿½(MOTUL),1990,3,2,4,9
MAHLE KL165,FILTRO COMBUSTIBLE GASOLINA SMART (MAHLE KL165),1853,9,2,9,20
MAHLE KL229/4,FILTRO COMBUSTIBLE GASOLINA VW (MAHLE KL229/4),1533,6,8,0,14
MAHLE KL248 ,FILTRO COMBUSTIBLE GASOLINA SMART W450 1 a GEN. (MAHLE KL248),1479,6,2,3,11
MAHLE LA102-100,FILTRO AIRE CABINA BMW E46-M54 INACTIVO,1930,2,3,0,5
MAHLE LA220-100,FILTRO AIRE VOLVO S40 C30 V50 MAHLE LA220 INACTIVO,1690,4,6,9,19
MAHLE LA630S *3,KIT 2 PZ. FILTRO POLEN AIRE CABINA BMW F25 E26 (MAHLE LA630S),1705,8,5,2,15
MAHLE LX1293-100,FILTRO AIRE  MOTO F650 GS INACTIVO,1382,4,7,2,13
MAHLE LX1741,FILTRO AIRE MOTOR BMW F10-N52N (MAHLE LX1741) BAJA,1699,4,6,1,11
MAHLE LX1790,FILTRO ENTRADA AIRE MOTOR BMW F650 (MAHLE LX1790),1750,3,2,2,7
MAHLE LX1805,FILTRO ENTRADA AIRE MOTOR SMART FORTWO (MAHLE LX1805),1938,6,7,0,13
MAHLE LX1841/1,FILTRO ENTRADA AIRE MOTOR BMW S1000 RR (MAHLE LX1841/1),1444,2,9,4,15
MAHLE LX1892,FILTRO ENTRADA AIRE MOTOR BMW K1300 (MAHLE LX1892),1580,6,9,3,18
MAHLE LX194,FILTRO ENTRADA AIRE MOTOR BMW 73-90 (MAHLE LX194),1879,2,5,2,9
MAHLE LX2813 *3,FILTRO ENTRADA AIRE MOTOR MERCEDES R172 W204 M271 2a GEN TURBO (MAHLE) DGO,1972,5,7,7,19
MAHLE LX628,FILTRO ENTRADA AIRE MOTOR BMW R1100 (MAHLE LX628),1964,4,4,5,13
MAHLE LX75,FILTRO ENTRADA AIRE MOTOR BMW MOTORCYCLE K-SERIES MAHLE LX75,1470,7,5,7,19
MAHLE LX820,FILTRO ENTRADA AIRE MOTOR BMW MOTO F650 (MAHLE LX820),1634,5,4,5,14
MAHLE LX966,FILTRO ENTRADA AIRE MOTOR BMW K1200 (MAHLE LX966),1437,8,6,3,17
MAHLE LX984/2,FILTRO ENTRADA AIRE MOTOR BMW (MAHLE LX984/2),1558,9,0,6,15
MAHLE LX984/5,FILTRO ENTRADA AIRE MOTOR BMW R1200 (MAHLE LX984/5),1997,0,9,2,11
MAHLE OC295,FILTRO ACEITE MOTOR VOLKSWAGEN 1.6L 4CIL (MAHLE OC295),1483,6,3,2,11
MAHLE OX135/1D,FILTRO ACEITE MOTOR MERCEDES BENZ W168 (MAHLE OX135/1D),1991,2,4,7,13
MAHLE OX188D,FILTRO ACEITE MOTOR MAHLE AUDI (MAHLE OX188D),1971,8,9,6,23
MAHLE OX341D,FILTRO ACEITE MOTOR 1.6 L MAHLE OX341D,1346,4,9,1,14
MAHLE OX35,FILTRO ACEITE MOTOR  BMW R100 R80 Hf161 (MAHLE OX35),1808,5,2,9,16
MAHLE OX36D,FILTRO ACEITE MOTOR BMW R100 R80 11009056146 (MAHLE OX36D),1645,4,3,0,7
MAHLE OX37D,FILTRO ACEITE MOTOR BMW R-SERIES (OX37D),1663,9,4,3,16
MAHLE OX420,FILTRO ACEITE MOTOR TOUAREG 3.0 DIESEL (MAHLE OX420),1252,5,0,9,14
MAHLE TI2495,TERMOSTATO DE MOTOR BMW E36-Z3 M44 MAHLE TI2495,1708,2,9,8,19
MAHLE TM45100D,TERMOSTATO MOTOR MERCEDES M272 (MAHLE TM45100D),1416,6,0,1,7
MAHLE TM6109,TERMOSTATO DE MOTOR AUDI A3 2.0 L FSI MAHLE TM6109,1712,2,7,0,9
MC952P2CBBR,FILTRO POLEN AIRE CABINA CON CARBON MINI F55 COOL-XPERT,1446,4,0,3,7
ME3ML-100,KIT DE 12 BOBINAS DE IGNICION BMW MOTOR INACTIVO,1373,2,1,4,7
MJY100620L *5,INYECTOR COMBUSTIBLE GASOLINA  FREELANDER 2002 A 2005 V6 2.5 L (GB) SSF,1709,2,8,3,13
MP3ML,PAR BOLSAS AIRE SUSPENSION TRASERA (L/R) CHEVROLET TRAIBLAZER-RAINIER-ENVOY-BRAVADA-SAAB 9 (EMBLER),1318,6,2,4,12
MYX100180L *5,"JUNTA DE MULTIPLE DE ADMISION """"O"""" RING FREELANDER 1a GEN EUROSPARE",1205,2,6,7,15
N10437201,BATERIA PARA LLAVE DE IGNICION AUDI A4 1.8 RAYOVAC 3.0 V CR1620,1265,0,1,9,10
N10721805-1,FOCO DE XENON D3S CON IGNITOR 5300K XENPLUS,1743,8,2,4,14
N90692901,CONECTOR REFRIGERANTE AUDI A1 A3 A5 A7 VIKA,1569,2,4,9,15
NBB3500AA,FILTRO ENTRADA AIRE MOTOR JAGUAR XJR V8 MANN C22117,1769,0,9,4,13
NEC000110L-1,BOBINA DE IGNICION LAND ROVER FREELANDER EUROSPARE,1537,9,1,4,14
NEC000110L-100,BOBINA DE IGNICION LAND ROVER FREELANDER INACTIVO,1584,2,5,0,7
NG2ML-100,PAR AMORTIGUADOR DE COFRE BMW E83 INACTIVO,1284,8,4,8,20
NGK SILZKFR8E7S *3,BUJIA IGNICION IRIDIUM MERCEDES M270 M256 (NGK),1970,4,4,0,8
NGK ZFR6FIX-11 *9,BUJIA IGNICION IRIDIUM HIGH POWER BMW N46 N46N N62 N62N (NGK),1595,1,4,8,13
NH6ML,PAR DE BRAZO INFERIOR DE SUSPENSION DELANTERA R Y L MERCEDES W221 FREY,1761,8,9,5,22
NJ2ML-100,PAR BRAZOS INFERIORES SUSPENSION DELANTERA INACTIVO,1663,8,9,0,17
NJA3558AA *3,FILTRO ENTRADA AIRE MOTOR JAGUAR XJ8 4.0 SUPER (MAHLE LX888),1514,0,7,7,14
NK3ML-100,PAR BRAZOS INFERIORES SUPENSION DELANTERA INACTIVO,1949,2,1,4,7
NL2ML-100,PAR DE HORQUILLAS SUPERIOR DE SUSPENSION TRASERA INACTIVO,1960,3,3,8,14
NL5ML-100,PAR DE TORNILLOS DE BARRA ESTABILIZADORA TRASERA INACTIVO,1669,3,4,0,7
NLP100290 *5,BUJIA IGNICION MOTOR DOBLE PLATINO FREE LANDER 2002 A 2005 V6 2.5 L (BOSCH) SSF,1387,6,5,6,17
NSC000310LES *5,SENSOR POSICION ARBOL LEVAS (L/R) FREELANDER 2002 A 2005 2.5 L V6 (EUROSPARE) SSF,1611,6,1,0,7
NY903 *1,HERRAMIENTA FILTRO ACEITE MERCEDES SPRINTER W901 W906 (FREY),1724,7,2,6,15
OM6ML,PAR BOLSA AIRE SUSPENSION TRASERA (L/R) JEEPGRAND CHEROKEE (EMBLER),1890,3,0,8,11
ORG2000,ORINGS BOLSA AIRE SUSPENSION 1C2000 1C2001 1C2002 1C2051 1C2004 1C2005 1C3580 (EMBLER),1945,8,8,1,17
ORG4500 *O,ORINGS BOLSA AIRE SUSPENSION TRASERA (L/R) MERCEDES W166 (EMBLER),1621,7,6,8,21
ORG4513 *O,ORINGS BOLSA AIRE SUSPENSION DELANTERA (L/R) MERCEDES W164 (EMBLER).,1638,9,4,2,15
ORG6221 *O,ORINGS BOLSA AIRE SUSPENSION DELANTERA (L/R) MERCEDES W221 (EMBLER).,1278,8,3,9,20
OS7ML-100,AMORTIGUADOR DE SUSPENSION DELANTERA R MINI F56 INACTIVO,1715,2,9,9,20
OSJ103221B,MANGUERA DE VENTILACION PCV AUDI A4 2.0 TFSI PROTECCION FOMI AFTERMARKET,1722,2,0,1,3
P19ML-100,KIT 4 BUJIAS IRIDIUM MERCEDES M270 M256 (GENUINA) INACTIVO,1377,0,2,5,7
PA1139 *5,BOMBA AGUA MECANICA ENFRIAMIENTO MOTOR VOLVO S60 S80 V60 XC60 XC70 2.5 L 5 CIL  3.0 L 6 CIL 3.2 L 6 CIL (GRAF) SSF,1673,3,5,4,12
PA659 *5,BOMBA AGUA ENFRIAMIENTO MOTOR BMW M52 M54 (MARCA SALERI),1946,5,6,2,13
PBC000010,ENFRIADOR DE ACEITE DE MOTOR LAND ROVER FREELANDER 2.5L BMTRS,1886,2,7,2,11
PCD500030 *5,TAPON DEPOSITO ANTICONGELANTE 1.1 BARES FREELANDER LR3 RANGE ROVER SPORT RANGE ROVER (EUROSPARE) SSF,1220,9,4,6,19
PCF000012 *2,DEPOSITO ANTICONGELANTE ENFRIAMIENTO MOTOR FREELANDER 2002 A 2005 V6 2.5 L (EMBLER) GOG,1762,8,4,5,17
PCF000012 *5,DEPOSITO ANTICONGELANTE ENFRIAMIENTO MOTOR FREELANDER 2002 A 2005 V6 2.5 L (EUROSPARE) SSF,1261,4,6,9,19
PCF101410 *2,DEPOSITO ANTICONGELANTE LAND ROVER DISCOVERY ( EMBLER ) GOG,1313,3,3,1,7
PCH000232 *5,MANGUERA SUPERIOR RADIADOR ENFRIAMIENTO MOTOR FREELANDER 2002 A 2005 V6 2.5 L (EUROSPARE) SSF,1378,8,1,3,12
PCH000460 *5,MANGUERA SUPERIOR RADIADOR CON PURGADOR LAND ROVER DISCOVERY 2000 A 2004 4.0 4.6 L V8 (URO PARTS) SSF,1356,3,1,3,7
PCH000460 *6,MANGUERA SUPERIOR RADIADOR CON PURGADOR LAND ROVER DISCOVERY 2000 A 2004 4.0 4.6 L V8  (EUROSPARE) SSF,1212,8,4,8,20
PCH000961 *5,MANGUERA INFERIOR RADIADOR ENFRIAMIENTO MOTOR FREELANDER 2002 A 2005 V6 2.5 L (EUROSPARE) SSF,1643,7,5,6,18
PCH500941,MANGUERA SUPERIOR DE RADIADOR RANGE ROVER SPORT 1a GEN ( EUROSPARE ),1866,9,6,7,22
PCH502160 *5,MANGUERA TERMOSTATO RADIADOR ENFRIAMIENTO MOTOR FREELANDER 2002 A 2005 V6 2.5 L (GENUINA) SSF,1874,8,7,0,15
PEB102240L *5,BOMBA AGUA ENFRIAMIENTO MOTOR FREELANDER 2002 A 2005 V6 2.5 L (TUBA) SSF,1832,2,8,5,15
PEB102240LES *5,BOMBA AGUA ENFRIAMIENTO MOTOR FREELANDER 2002 A 2005 V6 2.5 L (EUROSPARE) SSF,1530,4,0,6,10
PEM000030 *2,1 PZ TERMOSTATO ENFRIAMIENTO MOTOR FREELANDER 2002 A 2005 V6 2.5 L (EMBLER) GOG,1779,1,7,2,10
PEM000030 *3,KIT 4 PZ. TERMOSTATO TUBO CURBO RECTO SENSOR TEMPERATURA FREELANDER 2.5 L (EMBLER) GOG,1695,1,3,5,9
PEM000030 *5,1 PZ TERMOSTATO ENFRIAMIENTO MOTOR FREELANDER 2002 A 2005 V6 2.5 L (EUROSPARE) SSF,1978,2,4,3,9
PEM000030 *6,1 PZ TERMOSTATO ENFRIAMIENTO MOTOR FREELANDER 2002 A 2005 V6 2.5 L (OEM) SSF,1545,6,2,6,14
PEM101050,TERMOSTATO DE MOTOR CON TUBOS LAND ROVER ORIGINAL,1532,3,7,0,10
PEM101050-1,TERMOSTATO DE MOTOR CON TUBOS ROVER 75 AFTERMARKET,1532,6,3,4,13
PEM101130,TERMOSTATO DE MOTOR LAND ROVER RANGE ROVER ( GENERICO ),1747,0,5,7,12
PEP101970LR *5,TUBO AGUA RECTO ENFRIAMIENTO MOTOR FREELANDER 2002 A 2005 V6 2.5 L (EUROESPARE) SSF,1342,2,5,3,10
PEP103580 *5,TUBO AGUA CURVO ENFRIAMIENTO MOTOR FREELANDER 2002 A 2005 V6 2.5 L (EUROSPARE) SSF,1692,8,9,2,19
PFR7S8EG NGK *6,BUJIA IGNICION DOBLE PALTINO AUDI VW SEAT 2.0 L 4.2 L 5.2 L (NGK PFR7S8EG) SSF,1378,4,3,1,8
PHE000050 *3,FILTRO ENTRADA AIRE MOTOR LAND ROVER RANGE ROVER (MAHLE LX1460),1676,8,5,4,17
PHE000112 *3,FILTRO ENTRADA AIRE MOTOR RANGE ROVER SPORT (MAHLE LX1764),1369,3,1,0,4
PHE100460,FILTRO ENTRADA AIRE MOTOR LAND ROVER 75 V6 2005 MAHLE LX889,1212,1,1,3,5
PHF000140,SENSOR DE MASA DE AIRE MAF LAND ROVER LR2 ISUMO,1293,6,6,7,19
PI1ML-100,PAR ENGRANE DE ARBOL DE LEVAS DE ADMISION Y ESCAPE BMW F20-N20 INACTIVO,1936,0,1,2,3
PLZKBR7B8DG NGK *3,BUJIA LASER PLATINUM BMW MINI N14 N16 N18 N20 N55 N63 (NGK)*3,1289,8,2,8,18
PM3096,AMORTIGUADOR DE COFRE VOLVO S80 BMTR,1746,1,0,8,9
PQR500320-L,BANDA DE ALTERNADOR RANGE ROVER CONTITECH  6PK2271,1796,2,6,3,11
PQS500241,BANDA DE ALTERNADOR RANGE ROVER SPORT 1a GEN DAYCO 8DPK1355,1875,9,5,6,20
PX7ML,PAR BOLSAS AIRE SUSPENSION TRASERA (L/R) LINCOLN NAVIGATOR FORD EXPEDITION (EMBLER),1913,3,8,8,19
Q4150029,KIT DE CABLES DE BUJIA MERCEDES W126-M117 SIT,1456,2,1,8,11
QA6ML,PAR BOLSAS AIRE SUSPENSION DELANTERA (L/R) AUDI ALL ROAD QUATTRO AVANT A6 C5 (EMBLER),1292,6,8,9,23
QA8ML,PAR BOLSAS AIRE SUSPENSION TRASERA (L/R) AUDI ALL ROAD QUATTRO AVANT A6 C5 (EMBLER),1347,1,9,6,16
QB1ML,PAR BOLSAS AIRE SUSPENSION DELANTERA (L/R) MERCEDES W251 (EMBLER),1490,3,9,3,15
QC1ML,PAR BOLSAS AIRE SUSPENSION TRASERA (L/R) Q7 CAYENNE TOUAREG (EMBLER),1618,5,3,0,8
QC6ML,PAR BOLSAS AIRE SUSPENSION DELANTERA (L/R) AUDI A8 S8 (EMBLER),1512,0,5,3,8
QFK000070,BIELETA DIRECCION CON TERMINAL SUSPENSION DELANTERA (L) FREELANDER 1a GEN (MOOG),1798,4,8,1,13
QI2ML-100,PAR BASES DE AMORTIGUADOR DELANTERO INACTIVO,1370,8,5,0,13
QJ9ML-100,PAR BASE DE AMORTIGUADOR DELANTERO INACTIVO,1970,2,7,8,17
QSJ3545S,BRAZO DELANTERO RECTO DERECHO E70,1747,0,8,7,15
QW6ML,PAR BUJE DE HORQUILLA DE SUSPENSION DELANTERA R MERCEDES W176 BMTR,1662,6,7,5,18
RBJ500680,HORQUILLA INFERIOR DE SUSPENSION DELANTERA R FREELANDER EUROSPARE,1414,7,3,8,18
RBK500170,ROTULA DE SUSPENSION DELANTERA ( L / R ) RANGE ROVER SPORT 1a GEN. ( DELPHI ),1316,5,4,3,12
RBK500300,ROTULA DE SUSPENSION DELANTERA  ( L / R ) RANGE ROVER SPORT 1a GEN. ( DELPHI ),1397,3,3,9,15
RBM500140,TORNILLO BARRA ESTABILIZADOR R (65165),1553,2,5,6,13
RBM500150,TORNILLO BARRA ESTABILIZADOR L (65164),1903,9,1,6,16
RBX000010 *5,BUJE BARRA ESTABILIZADORA SUSPENSION DELANTERA (L/R) FREELANDER 2002 A 2005 V6 2.5 L  (EUROSPARE) SSF,1930,2,3,5,10
RBX500311,BUJE DE HORQUILLA INFERIOR DELANTERA LR3 SIDEM,1747,2,3,8,13
RBX500432,BUJE DE HORQUILLA INFERIOR RANGE ROVER SPORT 1a GEN LEMFOERDER,1764,6,4,5,15
RBX500443,BUJE DE HORQUILLA DELANTERA SUPERIOR RANGE ROVER SPORT 1a GEN LEMFOERDER,1933,2,5,3,10
RCP96-203,JUEGO DE PASTAS BMW 6L45R,1734,9,4,6,19
RE-100,RENTA DE HERRAMIENTA DE SINCRONIZACION INACTIVO,1994,9,2,6,17
REB101740 *B,BOLSA AIRE SUSPENSION DELANTERA (L/R) LAND ROVER RANGE ROVER GENERACION II (EMBLER) TECH,1955,9,6,5,20
RENTAHERRAM,RENTA DE HERRAMIENTA DE AUDI A4 MOTOR 3.2,1768,0,1,1,2
RKB101200 *B,BOLSA AIRE SUSPENSION TRASERA (L/R) LAND ROVER DISCOVERY 2 (EMBLER) TECH,1499,7,0,8,15
RKB101460 *B,BOLSA AIRE SUSPENSION TRASERA (L/R) LAND ROVER RANGE ROVER GENERACION II (EMBLER) TECH,1775,5,0,1,6
RKB500082 *B,BOLSA AIRE SUSPENSION TRASERA (L/R) LAND ROVER RANGE ROVER (EMBLER) TECH,1590,7,6,3,16
RL4ML-100,PAR BASE DE AMORTIGUADOR DELANTERO ( L-R ) BMW INACTIVO,1378,2,1,4,7
RNB000740 *A,AMORTIGUADOR AIRE SIN SENSOR SUSPENSION DELANTERA (R) RANGE ROVER III (EMBLER) TECH,1826,6,2,8,16
RNB000740 *B,BOLSA AIRE SUSPENSION DELANTERA (R) LAND ROVER RANGE ROVER (EMBLER) TECH,1613,6,5,3,14
RNB000750 *A,AMORTIGUADOR AIRE SIN SENSOR SUSPENSION DELANTERA (L) RANGE ROVER III (EMBLER) TECH,1742,0,8,8,16
RNB000750 *B,BOLSA AIRE SUSPENSION DELANTERA (L) LAND ROVER RANGE ROVER (EMBLER) TECH,1463,4,2,1,7
RNB501580 *A,AMORTIGUADOR AIRE SIN SENSOR SUSPENSION DELANTERA (L/R) LAND ROVER DISCOVERY 3 (EMBLER) TECH,1769,3,1,5,9
RNB501580 *B,BOLSA AIRE SUSPENSION DELANTERA (L/R) LAND ROVER LR3 LR4 SPORT (EMBLER) TECH,1214,3,4,6,13
RNB501580 *O,ORINGS BOLSA AIRE SUSPENSION DELANTERA (L/R) LAND ROVER LR3 LR4 SPORT (EMBLER),1720,4,9,6,19
RPD501110 *B,BOLSA AIRE SUSPENSION TRASERA (L/R) LAND ROVER RANGE ROVER SPORT DISCOVERY LR3 LR4 (EMBLER) TECH,1475,5,4,8,17
RQL000014 *C,COMPRESOR AIRE SUSPENSION LAND ROVER (EMBLER) TECH,1389,7,3,4,14
RQT500170,MODULO DE CONTROL DE SUSPENSION DE AIRE SEMINUEVO LAND ROVER LR3 ( GENUINO ),1797,9,4,8,21
RS2ML,PAR BOLSA AIRE SUSPENSION TRASERA (L/R) FORD F150 F250 F350 (EMBLER),1375,1,1,6,8
RU5ML,PAR BOLSA AIRE SUSPENSION TRASERA (L/R) LAND ROVER RANGE ROVER (EMBLER),1902,2,1,4,7
RV3ML,PAR BOLSA AIRE SUSPENSION TRASERA (L/R) BMW SERIE 5 F10 (EMBLER),1597,7,7,9,23
RVU500011,BUJE DE BARRA ESTABILIZADORA DE SUSPENSION DELANTERA RANGE ROVER SPORT EUROSPARE,1262,6,0,5,11
RVU500011-1,BUJE DE BARRA ESTABILIZADORA DE SUSPENSION DELANTERA RANGE ROVER SPORT METRIX,1616,2,1,1,4
RW8ML,PAR BOLSA AIRE SUSPENSION DELANTERA (L/R) MERCEDES W221 (EMBLER),1694,8,2,4,14
RX3ML,PAR AMORTIGUADOR AIRE SIN SENSOR SUSPENSION DELANTERA (L/R) LAND ROVER RANGE ROVER (EMBLER),1958,2,0,4,6
RX7ML,PAR BOLSA AIRE SUSPENSION TRASERA (L/R) BMW F02 F04 (EMBLER),1513,3,4,5,12
RZ4ML,PAR AMORTIGUADOR AIRE CON ADS SUSPENSION TRASERA (L/R) MERCEDES W164 (EMBLER),1735,3,6,9,18
S103518002Z,SENSOR DE FRENOS ABS DELANTERO BMW E39 / M52 / M62  ( BMTR ),1540,1,9,7,17
S119044012Z,SENSOR DE CIGUEï¿½AL BMW E90 ( SIEMENS ),1891,2,4,2,8
S1EV03 *3,LLANTA VENTUS S1 EV03 22545R18 RUNFLAT (HANKOOK),1419,5,9,8,22
S801004,BOMBA AGUA MECANICA ENFRIAMIENTO MOTOR VW TIGUAN 2.0 L (SIA),1252,6,4,1,11
SC,SHIPPING COST,1848,4,7,1,12
SC3ML,PAR AMORTIGUADOR AIRE CON ADS SUSPENSION DELANTERO (L/R) MERCEDES W164 (EMBLER),1549,5,5,0,10
SEM000024,SENSOR BALATAS FRENOS DELANTERO (L/R) LAND ROVER DISCOVERY,1692,8,0,8,16
SEM500070 *5,SENSOR BALATAS FRENOS DELANTERO (L/R) LAND ROVER LR3 2006 A 2009 LAND ROVER LR4 2010 A 2016 (PEX) SSF,1756,4,2,1,7
SEM500070 *6,SENSOR BALATAS FRENOS DELANTERO (L/R) LAND ROVER LR3 2006 A 2009 LAND ROVER LR4 2010 A 2016 (FEBI) SSF,1242,0,0,7,7
SEM500080G,SENSOR DE BALATAS DELANTERO,1557,4,7,5,16
SFP500010,BALATAS FRENOS DELANTEROS LAND ROVER RANGE ROVER PAGID T1513,1752,9,1,2,12
SFP500020-4,BALATAS FRENOS TRASEROS LAND ROVER  LR3 FTE BL2009B4,1706,2,9,2,13
SFP500070,BALATAS FRENOS DELANTEROS LAND ROVER RANGE ROVER SPORT PAGID T1686,1365,3,4,4,11
SFP500140,BALATAS FRENOS TRASEROS LAND ROVER  RANGE ROVER SPORT PAGID,1954,8,8,8,24
SFS000030,BALATAS FRENOS TRASEROS FREELANDER 1a GEN FERODO,1742,5,8,1,14
SILLA,SILLA,1731,0,0,2,2
SIN2,RADIADOR DE MOTOR AUDI A4 2.0 TFSI ( REACH ),1694,8,3,5,16
SINCLAVE12-100,TORNILLO ESTABILIZADOR DELANTERO R MERCEDES W204 INACTIVO,1649,8,1,4,13
SINCLAVE123-100,SENSOR DE OXGENO DELANTERO L BMW E70-N62 950 MM MOTOR 4.8 INACTIVO,1535,7,7,3,17
SINCLAVE1234-100,MANGUERA VENTILACION CARTER PCV 2 VIAS BMW N52 INACTIVO,1813,3,8,9,20
SP,SERVICIO DE  PAQUETERIA,1513,6,1,1,8
SPML,SERVICIO DE PAQUETERIA MERCADO LIBRE,1771,1,8,1,10
SSW000010,SENSOR ABS DELANTERO LAND ROVER FREELANDER ( BREMI ),1629,1,2,3,6
SSW000010BR,SENSOR DE FRENOS ABS DELANTERO FREE LANDER ( BREM ),1610,8,4,3,15
ST160001-100,JUEGO DE HERRAMIENTAS DISTRIBUCIï¿½N DEL MOTOR BMW B38 / B48 / B58 INACTIVO,1665,9,6,7,22
ST160002-100,Juego de herramientas de sincronizaciï¿½n-BMW Mini-PSA N12 tool INACTIVO,1419,3,8,3,14
ST160003-100,HERRAMIENTAS SINCRONIZACION CADENAS MOTOR BMW MINI N13 N18 (EMBLER) tool INACTIVO,1431,6,6,0,12
ST160004-100,"Kit de ajuste / bloqueo del motor de gasolina - BMW N42 / N46 1.6,1.8,2.0 INACTIVO",1261,9,4,1,14
ST160005-100,Kit de herramientas de sincronizaciï¿½n del motor para BMW N51 52535455 tool INACTIVO,1811,2,1,5,8
ST160008-100,Juego de herramientas de sincronizaciï¿½n BMW (N20 N26) tool INACTIVO,1899,8,1,4,13
ST160017-100,JUEGO DE HERRAMIENTAS DE DISTRIBUCIï¿½N DEL MOTOR PARA BMW N62 INACTIVO,1794,9,6,9,24
ST160201-100,KIT DE HERRAMIENTAS DE DISTRIBUCIï¿½N DEL MOTOR PARA AUDI1.8 2.0 ETI / TFSI T10352 T40196 INACTIVO,1395,4,7,4,15
ST160204 *2,HERRAMIENTA SINCRONIZACION ARBOLES MOTOR AUDI VW SEAT 1.8 2.0 TSI TFSI (EMBLER) T&F,1955,9,3,5,17
ST160204-100,"HERRAMIENTAS DE DISTRIBUCIï¿½N DEL MOTOR VAG 1.8, 2.0 TSI / TFSI INACTIVO",1318,3,3,5,11
ST160214-100,KIT DE HERRAMIENTAS DE DISTRIBUCIï¿½N DE MOTOR PARA VAG 1.2 / 1.4 / 1.6FSI / 1.4TSI INACTIVO,1225,0,3,2,5
T10323-100,HERRAMIENTA INSTALACION DOBLE CLUTCH DSG 7 VEL. AUDI A3-TOUAREG HT INACTIVO,1813,4,1,4,9
TC2393 *5,TORNILLO BARRA ESTABILIZADORA SUSPENSION TRASERA (L/R) LAND ROVER LR2 RANGE ROVER EVOQUE (DELPHI) SSF,1572,1,0,9,10
TC933 *5,TORNILLO ESTABILIZADOR SUSPENSION DELANTERA (L/R) FREELANDER (DELPHI) SSF,1481,3,1,1,5
TD03,KIT DE REPARACION DE TURBO,1239,3,6,4,13
TDR100750,CUBRE POLVO DE FLECHA DELANTERA EXTERIOR L-R FREELANDER GKN,1999,6,6,3,15
TDR500210,CUBRE POLVO DE FLECHA DELANTERA INTERIOR L-R FREELANDER GKN,1296,1,2,6,9
TF-1001,ENFRIADOR DE ACEITE DE MOTOR FORD DIESEL MOTOR 6.0 L,1615,2,2,0,4
TOOL-100,HERRAMIENTA DE SINCRONIZAC INACTIVO,1568,7,4,8,19
TRC116000S *100,DEPOSITO DE ANTICONGELANTE BMW E46-M54 (MAHLE) baja,1532,4,5,7,16
TRC216000S *5,TANQUE DE EXPANSION DE REFRIGERANTE  (MAHLE ) SSF,1899,2,0,7,9
TRW G43-100,BALATA TRASERA MERCEDES W164-M272 INACTIVO,1643,2,9,6,17
TRW GDB1498-100,BALATAS FRENOS DELANTEROS MINI R56 TURBO (TRW GDB1498) INACTIVO,1610,2,4,7,13
TS1ML-100,KIT ENGRANE DE ARBOL DE LEVAS DE ESCAPE Y ADMISION INACTIVO,1272,9,4,8,21
TS3ML,KIT ENGRANE DE ARBOL DE LEVAS DE ADMISION Y ESCAPE MERCEDES W203-M271 DORMAN ALEMAN,1837,2,1,3,6
TVB000090,TRIPODE LAND ROVER LUZAN,1641,1,2,0,3
TW1ML,KIT 2 PZ ENGRANES ARBOL LEVAS ADMISION ESCAPE MERCEDES M271 2a GEN TURBO (EMBLER),1389,4,8,3,15
UB4ML,PAR SOPORTE DE MOTOR  MERCEDES W169-W245 BMTR,1878,9,9,8,26
UBC000070 *2,ENFRIADOR ACEITE TRANMISION AUTOMATICA FREELANDER (EMBLER) GOG,1476,6,3,8,17
UE3ML-100,PAR SOPORTE DE MOTOR MERCEDES W169-W245 INACTIVO,1842,9,3,4,16
UL9ML,KIT RETEN CIGUEï¿½AL DELANTERO Y TRASERO MERCEDES BENZ W203 / M271 ORIGINAL / ELRING,1591,2,3,7,12
UNIFIL OX555,FILTRO ACEITE MOTOR MINI COOPER N12 N14-N18 (UNIFIL OX555),1401,1,7,5,13
UZ6ML,PAR AMORTIGUADOR DE COFRE BMW E70 BMT,1446,6,1,2,9
V021115562A,FILTRO ACEITE MOTOR AUDI Q7 V6 CAYENNE 3.2L TOUAREG V6 MANN HU932/6N,1621,4,5,1,10
V021145933H,BANDA ACCESORIOS MOTOR MEDIDA 7PK 1360 MM VW JETTA 2.8L CONTITECH,1367,9,2,3,14
V022103765A,VALVULA PCV VW TOUAREG - 3.2L  FEBI,1874,4,7,1,12
V022103765A-1,VALVULA PCV VW TOUAREG / 3.2L ( GENERICA ),1645,0,9,8,17
V022109423D,PUNTERIAS HIDRAULICAS ( BUZOS ) AUDI A3 / 1.8L ( GENUINOS ),1848,2,9,7,18
V022109423D-1,PUNTERIAS HIDRAULICAS ( BUZOS ) AUDI A3 / 1.8L TOPRAN,1232,1,2,2,5
V028117021B,ENFRIADOR DE ACEITE DE MOTOR BETTLE GOLF JETTA PASSAT HELLA,1718,9,0,2,11
V028117021E,ENFRIADOR DE ACEITE DE MOTOR AUDI S4 A4 A6 PASSAT BMTRS,1349,4,5,9,18
V028117021E-1,ENFRIADOR DE ACEITE DE MOTOR AUDI S4 A4 A6 PASSAT HELLA,1794,8,5,0,13
V028117021L,ENFRIADOR DE ACEITE DE MOTOR AUDI A4 1.8L BEHR 376778031,1753,1,8,6,15
V030115561,FILTRO ACEITE MOTOR VOLKSWAGEN 1.6L 4CIL MANN W712/53,1230,9,5,4,18
V036103171,RETEN DE CIGUEï¿½AL AUDI A1 A3 VIKA,1681,8,3,6,17
V036109675A,SELLOS DE VALVULA AUDI A4 / 2.0 L TFSI  ( CORTECO 6 MM ),1291,2,1,0,3
V036129620H-5,FILTRO ENTRADA AIRE MOTOR SEAT IBIZA V 1.6L MANN C3880,1605,3,9,9,21
V036905715F-100,BOBINA DE IGNICION AUDI A3 1.4 L BMTR INACTIVO,1255,3,9,7,19
V037906283C,VALVULA SOLENOIDE AUDI A4 - 3.0L  PIERBURG,1829,9,0,4,13
V038117021E,ENFRIADOR DE ACEITE DE MOTOR AUDI BETTLE JETTA PASSAT GOLF Q7-Q5-A5 BMTRS,1879,6,0,3,9
V038117070A,SELLO RADIADOR DE ACEITE AUDI A4 / 1.8L ( GENUINO ),1650,6,9,6,21
V038906051 *3,SENSOR DE PRESION DE TUBO DE ADMISION AUDI A4 / 2.0L (ORIGINAL),1935,6,7,5,18
V038906051E,SENSOR DE PRESION DE TUBO DE ADMISION AUDI A4 / 2.0L  ( BOSCH ),1969,3,8,2,13
V038919081K,SENSOR DE PRESION DE ACEITE AUDI A3 / A4 / 2.0L ( TOPRAN ),1652,9,5,4,18
V038919081K-1,SENSOR DE PRESION DE ACEITE AUDI A3 / A4 / 2.0L ( URO ),1388,3,6,4,13
V03C103383R,JUNTA CABEZA MOTOR MEDIDA STANDAR 0.8 MM AUDI SEAT VW 1.4 TSI GENERICA,1884,5,6,6,17
V03C109088C,KIT DE CADENAS DE DISTRIBUCION AUDI 1.4L TSI 1.6 FSI DORMAN PRECISION,1367,2,1,0,3
V03C115561H,FILTRO ACEITE MOTOR AUDI 1.4 TSI KOLBENSCHMIDT 50014298,1509,1,8,3,12
V03C115561H-1,FILTRO ACEITE MOTOR AUDI 1.4 L TSI MANN W712/94,1539,6,8,8,22
V03C115562,FILTRO ACEITE MOTOR 1.6 L MANN HU712/6X,1284,4,5,4,13
V03C117021D,ENFRIADOR DE ACEITE DE MOTOR BETTLE EOS TIGUAN GOLF JETTA POLO SHARAN A1,1232,0,0,1,1
V03C117021J,ENFRIADOR DE ACEITE DE MOTOR AUDI A1 -1.4 TSI TAIFA,1409,4,3,6,13
V03C198151A,ANILLOS DE MOTOR STD X 1 PISTON AUDI A1 - 1.4L MAHLE 02801N0,1480,6,3,4,13
V03C907660H,SENSOR DE NIVEL DE ACEITE AUDI A4 3.2L HELLA,1858,8,9,0,17
V03H103202A,MANGUERA DE VENTILACION PCV AUDI MOTOR 3.6L ( EMBLER ),1272,4,0,7,11
V03L115562,FILTRO ACEITE MOTOR VOLKSWAGEN-AUDI MANN HU7008Z,1498,1,9,6,16
V04E115561,FILTRO ACEITE MOTOR VOLKSWAGEN GOLF 1.4 L MANN W712/95,1489,0,1,3,4
V04E115561-2,FILTRO ACEITE MOTOR VOLKSWAGEN GOLF 1.4 L VIKA OC9771,1580,2,7,0,9
V04E121600AN-100,BOMBA DE AGUA MECANICA CON TERMOSTATO TOMAS DE AGUA AUDI A1-1.4L INACTIVO,1989,5,5,8,18
V04E129620A,FILTRO ENTRADA AIRE MOTOR SEAT IBIZA 1.6 MANN C21014,1879,4,1,1,6
V05184294AE,ENFRIADOR DE ACEITE DE MOTOR CHRYSLER JEEP 3.6L TAIFA,1399,7,1,0,8
V058133753D-3,KIT MANGUERA VACIO VALVULA CHECK BOSTER FRENO AUDI A4 1.8 TURBO (EMBLER),1681,3,0,7,10
V058133817D,MANGUERA DE BOMBA DE AIRE SECUNDARIO A4-1.8 T. 20 VALVULAS GENUINA,1914,3,9,9,21
V058133817H,KIT DE MANGUERAS DE BOMBA DE AIRE SECUNDARIA AUDI A4 1.8L GENUINO,1870,5,6,9,20
V079198405E *9,FILTRO ACEITE MOTOR AUDI Q7 4.2 L 8 CIL MANN HU7005X,1907,9,8,8,25
V15991894 *5,TERMOSTATO ENFRIAMIENTO MOTOR 87ï¿½ VOLVO S40 S60 S70 V40 V70 C70 V90 (VAICO) SSF,1979,2,1,0,3
V4697137007,CAJA DE FUSIBLE BMW E36-E46-E90-F30 GENUINA,1932,9,2,5,16
VALV6265,VALVULA DE BOLSA  AIRE SUSPENSION TRASERA ( L / R )   Q7  CAYENNE  ( EMBLER ),1948,2,4,2,8
VDP,VENTAS DE POSICIONAMIENTO,1206,7,6,2,15
VH3ML,KIT 4 BUJIAS DE IGNICION DOBLE PLATINO MERCEDES W140 BOSCH,1462,6,3,8,17
VH5ML,KIT 6 BUJIAS DE IGNICION DOBLE PLATINO MERCEDES W140 BOSCH,1859,4,2,2,8
VH7ML,KIT 8 BUJIAS DE IGNICION DOBLE PLATINO MERCEDES W140 BOSCH,1225,5,1,1,7
VM,VENTAS MOSTRADOR,1523,6,4,0,10
VM6ML,KIT DE BALATAS DELANTEROS Y SENSOR BMW E39,1849,0,8,1,9
VN5ML,KIT DE BALATAS DE FRENOS DELANTEROS Y SENSOR BMW E70,1853,4,1,2,7
VR8NII35U-100,BUJIA IRIDIUM BMW N14 N16 N18 N20 N55 N63 (BOSCH) INACTIVO,1931,0,2,0,2
VU5ML,KIT FILTRO ACEITE MOTOR Y JUNTAS DE ENFRIADOR DE ACEITE BMW MOTOR N46-N46N,1845,5,9,8,22
VX7ML *100,KIT BALATAS Y SENSOR DE FRENOS DELANTEROS 156X62 MM BMW BAJA,1896,1,6,6,13
WA1ML-100,KIT JUNTAS BASE DE FILTRO BMW N52N-N52-N55-N54-N20 INACTIVO,1220,8,6,3,17
WC2ML,KIT DE JUEGO DE FILTROS SEAT IBIZA MANN,1575,6,8,0,14
WFL000010 *3,FILTRO COMBUSTIBLE GASOLINA FREELANDER 1a GEN 2000-2006 (MAHLE KL468),1746,8,1,3,12
WHT003858,SENSOR DE FRENOS ABS TRASERO ( R ) AUDI A3 / 2.0L ( EMBLER ),1476,0,9,9,18
WHT003859,SENSOR DE FRENOS ABS TRASERO ( L ) AUDI A3 / 2.0L ( BREMI ),1330,4,0,5,9
WL3ML-100,SOPORTE DE MOTOR R-L BMW E46-M54 TOPRAN INACTIVO,1617,2,5,5,12
XB-271-04,JUEGO DE JUNTAS DE MOTOR SUPERIOR MERCEDES MOTOR M271 BMTRS,1211,2,9,0,11
XB-271-05,JUEGO DE JUNTAS DE MOTOR SUPERIOR MERCEDES MOTOR M271 BMTR,1593,0,2,7,9
XB-271-11,JUEGO DE JUNTAS DE MOTOR INFERIOR MERCEDES MOTOR M271 BMTRS,1919,4,0,0,4
XB-272-06 *9 ,KIT JUNTAS SUPERIORES MOTOR MERCEDES M272 3.0 L (BMTRS),1814,5,1,0,6
XB-272-07 *9 ,KIT JUNTAS INFERIORES MOTOR MERCEDES M272 3.0 L (BMTSR),1411,9,3,1,13
XB-272-08,KIT JUNTAS MOTOR MOTOR MEDIDA 1.70 CILINDRO 94 MM MERCEDES M272 3.5 L (BMTRS),1220,4,0,1,5
XB-272-09,JUEGO DE JUNTAS INFERIOR MOTOR M272 3.5  MERCEDEZ BENZ V6 BMTRS,1346,6,4,1,11
XB-272-10,JUEGO DE JUNTAS DE MOTOR INFERIOR MERCEDES BENZ MOTOR M272 BMTR,1659,7,7,0,14
XB-N55B30-02,KIT PZ. JUNTAS MOTOR COMPLETO BMW N55 (EMBLER) GOG,1388,5,6,8,19
XB-N55B30-N54B30-12,JUEGO DE JUNTAS DE MOTOR INFERIOR BMW MOTOR N54-N55 BMTRS,1439,8,4,5,17
XB-N63B44-03,JUEGO DE JUNTAS DE MOTOR COMPLETO BMW MOTOR N63 BMTSR,1273,0,3,6,9
XR819697,BUJE DE BARRA ESTABILIZADORA JAGUAR S-TYPE REIN,1290,3,4,7,14
XR819697-1,BUJE DE BARRA ESTABILIZADORA JAGUAR S-TYPE TOPRAN,1466,4,6,4,14
XR827648,MANGUERA SUPERIOR DE RADIADOR JAGUAR S-TYPE / 3.0L ( URO ),1382,8,9,3,20
XR841215J,ROTULA  INFERIOR DE SUSPENSION DELANTERA ( L / R ) JAGUAR S-TYPE ( URO ),1582,5,6,2,13
XR843533 *5,1 PZ JUNTA MULTIPLE ADMISION AIRE MOTOR JAGUAR S-TYPE 3.0 L V6 2001 A 2008 (EUROSPARE) SSF,1205,1,5,1,7
XR857652,HORQUILLA SUPERIOR DE SUSPENSION DELANTERA R JAGUAR S-TYPE EUROSPARE,1215,6,2,4,12
XR857653,HORQUILLA SUPERIOR DE SUSPENSION DELANTERA L JAGUAR S-TYPE EUROSPARE,1474,3,0,8,11
YJ8ML-100,PAR AMORTIGUADORES CAJUELA (L/R) MERCEDES W164 INACTIVO,1578,7,8,1,16
YK5ML-100,PAR DE AMORTIGUADORES DE COFRE L-R MERCEDES BENZ INACTIVO,1203,7,1,9,17
YLE102480,ALTERNADOR LAND ROVER FREELANDER DENSO,1308,6,0,5,11
YO2ML-100,PAR AMORTIGUADORES DE CAJUELA ( L-R ) MERCEDES BENZ INACTIVO,1363,4,7,2,13
YP5ML-100,PAR AMORTIGUADORES DE SUSPENSION DELANTERA L-R INACTIVO,1463,5,4,4,13
YR7ML-100,PAR BIELETA DE DIRECCION CON TERMINAL L-R BMW E83-M54 INACTIVO,1423,0,6,7,13
YZ5ML-100,PAR BRAZOS RECTO SUSPENSION DELANTERA INACTIVO,1633,1,8,6,15
ZC4ML-100,PAR AMORTIGUADORES DE COFRE ( L Y R ) BMW INACTIVO,1727,1,8,9,18
ZC8ML-100,PAR DE AMORTIGUADORES DE COFRE ( L Y R) BMW INACTIVO,1375,9,0,5,14
ZD3ML-100,PAR AMORTIGUADORES DE COFRE ( LY R ) BMW INACTIVO,1924,6,2,2,10
ZE4ML-100,PAR AMORTIGUADORES DE CAJUELA N400 (L Y R ) INACTIVO,1334,7,4,0,11
ZK4ML-100,PAR HORQUILLAS DE SUSPENSION DELANTERA (L Y R) INACTIVO,1812,9,3,7,19
ZR2ML-100,PAR AMORTIGUADOR DE COFRE L-R MERCEDES INACTIVO,1254,0,6,0,6
ZVW311002,KIT DE CABLES DE BUJIA VW-JETTA-GOLF 2.8L BREMI,1384,2,1,5,8
_,/./,1304,6,7,0,13
